# 「基本辞書データ（英和、自由）.tsv」片山博文MZ
# This file is public domain software.
abbreviation	省略。
ABC	アルファベット。基礎。
ability	能力。手腕。
absence	欠席。不在。欠如。
abundance	豊富。たくさん。
AC	（電気の）交流。
academy	学術協会。学会。芸術協会。専門学校。
accent	アクセント。
acceptance	承諾。受理。
access	アクセス。
accessory	付属品。アクセサリー。
accident	事故。偶然の出来事。
accordance	一致。調和。協調。
accordion	アコーディオン。
account	口座。顧客。記述。説明。理由。
accuracy	正確さ。
accused	被告。
accuser	(theをつけて)告発人、原告。
ace	エース。
ache	痛み。
achievement	業績。達成。学力。
Achilles	アキレス。
acid	酸。
acknowledgment	承認。感謝。受け取りの連絡。
acorn	どんぐり。
acquaintance	知人。知り合い。
acre	エーカー。土地の面積の単位。
acrobat	曲芸師。軽わざ師。
act	行い。行為。
action	行動。行為。
activity	活動。活力。活気。
actor	男の俳優。男優。
actress	女優。
ad	西暦。広告。
Adam	神が創った最初の人間。
adaptation	適合。改作。脚色。
addend	加数。加える数。
addict	中毒者。常習者。
addition	付け加えること。足し算。追加分。
address	住所。
adjustment	調整。調節。
administration	管理。経営。行政。
administrator	管理者。行政官。
admiral	提督。海軍大将。海軍将官。
admiration	賞賛。感嘆。(theをつけて)賞賛の的。
admirer	賛美者。崇拝者。(女性に)惚れている人。
admission	入場許可。入学許可。入場料。
admittance	入場許可。入場。
adoption	採用。養子縁組。
adrenaline	アドレナリン。
adult	大人。
advance	前進。進歩。昇進。前払い。
advantage	有利な点。長所。好都合。利益。
adventure	冒険。
adventurer	冒険家。
adverb	動詞。
advice	忠告。
adviser	忠告者。助言者。顧問。指導教官。
advocate	支持者。主張者。代弁者。
Aegean	(theをつけて)エーゲ海。
Aesop	イソップ。
affair	事件。出来事。仕事。関心事。
affection	愛。情愛。慈しみ。
Africa	アフリカ。
African	アフリカ人。
afternoon	午後。
Ag	銀の元素記号。
age	年齢。時代。成年。
agency	代理店。取扱店。作用。働き。
agent	代理人。
agitator	扇動者。
agony	苦悩。苦痛。
agreement	一致。同意。協定。契約。
agriculture	農業。農学。
aid	援助。助力。援助者。
aim	狙い。照準。
air	空気。
aircraft	航空機。
airfield	airportよりも小規模な飛行場。
airgun	空気銃。
airline	定期航空。航空会社。
airmail	航空便の手紙。
airplane	飛行機。
airport	空港。
Aladdin	アラジン。
alarm	警報。目覚まし時計。驚き。心配。
album	アルバム。
alchemist	錬金術師。
alchemy	錬金術
alcohol	アルコール。
ale	エール（ビールの一種）。
alert	警報。警戒。
Alexander	アレキサンダー。男子の名。
Alfred	アルフレッド。男子の名。
alga	藻、藻類（単数形）。
algae	藻、藻類（複数形）。
algebra	代数。代数学。
Algeria	アルジェリア。
alibi	アリバイ。
Alice	アリス。女子の名。
alien	外国人。よそ者。宇宙人。
alignment	一列に整列すること。一列に並んだもの。
alkali	アルカリ。
all	すべて。全部。
allergy	アレルギー。
alliance	同盟。
alligator	(アメリカの)ワニ。
allowance	手当て。小遣い。値引き。考慮。容認。
alloy	合金。純度。混合物。
ally	同盟国。同盟者。
almond	アーモンド。
alphabet	アルファベット。
Alps	(theをつけて)アルプス山脈。
altar	祭壇。
alternate	代理者。代行者。
alternative	どちらかを選ぶこと。二者択一。
altitude	高度。高さ。
alto	アルト。女声の最低音。
aluminum	アルミニウム。
AM	午前。
amateur	アマチュア。素人。
Amazon	(theをつけて)アマゾン川。
ambassador	大使。施設。
ambition	大望。野心。熱望。
ambulance	救急車。
ambush	待ち伏せ。
ameba	アメーバ。
amendment	改正。修正。改正案。
America	アメリカ。
American	アメリカ人。
ammonia	アンモニア。
amoeba	アメーバ。
amoebae	アメーバの複数形の一つ。
amp	電流の強さの単位。アンペア。
ampere	電流の強さの単位。アンペア。
amphibian	両生類。水陸両用。
amplifier	増幅器。アンプ。
Amsterdam	アムステルダム。
amusement	楽しみ。娯楽。
Amy	エイミー。女子の名。
analysis	分析。分解。
anarchism	無政府主義。
anarchist	無政府主義者。
anarchy	無政府状態。
ancestor	先祖。祖先。
anchor	船のいかり。最後の走者。アンカー。
ancient	古代人。
Andersen	アンデルセン。
Andrew	アンドリュー。男子の名。
angel	天使。
anger	怒り。
angle	角度。角。かど。
animal	動物。
animation	動画。アニメーション。
ankle	くるぶし。足首。
Ann	アン。女子の名。
Anna	アンナ。女子の名。
announcer	アナウンサー。告知者。
annoyance	困惑。迷惑。やっかいなこと。
annual	年報。年間。一年生植物。
another	別のもの。もう一つのもの。
answer	答え。返事。
ant	昆虫のアリ。
Antarctica	南極大陸。
antenna	アンテナ。
antennae	アンテナの複数形。
Anthony	アンソニー。アントニー。男子の名。
anthropologist	人類学者。
anthropology	人類学。
antibiotic	抗生物質。
antibody	抗体。
antimony	アンチモン。
antique	古いもの。骨董品。
Antony	アントニー。アントニウス。男子の名。
antonym	反意語。
ants	昆虫のアリの複数形。
anxiety	心配。不安。懸念。切望。熱望。
any	どれでも。
anybody	だれか。だれも。だれでも。
anyone	だれか。だれも。だれでも。
anything	何か。何も。何でも。
apartment	一家族分の部屋。アパートの一室。
ape	類人猿。
apeces	apexの複数形の一つ。
apex	頂点。頂上。先端。
apexes	apexの複数形の一つ。
Apollo	アポロ。
apology	謝罪。言い訳。弁護。
apostrophe	アポストロフィー。
apparatus	器具。器官。
appeal	懇願。訴え。魅力。控訴。上告。
appearance	出現。出演。外見。
appendix	付録。追加。盲腸。
appetite	食欲。欲望。好み。
applause	拍手かっさい。賞賛。
apple	リンゴ。
appliance	器具。器械。装置。
applicant	志願者。応募者。
application	応用ソフト。アプリ。
appointment	約束。予約。
appreciation	正しく評価すること。鑑賞。感謝。値上がり。
apprentice	見習い。初心者。
approach	接近。近づく道。入り口。研究法。取り組み。
approval	賛成。認可。許可。
Apr	四月。
April	四月。
aptitude	才能。素質。傾向。習性。適性。
aquarium	水族館。魚などを入れる水槽。
Ar	アルゴンの元素記号。
Arab	アラブ人。
Arabia	アラビア。
Arabian	アラビア人。アラビア語。
arc	弧。円弧。弓形。
arcade	アーケード。
arch	アーチ。弓形の門。
archer	射手（いて）。弓術家。
archery	アーチェリー。弓術。
architect	建築家。設計技師。創始者。
architecture	建築。建築物。建築学。建築様式。
arctic	(theをつけて)北極地方。
are	アール。面積の単位。
area	面積。地域。地方。範囲。
Argentina	アルゼンチン。
Argentine	アルゼンチン人。
argon	化学物質のアルゴン。
argument	議論。口論。論拠。論証。要旨。
Aristotle	アリストテレス。古代ギリシャの哲学者。
arithmetic	算数。算術。
Ariz	アリゾナ州。
Arizona	アリゾナ州。
ark	箱舟。
Arkansas	アーカンソー州。
arm	腕。前足。武器。
armadillo	アルマジロ。
Armenia	アルメニア。
Armenian	アルメニア人。アルメニア語。
armistice	休戦。停戦。
armor	よろいかぶと。
armory	兵器庫。兵器工場。
armour	よろいかぶと。
army	軍隊。集団。
Arnold	アーノルド。男子の名。
aroma	香り。におい。芳香。
arrangement	整理。整とん。配置。協定。取り決め。準備。
array	一続き。配列。
arrest	逮捕。検挙。
arrival	到着。到着者。到着物。
arrogance	ごう慢さ。
arrow	矢。矢印。
art	芸術。美術。技能。
Artemis	アルテミス。ギリシャ神話における、月と狩猟の女神。
artery	動脈。幹線。
arthropod	節足動物。
Arthur	アーサー。男子の名。
article	品物。記事。冠詞。
artifice	器用さ。策略。
artist	芸術家。
asbestos	石綿。アスベスト。
ash	灰。
ashtray	灰皿。
Asia	アジア。
Asian	アジア人。
asparagus	アスパラガス。
aspect	表情。局面。状況。向き。
asphalt	アスファルト。
aspirin	アスピリン。
ass	ロバ。
assault	猛攻撃。強襲。暴行。
assembly	会合。会議。
assent	同意。賛成。
assertion	主張。断言。言い分。
assignment	割り当て。任命。宿題。研究課題。
assistance	手伝い。助力。援助。
assistant	助手。補佐員。店員。
association	交際。協会。連想。
assumption	仮定。想定。仮説。傲慢。でしゃばり。
assurance	保証。確信。自信。
astonishment	驚き。驚くべきこと。
astrology	占星学。
astronaut	宇宙飛行士。
astronomer	天文学者。
astronomy	天文学。
Athena	知恵・芸術・戦術の女神アテナ。
Athenian	アテネ人。
Athens	ギリシャの首都アテネ。
athlete	運動選手。競技者。
athletics	運動競技。体育。
Atlantic	(theをつけて)大西洋。
atlas	地図帳。
atmosphere	大気。空気。雰囲気。
atom	原子。
attachment	付着。付属品。愛情。
attack	攻撃。襲撃。発病。発作。
attacker	攻撃者。
attempt	試み。企て。
attendance	出席。参列。出席者。付き添い。看護。世話。
attendant	付き添い人。出席者。係員。案内係。
attention	注意。気をつけ。世話。手当て。親切。
attic	屋根裏。屋根裏部屋。
attitude	態度。心構え。姿勢。
attorney	弁護士。
attraction	魅力。呼び物。引力。
attribute	属性。特質。
attrition	摩擦。消耗。
auction	競売。せり売り。
audience	聴衆。観客。公式会見。
audio	音声。音の発信・受信・再生。
audition	オーディション。
auditorium	客席。講堂。
Aug	８月。
August	８月。
aunt	おば。
aurora	オーロラ。
Australia	オーストラリア。
Australian	オーストラリア人。
Austria	オーストリア。
Austrian	オーストリア人。
author	著者。作家。創始者。
authority	権威。権威者。権限。当局。
auto	自動車。
autograph	自筆の署名。サイン。
automation	自動操作。オートメーション。
automobile	自動車。
autumn	秋。
auxiliary	補助。助動詞。
avail	利益。効用。
avantgarde	(theをつけて)アバンギャルド。
Ave	``～ Maria''
avenue	大通り。...街。並木道。
average	(aかtheをつけて)平均。平均値。
aviation	飛行。航空。航空機。航空技術。
aviator	飛行士の古い言い方。
award	賞。賞品。賞金。裁定。判定。
awareness	自覚。
awe	畏敬の念。
ax	おの。まさかり。
axis	軸。枢軸。
axle	心棒。回転軸。
aye	賛成。賛成投票者。
AZ	アリゾナ州。
azure	空色。
Ba	バリウムの元素記号。
Babel	``The tower of ～''
baby	赤ちゃん。
Babylon	バビロン。
babysitter	子守をする人。
Bacchus	酒の神バッカス。
Bach	ドイツの大作曲家。
bachelor	独身者。学士。
back	後ろ。背中。
backbone	背骨。気骨。精神力。
background	背景。事情。経歴。
bacon	ベーコン。
bacteria	細菌。バクテリア。
badge	記章。バッジ。
badminton	バドミントン。
badness	悪いこと。不良。劣悪。
bag	袋。バッグ。
baggage	手荷物。(軍隊・探検隊の)装備。
bail	保釈。保釈金。
bait	えさ。おとり。誘惑。
baker	パン屋。パン焼き職人。
baking	パン・ケーキを焼くこと。一焼き分の量。
balance	つりあい。均衡。てんびん。差額。
balcony	バルコニー。露台。
ball	球。ボール。球技。
ballad	バラッド。民謡。
ballerina	バレリーナ。女性バレエダンサー。
ballet	バレエ。
balloon	気球。風船。
ballot	投票用紙。投票。投票総数。
bamboo	竹。竹材。
ban	禁止。禁止令。
banana	バナナ。
band	ひも。バンド。しま。線。筋。周波数帯。
bandage	包帯。巻き布。
bandit	無法者。盗賊。追いはぎ。
bang	ズドン、ドガンのような音。強打。一撃。
banish	追放する。流刑にする。
bank	銀行。貯金箱。貯蔵所。
bankbook	銀行通帳。
banker	銀行家。銀行営業者。胴元。
bankrupt	破産者。
bankruptcy	破産。倒産。破綻。
banner	旗。軍旗。垂れ幕。横断幕。大見出し。
banquet	宴会。祝宴。ごちそう。
baptism	先例。
bar	棒。棒状の物。かんぬき。横木。柵。障害。縦線。酒場。バー。
barbarian	野蛮人。未開人。
barbecue	バーベキュー。
barbell	（重量挙げの）バーベル。
barber	理髪師。床屋。理容師。
barbershop	床屋。理髪店。
bargain	安売り。特価品。売買契約。取引。
baritone	テナーとバスの中間の男声。バリトン。
barium	バリウム。
bark	ほえる声。怒鳴り声。銃声。
barley	大麦。
barn	納屋。家畜小屋。``Where you born in a ～?''
barometer	気圧計。バロメーター。指標。
baron	男爵。
barrel	たる。１たるの分量。銃身。砲身。
barricade	障害物。バリケード。
barrier	障害。柵。障壁。さまたげ。
base	土台。塁。ベース。
baseball	野球。
basement	地下室。
bases	basisの複数形。
basics	基礎。
basis	基礎。根拠。根拠。
basket	かご。バスケット。かご一杯。
basketball	バスケットボール。
bass	男声の最低音。バス。
bassman	内野手。
bastard	私生児。いやなやつ。
bat	バット。コウモリ。
bath	入浴。水浴。浴槽。風呂場。浴室。
bathe	水泳。水浴。
bathrobe	バスローブ。化粧着。
bathroom	浴室。風呂場。手洗い。
bathtub	湯船。浴槽。
baton	指揮棒。警棒。バトン。
batter	打者。バッター。
battery	電池。バッテリー。
batting	バッティング。打撃。ふとん綿。中いれ綿。
battle	戦闘。闘争。競争。(theをつけて)勝利。
battlefield	戦場。
battleship	戦艦。
bawl	わめき声。
bay	湾。入り江。うなり声。月桂樹。
BBC	イギリス放送協会。
BBQ	バーベキューの略。
BC	西暦紀元前。
beach	海辺。浜。ビーチ。
bead	ビーズ玉。液体のしずく。
beagle	小型の猟犬。ビーグル。
beak	くちばし。
beaker	ビーカー。
beam	光線。輝き。
bean	豆。
bear	クマ。
beard	あごひげ。
bearing	関係。態度。忍耐。ベアリング。
beast	野獣。けもの。
beat	打つこと。打つ音。鼓動。拍子。
beater	打つ人。泡だて器。
beating	打つこと。打ち負かすこと。敗北。
Beatles	(theをつけて)ビートルズ。英国のロックグループ。
beauty	美。美しさ。美人。美しいもの。
beaver	ビーバー。
bed	ベッド。寝床。
bedding	寝具類。
bedroom	寝室。
bedtime	就寝時間。寝る時間。
bee	ミツバチ。ハチ。
beef	牛肉。
beefsteak	ビフテキ。
beehive	ミツバチの巣箱。
beeline	一直線。巣に戻るハチのようにまっすぐ。
beep	ビーッという音。
beer	ビール。
beerhouse	ビアホール。
beetle	甲虫。カブトムシ、クワガタムシなど。
beggar	乞食。物乞い。
beginner	初心者。
beginning	最初。初期。起源。
behavior	振る舞い。行動。行儀。
Beijing	中華人民共和国の首都、北京。
being	存在。生きていること。生き物。
Belgian	ベルギー人。
Belgium	ベルギー。
belief	信念。確信。信仰。信頼。
believer	信じる人。信者。
bell	ベル。鐘。鈴。ベルの音。
belly	腹。``～ dance''は腹をくねらせる踊り。
belongings	持ち物。所持品。
beloved	愛する人。最愛の人。
belt	ベルト。帯。帯状のもの。地帯。
bench	ベンチ。長いす。
bend	曲がること。曲げること。曲がった状態。
benefit	有利。利益。有益。承認。認可。
bent	好み。傾向。性癖。橋脚。忍耐力。
beret	ベレー帽。
Berlin	ベルリン。``the ～ Wall''
best	(theをつけて)最善のもの。
bet	賭け。掛け金。
beverage	飲料。
bias	先入観。偏見。バイアス。
Bible	(theをつけて)聖書。
bicycle	自転車。
bid	入札。付け値。
bidder	入札者。
bike	自転車。バイク。
bill	ビラ。請求書。紙幣。法案。
billboard	掲示板。
billiards	ビリヤード。玉突き。
billion	十億。
bin	ふたのついた箱。
biography	伝記。
biology	生物学。
bird	鳥。
birdie	小鳥ちゃん。ゴルフでparより一打少ない打数。
birth	誕生。出生。血統。
birthday	誕生日。
biscuit	小型丸パン。ビスケット。
bishop	司教。主教。
bit	小片。少量。一口。情報量の最小単位。
bitch	雌犬。
bite	かむこと。かみ傷。一かじり。
bitter	苦さ。苦しみ。苦痛。
bitterness	苦味。苦さ。
black	黒。黒色。黒服。黒人。
blackboard	黒板。
blacklist	ブラックリスト。
blackmail	ゆすり。恐喝。
blackness	黒いこと。暗黒。腹黒さ。
blade	刃。刃物。
blame	とがめ。非難。罪。責任。
blank	空所。空白。白紙。書き込み用紙。
blanket	毛布。
blast	突風。ラッパなどを吹く音。爆破。送風。爆風。
blaze	炎。強い輝き。爆発。
bleach	漂白剤。
blend	混合物。混合。
blender	混ぜるもの。混ぜる人。ミキサー。
blessing	祝福。天の恵み。祈り。
blind	日よけ。ブラインド。
blindfold	目隠し。
blindness	目が見えないこと。盲目。
blink	またたき。きらめき。ちらっと見ること。
block	(木や石などの)かたまり。ブロック。積み木。区間。障害物。
blond	金髪で肌が白く目の青い人。
blood	血。血液。活力。気質。血統。
bloodshed	流血。
bloom	(観賞用の)花。花盛り。最盛期。
blossom	(果樹の)花。開花。開花期。
blot	(インクなどの)よごれ。しみ。汚点。spot。
blouse	ブラウス。仕事着。
blow	一吹き。強打。打撃。
blower	吹く人。送風機。
blue	青色。藍色。
blueprint	青写真。詳細な計画。
bluff	絶壁。断崖。
blur	にじみ。不鮮明。かすみ。くもり。
blush	顔を赤めること。赤面。
board	広くて薄い板。食事。委員会。会議。
boast	誇り。自慢。自慢の種。
boat	ボート。小舟。汽船。船。
body	身体。胴体。死体。主要部。
bodyguard	ボディガード。
bog	沼地。湿地。泥沼。
boil	沸騰。煮沸。
boiler	ボイラー。煮沸器。湯沸かし。
boldness	大胆さ。ずぶとさ。厚かましさ。
bolt	ボルト。ねじくぎ。かんぬき。いなずま。
bomb	爆弾。
bomber	爆撃機。爆撃手。
bond	きずな。結びつき。束縛。接着。債券。契約。
bone	骨。
bonnet	ボンネット。
bonus	ボーナス。賞与。
boo	ブーという叫び声。
booby	間抜け。ばか者。最下位。びり。
book	本。書物。著書。
bookshop	書店。本屋。
bookstore	書店。本屋。
boom	ドーンという音。とどろき。急な人気。ブーム。
boomerang	ブーメラン。
boot	長靴。ブーツ。けること。
booth	売店。屋台。ブース。小部屋。
border	境界。境界線。国境。
borderline	国境線。境界線。
bore	退屈なもの。穴。直径。口径。
bosom	胸。胸部。胸の内。内部。
boss	長。上司。監督。
Boston	マサチューセッツ州の州都ボストン。
both	両方。両者。どちらも。
bother	やっかい。面倒。
bottle	びん。ボトル。
bottom	底。ふもと。根元。根底。びり。
bough	大枝。
bounce	はずみ。はね返り。弾力。
bound	はね返り。バウンド。はずみ。
boundary	境界。境界線。
bouquet	花束。ブーケ。香り。芳香。
boutique	ブティック。婦人服や装身具などを扱う店。
bow	おじぎ。会釈。へさき。弓。
bowel	腸。内臓。
bowl	鉢。おわん。どんぶり。ボール。
bowling	ボウリング。
box	箱。ボックス。特別席。打者席。詰め所。こぶしで殴ること。
boxing	ボクシング。
boy	少年。男の子。ボーイ。
boycott	ボイコット。
boyfriend	男友達。ボーイフレンド。
boyhood	少年時代。少年期。
Br	臭素の元素記号。
bra	ブラジャー。
brace	留め金。補強材。中カッコ。
bracelet	腕輪。ブレスレット。
bracket	角カッコ。カッコ。ブラケット。
brag	自慢。ほら吹き。
braid	編み髪。おさげ。組みひも。
brain	脳。頭脳。
brake	ブレーキ。歯止め。
branch	枝。支流。支部。支店。分科。
brand	銘柄。商標。ブランド。
brandy	ブランデー。
brass	銅と亜鉛の合金、しんちゅう。金管楽器。
brassiere	ブラジャー。
brave	勇士。戦士。
bravery	勇気。大胆さ。勇敢な行動。
bravo	ブラボーという叫び声。喝采の叫び。
Brazil	ブラジル。
Brazilian	ブラジル人。
breach	破ること。違反。絶交。裂け目。
bread	パン。食べ物。生計。
breading	繁殖。飼育。育ち。教育。
breadth	幅。広がり。広さ。
break	割れ目。ひび。とぎれ。休憩。休み時間。
breakdown	故障。破損。病気で倒れること。中断。
breaker	壊すもの。壊す人。電気の遮断器。
breakfast	朝食。朝飯。
breakthrough	突破。難関突破。躍進。ブレイクスルー。
breast	胸部。乳房。
breastbone	胸骨。
breath	息。呼吸。そよ風。ほのかな香り。ささやき。
breathing	呼吸。
breed	品種。種類。
breeder	家畜・植物を繁殖させる人。
breeze	微風。そよ風。
brew	醸造高。地ビール。熱い飲み物。混合。
bribe	わいろ。人の買収。
bribery	贈賄（ぞうわい）。汚職。
brick	レンガ。
bridal	結婚式。
bride	花嫁。新婦。
bridge	橋。ブリッジ。
brief	概要。要旨。下着のブリーフ。
briefcase	書類かばん。ブリーフケース。
brigade	旅団。団体。隊。団。
brightness	明るさ。輝き。輝度。
brim	皿・コップなど、くぼみのあるものの縁。へり。帽子のつば。
Britain	``Great ～''の略称。大ブリテン島。
British	英国人。イギリス人。
broadcast	放送。放送番組。
broadcasting	放送。
Broadway	ニューヨーク市の主要な街路、ブロードウェイ。
broccoli	ブロッコリー。
broker	仲介業者。ブローカー。
bromine	臭素。
bronze	青銅。ブロンズ。青銅製品。青銅色。
brooch	飾り留めピン。ブローチ。
brook	小川。
broom	ほうき。
brother	兄弟。兄。弟。
brotherhood	兄弟の関係。
brow	まゆ。まゆ毛。ひたい。がけっぷち。
brown	茶色。褐色。
bruise	打撲傷。打ち身。植物の傷。
brush	はけ。ブラシ。毛筆。
Brussels	ベルギー（Belgium）の首都、ブリュッセル。
brute	動物。けもの。
bubble	あわ。あぶく。シャボン玉。
buck	雄鹿。トナカイ・カモシカ・ウサギなどの雄。
bucket	バケツ。手おけ。
buckle	（ベルト・革帯などの）締め金。（靴の）留め金。バックル。
buckskin	雄の革。
bud	芽。つぼみ。
Buddha	仏教の開祖、ブッダ。
Buddhism	仏教。
budding	発芽。
budget	予算。予算案。
buffalo	水牛。バッファロー。野牛。
bug	昆虫。虫。
builder	建築業者。建築技師。創始者。
building	建物。ビル。建築。
bulb	球根。電球。
Bulgaria	ブルガリア。
Bulgarian	ブルガリア人。ブルガリア語。
bulk	容積。体積。大部分。積荷。
bull	雄牛。象・鯨・アザラシなどの大型動物の雄。
bulldog	ブルドッグ。
bulldozer	ブルドーザー。
bullet	弾丸。
bullfight	闘牛。
bump	衝突。ドスンという音。
bumper	(自動車の)バンパー。
bunch	(果物などの)ふさ。(同じ種類の)束、山。群れ。
bundle	束。小包。
bunker	ゴルフ場のバンカー（砂地のくぼみ）。sand trap。
bunny	ウサギちゃん。
buoy	浮標。ブイ。浮き袋。
burden	荷。重荷。負担。
bureau	局。事業所。受付。「職業安定所」＝``an employment ～''
burn	日焼け。焼け焦げ。
burner	バーナー。焼く人。燃やす道具。
burst	破裂。爆発。突発。
bus	バス。乗合自動車。
Bush	米国第41代大統領、George ～。
business	仕事。職務。商売。用事。ビジネス。
butcher	肉屋。精肉店。虐殺者。
butter	バター。
butterfly	チョウ。
button	ボタン。
buttonhole	ボタン穴。
buyer	買い手。バイヤー。
buzz	ブンブンいう、うなり音。ガヤガヤとしたざわめき声。
buzzer	ブザー。サイレン。ブンブンうなるもの。
bypass	バイパス。迂回路（うかいろ）。
byproduct	副産物。
Ca	カルシウムの元素記号。
cab	タクシー。
cabaret	歌や踊りのショーがあるレストラン。キャバレー。
cabbage	キャベツ。
cabin	小屋。船室。客室。キャビン。
cabinet	戸棚。キャビネット。内閣。
cable	太い綱。ケーブル線。海底電信。
cacao	カカオ。
cactus	サボテン。
caddie	ゴルフ場でクラブなどを運ぶ人。キャディー。
cadmium	カドミウム。
cafe	カフェ。コーヒー。
cage	鳥かご。おり。
cake	ケーキ。
calcium	カルシウム。
calculation	計算。
calculator	計算機。電卓。
calendar	カレンダー。暦。
calf	子牛。ふくらはぎ。
California	カリフォルニア。
call	呼び声。呼び出し。訪問。魅力。必要性。
caller	訪問者。呼び出し人。
calling	呼ぶこと。点呼。天職。
calm	平静。落ち着き。
calmness	平穏。静けさ。冷静。落ち着き。
calorie	熱量の単位、カロリー。
Cambridge	ケンブリッジ。
camel	ラクダ。
camera	カメラ。写真機。
cameraman	カメラマン。
camp	キャンプ。野営。キャンプ場。陣営。
campaign	軍事行動。運動。キャンペーン。
camper	キャンプをする人。キャンプ用の自動車。
campfire	キャンプのかがり火。キャンプファイアー。
campus	学校の構内。キャンパス。
can	缶。
Canada	カナダ。
Canadian	カナダ人。
canal	運河。導管。
canary	カナリア。
cancellation	取り消し。キャンセル。
cancer	がん。害悪。
candidate	候補。志願者。
candle	ろうそく。キャンドル。
candy	キャンデー。砂糖菓子。
cane	つえ。ステッキ。棍棒。茎。むち。
cannibal	人食い人。共食いする動物。
cannon	大砲。
canoe	カヌー。
canvas	キャンバス。画布。ズック。
canyon	峡谷（きょうこく）。
cap	(ふちなしの)帽子。水泳帽。帽子状のふた。キャップ。
capability	能力。才能。
capacity	収容力。容量。能力。資格。
cape	みさき。
capital	首都。大文字。頭文字。資本。資本家。
capitalism	資本主義。
Capitol	(theをつけて)議事堂。
capsule	カプセル。
captain	船長。長。主将。キャプテン。
caption	表題。見出し。キャプション。タイトル。
captive	とりこ。捕虜。
captivity	とらわれの身。監禁状態。
capture	捕獲。逮捕。捕虜。
car	自動車。車。車両。
caramel	キャラメル。カラメル。
carat	宝石の重さの単位、カラット。
caravan	キャラバン。隊商。大型ほろ馬車。移動住宅。
carbohydrate	炭水化物。
carbon	炭素。炭素棒。(複写用の)カーボン紙。
card	カード。はがき。トランプ。
cardboard	厚紙。ボール紙。
care	心配。気苦労。心配事。世話。
career	経歴。職業。出世。進展。
cargo	積み荷。
Caribbean	カリブ人。カリブ海。
carnival	謝肉祭。カーニバル。お祭り騒ぎ。
carnivore	肉食動物。
carp	コイ。
carpenter	大工。
carpet	じゅうたん。カーペット。
carriage	馬車。車両。うば車。運搬。運賃。
carrier	運搬人。配達人。保菌者。媒介者。キャリア。
carrot	ニンジン。
cartel	カルテル。企業連合。挑戦状。
cartoon	風刺漫画。時事漫画。続き漫画。
cartridge	カートリッジ。カセット。薬きょう。
carving	彫刻。彫り物。
case	場合。事情。事件。容器。
cash	現金。
cashbook	現金出納帳。
cashier	出納係。会計。レジ。
casino	カジノ。
cassette	カセット。
cast	投げること。配役。キャスト。傾向。
castanet	カスタネット。
castle	城。大邸宅。
cat	猫。
catalog	カタログ。目録。
catch	捕らえること。獲物。留め金。わな。
catcher	捕手。キャッチャー。
category	範疇。カテゴリー。部門。
caterpillar	毛虫、いも虫。キャタピラー。
catfish	ナマズ。
Catholic	カトリック教徒。旧教徒。
cattle	牛。家畜。
cause	原因。理由。主義。訴訟。
caution	用心。慎重さ。警告。
cave	ほら穴。
cavern	ほら穴。(大きな)洞窟。
caviar	キャビア。
CD	コンパクトディスク。
cease	終止。「絶え間なく」＝``without ～''
ceiling	天井。最高限度。
celeb	名士。有名人。セレブ。
celebration	祝賀。祝典。賞賛。
celery	セロリ。
cell	細胞。小部屋。電池。
cellar	地下室。ワインの蓄え。最下位。
cello	チェロ。
cellophane	セロハン。
cement	セメント。
censor	検閲。風紀係。センサー。
censorship	検閲制度。検閲職。
censure	激しい非難。厳しい批判。とがめ。
census	国勢調査。人口調査。センサス。
center	中心。中央。真ん中。中心地。センター。
centimeter	センチメートル。
century	世紀。
CEO	最高経営責任者。
cereal	穀類。穀物。加工穀物食。
ceremony	儀式。式典。礼儀。
certificate	証明書。証券。
CG	コンピューターグラフィックス。
chain	くさり。連なり。束縛。
chair	（１人用で背もたれのある）いす。
chairman	議長。委員長。司会者。
chalk	チョーク。
challenge	挑戦。異議申し立て。呼びとめ。
chamber	部屋。寝室。議場。判事室。
chameleon	カメレオン。
champ	チャンピオンの略。
champion	優勝者。チャンピオン。
chance	機会。チャンス。偶然。可能性。
change	変化。変更。取替え。つり銭。
channel	海峡。水路。チャンネル。伝達手段。
chant	唱歌。さえずり。
chaos	無秩序。混沌状態。カオス。
chapel	礼拝堂。礼拝室。礼拝。
chapter	章。支部。総会。
character	個性。特質。人格。登場人物。文字。
charcoal	木炭。炭。
charge	料金。費用。責任。預かり物。告発。攻撃。充電。
charity	慈悲。事前。慈善事業。チャリティー。
charm	魅力。女性の美しさ。お守り。まじない。
chart	図表。海図。
charter	特許状。特権。宣言。憲章。貸切。チャーター。
chase	追跡。追撃。狩猟。
chat	雑談。おしゃべり。
chatter	おしゃべり。鳥やサルなどが鳴く声。
cheat	詐欺。不正行為。詐欺師。
check	照合。チェック。小切手。勘定書。抑制。
checker	格子じま。市松模様。
cheek	ほお。なまいき。
cheer	応援。声援。気分。食べ物。
cheese	チーズ。
cheesecake	チーズケーキ。
cheetah	チーター。
chef	コック長。シェフ。
chemical	化学物質。
chemist	化学者。
chemistry	化学。
cherry	サクラ。サクランボ。
chess	チェス。
chessboard	チェス盤。
chest	大箱。胸。金庫。たんす。
chestnut	クリの木。クリの実。
chew	かむこと。一かみ。
chick	ひな鳥。ひよこ。子供。小娘。
chicken	ニワトリ。ひな鳥。ひよこ。鶏肉。
chief	長。首領。
child	子供。児童。幼児。子。
childhood	幼年時代。子供のころ。
children	子供たち。
Chile	チリ。
chill	冷たさ。冷気。寒気。
chime	チャイム。一組の鐘。調和。
chimney	煙突。火山の噴煙口。
chimpanzee	チンパンジー。
chin	あご。下あご。
China	中国。
Chinatown	中華街。
chinaware	陶磁器。
Chinese	中国人。中国語。
chip	切れ端。かけら。
chocolate	チョコレート。
choice	選択。選択権。選ばれたもの。
choke	窒息。
chop	たたき切ること。切断。肉片。一撃。
chord	和音。弦。感情。
chorus	合唱。コーラス。合唱隊。合唱曲。
Christ	キリスト。
Christian	キリスト教徒。クリスチャン。
Christmas	クリスマス。
chromosome	染色体。
chronicle	年代記。歴史。
chuckle	くすくす笑い。
chunk	厚切り。大きなかたまり。
church	教会。礼拝。聖職。
cigar	葉巻きタバコ。シガー。
cigarette	紙巻きタバコ。
cinema	映画館。映画。
circle	円。円周。サークル。
circuit	一周。回路。サーキット。
circulation	循環。流通。発行部数。
circumstance	周囲の状況。環境。境遇。
circus	サーカス。
citrus	かんきつ類。シトラス。
city	都市。都会。市。
civilian	一般市民。民間人。
civilization	文明。文明世界。文明開化。
claim	要求。請求。主張。断言。クレーム。
clam	二枚貝。口のかたい人。
clap	ピシャッという音。平手打ち。雷のとどろく音。
clapping	拍手。
Clara	クララ。女子の名。
clash	ガチャンという音。衝突。対立。
clasp	留め金。しっかり握ること。しっかり抱くこと。
class	学級。クラス。授業。等級。階級。
classic	名作。決定版。古典。
classmate	級友。クラスメート。
classroom	教室。クラスルーム。
clatter	カチャカチャ、ガラガラという音。ざわめき。
clause	(文法の)節。
claw	つめ。はさみ。
clay	粘土。泥土。
cleaner	掃除機。清掃員。洗剤。
cleaning	掃除。洗濯。
cleanness	清潔。潔白。
cleanser	洗剤。クレンザー。磨き粉。清掃係。消毒係。
clearance	一掃。在庫一掃セール。すきま。船の通関手続き。
clearness	明るさ。明確。潔白。
clerk	乗務員。事務官。店員。
cleverness	りこう。器用さ。巧妙さ。
click	カチッという音。クリック。
client	依頼人。顧客。
cliff	絶壁。
climate	気候。風土。
climax	最高潮。頂点。クライマックス。
climb	よじ登ること。上昇。登山。
climber	登山者。よじ登る人。
climbing	登ること。登山。
cling	粘着。密着。
clip	クリップ。刈り込み。
cloak	そでなしの外とう。マント。
clock	時計。
clockwork	時計仕掛け。
close	終わり。閉店。
closet	押入れ。クローゼット。
closeup	クローズアップ。
cloth	布。布切れ。
clothes	衣服。寝具。
clothing	衣服。衣料。
cloud	雲。暗雲。くもり。
clover	クローバー。
clown	道化。道化役者。おどけ者。
club	こん棒。クラブ。
clue	手がかり。
cluster	花・果実などのふさ。群れ。集団。
clutch	ぐっとつかむこと。(自動車などの)クラッチ。
cm	センチメートル。
Co	コバルトの元素記号。
coach	コーチ。技術指導者。家庭教師。乗り合いバス。普通客車。
coal	石炭。
coalition	連立。一体化。
coast	海岸。沿岸。
coaster	沿岸貿易船。「ジェットコースター」＝``roller ～''
coat	コート。上着。
coating	コーティング。塗装。ころも。
cobalt	コバルト。
cobra	アフリカ・南アジアにすむ毒蛇、コブラ。
cocaine	コカイン。
cock	おんどり。雄鳥。栓。コック。
cockpit	操縦室。コックピット。
cockroach	ゴキブリ。
cocktail	カクテル。
cocoa	ココア。
coconut	ココナッツ。
cod	魚のタラ。
code	信号法。符号。暗号。決まり。法典。
codfish	魚のタラ。
coffee	コーヒー。
coffin	棺おけ。ひつぎ。
coil	ぐるぐる巻いたもの。コイル。
coin	硬貨。コイン。
cold	寒さ。冷気。風邪。
collapse	倒壊。崩壊。失敗。挫折。
collar	えり。カラー。
collection	収集。収集物。募金。
collector	収集家。コレクター。
college	単科大学。専門学校。大学。カレッジ。
collision	衝突。
colonel	陸軍大佐。
colony	植民地。群落。
color	色。色彩。絵の具。旗。顔色。特色。
Colorado	コロラド。
colt	雄の子馬。新米。
Columbus	コロンブス。
column	円柱。欄。コラム。
comb	くし。とさか。
combat	戦い。戦闘。競争。論戦。
combination	結合。連合。組合せ。
combine	企業の合併。刈り取りと脱穀が同時にできる農機具。コンバイン。
comeback	返り咲き。カムバック。回復。
comedian	喜劇役者。コメディアン。
comedy	喜劇。コメディー。
comet	彗星。ほうき星。
comfort	なぐさめ。慰安。安楽。気楽。快適。
comic	漫画。漫画本。喜劇映画。
comma	コンマ（,）。
command	命令。指揮。支配力。見晴らし。
commander	指揮者。陸軍中佐。
comment	解説。論評。意見。コメント。
commerce	商業。通商。貿易。
commercial	広告放送。コマーシャル。
commission	委任。委託。任務。命令。権限。委員会。手数料。
commitment	委託。拘留。監禁。確約。公約。
committee	委員会。
commodity	日用品。必需品。商品。
common	共有地。公有地。共有権。
commonplace	ありふれたこと。
communism	共産主義。
communist	共産主義者。
community	共同社会。地域共同体。地域社会。
commuter	定期券。通勤者。
compact	コンパクト。契約。協定。
companion	仲間。友人。手引き。
company	会社。商会。仲間。客。
comparison	比較。たとえ。
compass	羅針盤。コンパス。
compassion	思いやり。哀れみ。同情。
competition	競争。試合。
complainer	不平・苦情を言う人。
complaint	不平。苦情。告訴。病気。
complement	補完。補語。片方。補色。
complex	複合体。精神複合。コンプレックス。固定観念。
complexion	顔色。外見。様子。
complexity	複雑さ。複雑なもの。
compliment	ほめ言葉。おせじ。あいさつ。
component	構成要素。成分。
composer	作曲家。作者。構成者。
composition	創作。作文。芸術作品。組み立て。構成。
compound	混合物。化合物。複合語。
compress	湿布。
compression	圧縮。要約。
compressor	圧縮機。コンプレッサー。
compromise	妥協。和解。折衷案。
compulsion	強制。
computer	計算機。コンピューター。
comrade	仲間。友。同士。
comsumer	消費者。
comtempt	軽べつ。侮辱。
con	反対。反対投票。反対意見。
conceit	うぬぼれ。自負心。思いつき。気まぐれ。
concentration	集中。専念。濃縮。
concept	概念。観念。コンセプト。
concern	関係。心配。関心事。事業。
concert	音楽会。演奏会。コンサート。
conclusion	結末。終結。結論。
concrete	コンクリート。
condenser	蓄電器。コンデンサー。集光レンズ。
condition	状態。条件。状況。
conditioner	調節する人。調節する物。調節装置。
condor	コンドル。
conduct	行い。振る舞い。品行。指揮。
conductor	指揮者。車掌。導体。伝導体。
cone	円すい形。
conference	会議。協議会。
confession	自白。白状。ざんげ。
confidence	信頼。信用。自信。秘密。
conflict	争い。戦い。衝突。
Confucius	中国の思想家、孔子。
confusion	混乱。混同。困惑。
congress	会議。大会。議会。
connection	関係。連想。連絡。
conqueror	征服者。勝利者。
conquest	征服。克服。
conscience	両親。道義心。
consent	同意。承諾。
consequence	結果。成り行き。重要さ。
consonant	子音。
constitution	憲法。体格。構成。構造。
construction	建造。建設。構造。建造物。構文。
consultant	顧問。コンサルタント。
consumption	消費。
contact	接触。交際。コンタクト。
container	入れ物。容器。コンテナ。
content	満足。
contents	内容。中身。目次。
contest	競技。競争。コンテスト。
context	文脈。
continent	大陸。
contract	契約。請負。契約書。
contrast	対照。対比。コントラスト。差異。
contribution	寄付。貢献。寄稿。
control	支配。管理。制御。コントロール。
controller	支配者。監督。管理人。制御装置。
convenience	便利。便利なもの。
conversation	会話。談話。
conviction	確信。信念。有罪判決。
coo	ハトの鳴き声。
cook	コック。料理人。
cookie	クッキー。
cooking	料理。料理法。
cooler	冷却器。冷房装置。クーラー。
cooperation	協力。協同。
copper	銅。銅貨。銅製品。赤銅色。
copy	写し。複写。コピー。部。広告。
copyright	著作権。版権。
copyrighter	コピーライター。
coral	サンゴ。
cord	ひも（stringより太く、ropeより細い）。(電気の)コード。
core	芯。中心。核心。
corn	トウモロコシ。穀物。小麦。
corner	街角。すみ。コーナー。
cornstarch	コーンスターチ。トウモロコシのでんぷん。
corporation	有限会社。株式会社。法人。
correction	訂正。訂正箇所。
correctness	正しいこと。正確さ。適正。適切。
correspondence	一致。調和。文通。
correspondent	文通する人。通信員。
corridor	廊下。
corruption	堕落。腐敗。買収。なまり。
cosine	コサイン。余弦。
cosmetic	化粧品。
cosmos	宇宙。コスモス。
cost	値段。費用。経費。
cottage	小住宅。別荘。コテージ。
cotton	綿。コットン。
couch	長いす。
cough	せき。
council	会議。協議会。議会。
counsel	忠告。意見。相談。協議。
counsellor	助言者。相談相手。顧問。弁護士。カウンセラー。
count	数えること。計算。総数。評価。
countable	可算名詞。
countdown	秒読み。
counter	計算機。計算する人。勘定台。カウンター。逆のもの。
country	国。国家。祖国。いなか。
countryside	いなか。田園地方。地方の住民たち。
couple	男女一組。夫婦。
courage	勇気。
course	進路。方向。道順。進行。経過。コース。課程。教科。
court	法廷。裁判所。コート。中庭。宮廷。
courtesy	礼儀。親切。ていねいな行い。
courtmartial	軍法会議。
courtyard	中庭。前庭。
cove	入り江。
cover	覆い。カバー。表紙。隠れ場所。口実。一人前の食器。
cow	雌牛。(大型動物の)雌。
coward	臆病者。卑怯者。
cowboy	カウボーイ。
coyote	オオカミの一種、コヨーテ。
crab	カニ。カニの肉。かに座。
crack	ひび。割れ目。裂け目。ピシッという音。欠陥。一撃。
cracker	クラッカー。
cradle	ゆりかご。(theをつけて)幼年時代。受話器置き。
craft	技術。技能。職人たち。船。航空機。悪知恵。
craftsman	職人。熟練工。名工。
crane	起重機。クレーン。(動物の)ツル。
crank	クランク。変わり者。ひねった言い回し。
crash	ガチャンという音。とどろき。衝突。墜落。つぶれること。
crate	木枠。かご。
crater	噴出口。クレーター。
crawl	はうこと。徐行。(水泳の)クロール。
crayfish	ザリガニ。
crayon	クレヨン。
cream	クリーム。
creation	創造。創作。授与。
creator	創造者。
creature	生き物。人。やつ。
credit	信用。信用貸し。クレジット。名声。名誉。履修単位。貸し方。
crepe	薄いパンケーキ。クレープ。
crew	乗組員。乗務員。
cricket	(球技の)クリケット。
crime	罪。犯罪。ばかげたこと。
criminal	犯罪人。犯人。
crisis	危機。危険状態。危篤。
crisp	かりかりに揚げた薄切りジャガイモ。ポテトチップス。
critic	批評家。評論家。
criticism	批評。あら捜し。非難。
crocodile	(アフリカ・アジア産の)ワニ。
crop	作物。収穫高。集まり。群れ。いがぐり頭。
cross	十字形。十字架。受難。雑種。
crossing	横断。交差点。踏み切り。
crossroads	交差点。十字路。
crow	カラス。
crowd	群集。大勢の人々。大衆。
crown	王冠。王位。勝利の栄冠。
crush	粉砕。圧縮。雑踏。
cry	叫ぶ声。泣き声。
crystal	水晶。クリスタル。クリスタルガラス。結晶。
Cuba	キューバ。
Cuban	キューバ人。
cube	立方体。立方。
culture	教養。文化。栽培。養殖。
cunning	ずるさ。悪賢さ。
cup	茶わん。優勝カップ。人生経験。茶わんの形のもの。
cupboard	食器棚。戸棚。
Cupid	ローマ神話の恋愛の神、キューピッド。
cure	回復。治療薬。治療法。救済策。
curiosity	好奇心。珍しいもの。
curl	巻き毛。カール。
currency	流通貨幣。通貨。
current	流れ。風潮。
curry	カレー粉。カレー料理。
curse	のろい。たたり。災い。
curtain	カーテン。幕。
curve	曲線。湾曲。カーブ。
cushion	クッション。座布団。
custard	牛乳、卵、砂糖を混ぜて作ったお菓子。カスタード。
custom	慣習。風習。習慣。関税。
customer	お客。得意先。
cut	切断。切り傷。切り身。散髪。削減。省略。
cutter	切る道具。カッター。
cutting	切断。裁断。切り抜き。
cycle	周期。サイクル。自転車。
cylinder	円筒。円柱。シリンダー。
cymbal	(打楽器の)シンバル。
dad	お父さん。
daddy	お父ちゃん。
dagger	短剣。ダガー。参照符。
dahlia	ダリア。
daily	日刊新聞。
dairy	バター・チーズ製造所。乳製品製造・販売。酪農場。
dam	ダム。せき。
damage	損害。被害。
damn	のろいの言葉。ののしり。
damp	湿気。霧。もや。
dampness	湿気。
dance	ダンス。踊り。ダンスパーティー。
dancer	舞踊家。ダンサー。
dancing	舞踊。ダンスをすること。
dandelion	タンポポ。
Dane	デンマーク人。
danger	危険。危険なもの。
Daniel	ダニエル。男子の名。
Danish	デンマーク語。
dark	暗闇。夕暮れ。
darkness	暗さ。暗闇。
darkroom	暗室。
darling	かわいい人。最愛の人。
dart	投げ矢。ダーツ。針。
Darwin	進化論を唱えた英国の生物学者、ダーウィン。
dash	突進。突撃。激しく打つこと。短距離競争。ダッシュ記号（―）。
data	資料。データ。
date	日付。年月日。年代。会う約束。デート。
daughter	娘。
David	デービッド。男子の名。
dawn	夜明け。明け方。始まり。
day	日。昼間。一日。
daybreak	夜明け。
daydream	白昼夢。空想。
daylight	日光。昼間。夜明け。明け方。
daytime	昼間。日中。
DC	直流。
dead	(theをつけて)死者たち。
deadline	締め切り。
deafness	耳の遠いこと。難聴。
deal	量。分量。取引。取り扱い。配分。
dealer	商人。卸業者。ディーラー。
dealing	取引関係。交際関係。配分。
dear	かわいい人。愛する人。
death	死。死亡。
debate	討論。ディベート。
debt	借金。
debtor	借り主。債務者。
debut	デビュー。
Dec	十二月。
decade	十年間。
decay	腐敗。衰え。
decease	死亡。
December	十二月。
decimal	小数。
decision	決定。決心。判決。決断力。
deck	甲板。デッキ。
declaration	宣言。布告。断言。
decoration	装飾。飾り。勲章。
decrease	減少。
deed	行い。行為。実行。
deep	深い所。
deer	シカ。
defeat	負かすこと。打破。敗北。
defect	欠陥。欠点。不足。
defendant	被告。
defender	防御者。弁護者。選手権保持者。
defense	防ぐこと。防御。弁護。
definition	定義。
degree	程度。度。学位。称号。
delay	遅れること。延期。
delicacy	優美。繊細さ。敏感さ。気づかい。
delight	大喜び。うれしさ。楽しいもの。
delivery	配達。配達物。引渡し。
delta	ギリシャ文字のデルタ（Δ、δ）。三角形のもの。
deluxe	デラックス。豪華版。
demand	要求。請求。需要。
democracy	民主主義。民主主義国。
democrat	民主主義者。
demon	悪魔。
demonstration	証明。公開実演。デモ。
denial	否定。拒絶。
denim	デニム。
Denmark	欧州北部の王国、デンマーク。
dentist	歯科医。歯医者。
department	部門。省。学部。科。
departure	出発。離脱。
dependence	頼ること。依存。信頼。
dependency	属国。保護領。従属物。
dependent	居候。扶養家族。
deposit	担保。敷金。預金。デポジット。
depression	ゆううつ。不景気。不況。沈下。
depth	深さ。奥行き。
descent	降下。下り坂。家系。
description	描写。叙述。説明書。種類。
design	設計。計画。図案。デザイン。
designer	設計者。図案家。デザイナー。
desire	願望。望みのもの。
desk	机。受付。
despair	絶望。
dessert	デザート。
destination	目的地。あて先。届け先。
destiny	運命。宿命。
destroyer	破壊者。駆逐艦。
destruction	破壊。滅亡。破滅。
details	詳細。
detector	探知器。発見器。検電器。検波器。検出器。
Detroit	デトロイト。
developer	開発者。現像液。
development	開発。発達。発展。発育。現像。
device	工夫。仕掛け。装置。
devil	悪魔。悪霊。
dew	露。
diagnosis	診断。
diagram	図。図形。図表。設計図。略図。ダイヤ。
dial	文字盤。(電話・ラジオなどの)ダイヤル。日時計。
dialog	対話。問答。
dialogue	対話。問答。
diameter	直径。
diamond	ダイヤモンド。金剛石。ひし形。野球の内野。
diary	日記。日誌。日記帳。
dice	さいころの複数形。
dictation	聞き取り。命令。指図。
dictionary	辞書。辞典。字引。
diet	規定食。ダイエット。議会。
difference	違い。差異。相違点。差。
difficulty	難しさ。困難。難しいこと。
dig	一掘り。発掘。小突くこと。
digestion	消化。会得。同化。
digit	指。アラビア数字。
dignity	威厳。気品。尊さ。高官。
diligence	勤勉。熱心さ。
dillemma	ジレンマ。板ばさみ。窮地。
dime	(米国・カナダの)十セント銀貨。ダイム。
dimension	次元。
dinasaur	恐竜。
dinner	晩餐。夕食。ディナー。
diploma	卒業証書。賞状。
diplomacy	外交。外交術。
diplomat	外交官。
direction	方向。方角。指導。宛名。
director	指導者。重役。監督。
dirt	ごみ。ほこり。泥。
disadvantage	不利。不便。不利益。
disagreement	不一致。不調和。相違。争い。食中毒。
disaster	天災。災害。不幸。災難。
discharge	解雇。八方。放電。荷揚げ。支払い。履行。
discipline	訓練。鍛錬。規律。風紀。
disco	ディスコ。
discomfort	不快。「不快指数」＝``～ index''
discontent	不平。不満。不愉快。
discount	割引。
discoverer	発見者。
discovery	発見。
discretion	思慮。分別。慎重さ。自由。任意。
discussion	話し合い。議論。
disease	病気。
disgrace	不名誉。恥。不評。
disgust	いやけ。むかつき。嫌悪感。うんざり。
dish	皿。料理。ごちそう。
dishonor	不名誉。恥。侮辱。無礼。
disorder	混乱。乱雑。無秩序。不調。
dispatch	発送。派遣。速達。
dispenser	薬剤師。自動販売機。
display	展示。陳列。ディスプレイ。表示装置。
disposal	処分。売却。配置。
disposition	気質。傾向。配置。
dispute	論争。討論。けんか。
distance	距離。遠方。へだたり。
distinction	区別。相違点。特徴。名誉。著名。
distres	悩み。苦悩。悲痛。困難。(船の)遭難。
distribution	分配。配布。分布。
district	地方。地域。地区。
ditch	みぞ。どぶ。堀。
dive	潜水。
diver	潜水夫。海女。飛び込む人。
dividend	被除数。配当金。
divider	分割者。分配者。
divine	神学者。牧師。
diving	ダイビング。
division	分割。分配。区分。局。課。
divisor	除数。約数。
DJ	ディスクジョッキー。
divorce	離婚。絶縁。
dock	波止場。ドック。
docking	ドッキング。
dockyard	造船所。
doctor	医者。医師。博士。博士号。
document	書類。記録文書。証書。
documentary	記録物。実録。ドキュメンタリー。
dog	犬。やつ。
doghouse	犬小屋。
doing	すること。実行。
doll	人形。
dollar	ドル。
dolphin	イルカ。
domain	領地。領土。所有地。領域。ドメイン。
dome	ドーム。丸屋根。丸天井。
domination	統治。君臨。優勢。
dominion	統治権。主権。支配。
domino	ドミノ。
donation	寄付。寄贈。寄付金。寄贈品。
donkey	ロバ。頑固者。ばか者。
donor	提供者。ドナー。
donut	ドーナツ。
doom	(悪い)運命。破滅。最後の審判。
door	戸。扉。ドア。
doorbell	玄関のベル。呼び鈴。
doorknob	ドアの取っ手。ドアノブ。
doorway	戸口。出入り口。
dose	(薬の)一服。一回分の量。
dot	小さな点。ドット。
double	二倍。倍。
doubt	疑い。疑惑。不振。
doughnut	ドーナツ。
dove	(pigeonより小さい種類の)ハト。ハト派。
doz	ダース。十二個。
doze	居眠り。うたたね。
dozen	ダース。十二個。
Dr	ドクター。
draft	線描。草案。通風。引くこと。徴兵。金の引き出し。一飲み。
dragon	竜。ドラゴン。
dragonfly	トンボ。
drain	排水管。流出。浪費。
drainage	排水。放水。排水路。下水。
drama	演劇。芝居。劇。ドラマ。
draw	引くこと。くじ引き。呼び物。引き分け。
drawer	引き出し。
drawing	絵。スケッチ。製図。引くこと。くじ引き。
dread	恐れ。不安。心配。
dream	夢。夢心地。理想。幻想。
dreamer	夢見る人。
dreamland	夢の国。
dress	婦人服。衣服。服装。正装。ドレス。
dressing	着付け。ドレッシング。
drier	乾燥機。ドライヤー。
drift	漂流。流されること。吹き溜まり。流れ。
drill	訓練。練習。きり。穴あけ機。ドリル。
drink	飲み物。飲料。酒。一杯。
drip	しずく。したたること。
drive	ドライブ。自動車道。距離。やる気。
driver	運転手。ねじ回し。ドライバー。
driveway	私道。自動車道。
drop	しずく。落下。あめ玉。一滴。
dropout	中途退学者。脱落者。落ちこぼれ。
drug	薬。薬品。薬剤。
drugstore	ドラッグストア。
drum	ドラム。太鼓。太鼓の音。鼓膜。
drumbeat	太鼓の音。
drummer	ドラム奏者。ドラマー。
duck	カモ。アヒル。かわいい人。
duckbill	カモノハシ。
duckling	小ガモ。アヒルの子。
due	当然受けるべきもの。正当な報酬。税。料金。
duel	闘争。抗争。
duet	二重奏。二重唱。
dummy	見本。偽物。替え玉。ダミー。マネキン人形。
dump	ドシンという音。ごみの山。ゴミ捨て場。
dumping	投げ捨て。投げ売り。ダンピング。
duplicate	複製。複写。写し。控え。
duration	持続。継続。寿命。
dusk	たそがれ。夕闇。
dust	ほこり。ちり。粉。
Dutch	オランダ人。オランダ語。「割り勘にする」＝``go ～''
duty	義務。職務。税。
DVD	デジタル・ビデオ・ディスクの略。
dwarf	小人。小さいもの。
dye	染料。
dyeing	染色。
dying	臨終。死。
dynamite	ダイナマイト。
dz	ダース。
each	それぞれ。
eagerness	熱心。熱望。
eagle	ワシ。
ear	耳。聴覚。
earl	(英国の)伯爵。
earnest	まじめ。本気。
earnings	稼いだ金。所得。もうけ。
earphone	イヤホン。
earring	耳飾り。イヤリング。
earth	(theをつけて)地球。地。土。アース。
earthenware	土器。陶器。
earthquake	地震。
earthworm	ミミズ。
ease	容易さ。たやすさ。気楽。ゆるみ。
east	(theをつけて)東。東方。東部。東洋。
Easter	イースター。復活祭。
eater	食べる人。
eating	食べること。食事。食べ物。
eccentric	奇人。変人。
echo	こだま。反響。受け売り。
eclipse	(日食・月食などの)食。失墜。
ecology	生態学。
economics	経済学。経済状態。
economist	経済学者。
economy	経済。倹約。
ecstasy	有頂天。うっとりした状態。
Ecuador	エクアドル。
Eden	エデンの園。楽園。
Edgar	エドガー。男子の名。
edge	ふち。へり。端。刃。鋭さ。
Edison	アメリカの発明家、エジソン。
edition	(本・雑誌などの)版。エディション。
editor	編集者。
education	教育。教育学。
educator	教育者。教師。
Ed	エド。エドガーとエドワードの略称。
Edward	エドワード。男子の名。
eel	ウナギ。
effect	結果。効力。効果。働き。趣旨。
efficiency	能率。効率。
effort	努力。骨折り。
egg	卵。卵子。やつ。
eggplant	ナス。ナスビ。
eggshell	卵の殻。
ego	自我。うぬぼれ。
Egypt	エジプト。
Egyptian	エジプト人。エジプト語。
Eiffel	「エッフェル塔」＝``～ Tower''
eight	八つ。八時。八歳。八人。
eighteen	十八。十八人。十八個。十八歳。
eighth	(theをつけて)第八。八番目。(anかoneをつけて)八分の一。
eightieth	(theをつけて)八十番目。(anかoneをつけて)八十分の一。
either	どちらか。どちらでも。
elastic	ゴムひも。
elbow	ひじ。ひじかけ。L字形のもの。
elder	年上の人。先輩。
election	選挙。選出。当選。
electricity	電気。電流。
electrode	電極。
electron	電子。エレクトロン。
electronics	電子工学。
elegance	優美。上品。優雅。気品。
element	要素。元素。
elephant	象。
elevation	高めること。昇進。向上。高み。正面図。
elevator	エレベーター。
eleven	十一。十一人。十一個。十一時。
eleventh	第十一。十一番目。(月の)十一日。(theかanをつけて)十一分の一。
elf	小妖精。エルフ。
elite	(theをつけて)えり抜きの人々。エリート。
Elizabeth	エリザベス。英国の女王。女子の名。
ellipse	楕円。
elves	エルフの複数形。
embarrassment	困惑。当惑させること。
embassy	大使館。大使の職。
emblem	象徴。しるし。記章。エンブレム。
emerald	鉱物・宝石のエメラルド。
emergency	非常事態。
emigrant	(他国へ出て行く)移住者。
emigration	(他国へ出て行く)移住。
emotion	感情。情緒。感動。
emperor	皇帝。帝王。天皇。
emphasis	強調。
empire	定刻。
employ	雇用。勤務。
employee	雇われ人。従業員。
employer	雇い主。雇用者。
employment	雇用。使用。勤め。仕事。職業。
empty	空き箱。空き瓶。
enamel	エナメル。
enclosure	包囲。囲うこと。囲うもの。柵。同封。
encore	アンコール。もう一度。
encounter	遭遇。交戦。
encouragement	激励。奨励。刺激。
encyclopedia	百科事典。
end	終わり。最後。先端。目的。目標。
endeavor	努力。
ending	終わり。終了。結末。死。
endurance	忍耐。我慢。耐久力。持久力。
enemy	敵。敵国。敵軍。
energy	精力。元気。活動力。エネルギー。
engagement	約束。契約。予約。婚約。
engine	エンジン。発動機。
engineer	技師。技術者。エンジニア。
engineering	工学。
England	イングランド。
English	英語。(theをつけて)イギリス人。
enjoyment	楽しみ。楽しむこと。喜び。
enough	十分。たっぷり。
enrichment	質の向上。豊かにすること。
entent	広がり。広さ。大きさ。範囲。程度。限界。
enterprise	事業。企て。企業。
entertainer	芸能人。楽しませる人。エンターテイナー。
entertainment	もてなし。余興。演芸。催し物。
enthusiasm	熱狂。熱中。
entity	実在するもの。実体。
entrance	入ること。入学。入場。入り口。入場許可。
entry	入り口。入ること。入場。記入。事項。
envelope	封筒。包むもの。
environment	環境。周囲の状況。
envy	うらやみ。嫉妬。
episode	エピソード。挿話。
epoch	新時代。記念すべき瞬間。
equal	同等のもの。等号。
equality	等しいこと。平等。
equator	(theをつけて)赤道。
equipment	用意。準備。備品。装備。素養。
era	時代。時期。年号。紀元。
eraser	消しゴム。黒板消し。インク消し。
errand	使い。使い走り。用件。
error	間違い。思い違い。考え違い。過失。
escalator	エスカレーター。
escape	逃亡。脱出。まぬがれること。逃げる手段。漏れ出すこと。
escort	護衛。護衛者。付き添いの男性。
essay	評論。随筆。エッセー。
essayist	随筆家。エッセイスト。
essence	本質。エキス。香水。
essential	本質的要素。不可欠なもの。要点。
establishment	設立。創立。樹立。施設。
estate	地所。財産。財産権。遺産。団地。
esteem	尊敬。尊重。
estimate	見積もり。見積書。
ET	地球外生物。
etc	ラテン語のet ceteraの略。...など。and so forthまたはand so onと読む。
eternity	永遠。永久。不死。不滅。来世・死後の世界。
ether	エーテル。
ethics	倫理学。道徳。倫理。
etiquette	礼儀作法。エチケット。
EU	欧州連合。
Eurasia	ユーラシア。欧亜大陸。
Europe	ヨーロッパ。欧州。
European	ヨーロッパ人。
evaluation	評価。数値を求めること。
eve	前日。前夜。
evening	晩。夕方。末期。夜会。
event	出来事。事件。イベント。
Everest	(Mt.をつけて)エベレスト山。
everybody	誰でも。みんな。
everything	何もかも。全部。すべて。
evidence	証拠。証言。形跡。
evil	悪。罪悪。害悪。災い。不幸。
evolution	進化。発展。発達。展開。
ex	エックス。Ｘ字形のもの。前の人。昔の恋人。
exaggeration	誇張。
exam	試験。検査。～inationの略。
examiner	試験官。検査官。審査員。調査官。
example	例。実例。例題。手本。模範。見せしめ。
excellence	優秀。優れていること。美点。
exception	例外。除外。
excess	超過。過度。暴飲。暴食。
exchange	交換。取替え。両替。為替。
excitement	興奮。わくわくすること。刺激。
exclamation	叫び。絶叫。感嘆。
excretion	排泄。排泄物。
excuse	言い訳。弁解。口実。
execution	実行。遂行。実施。処刑。制作。演奏。
exercise	練習。けいこ。練習問題。運動。儀式。
exhaust	排気装置。排気ガス。
exhibit	陳列。展示。展示会。証拠書類。
exhibition	展覧。展示。陳列。展覧会。
exile	国外追放。流罪。亡命。追放された人。
existence	存在。実在。生存。生活。
exit	出口。退出。退去。退場。
expanse	(広々とした)広がり。
expansion	拡大。拡張。膨張。発展。展開。
expectation	期待。期待されるもの。
expedition	探検。遠征。探検隊。急速。敏速。
expenditure	支出。消費。経費。費用。
expense	出費。支出。費用。経費。
experience	経験。体験。経験したこと。
experiment	実験。
expert	専門家。熟練者。くろうと。
explanation	説明。解釈。弁明。弁解。
exploration	探検。調査。探求。精密検査。
explorer	探検家。探求者。
explosion	爆発。破裂。爆発音。
export	輸出。輸出品。
exposuer	さらされること。暴露。発覚。陳列。露出。
express	速達便。急行便。急行列車。急行バス。特使。
expression	表現。表示。表情。
extension	拡大。延長。延期。広げた部分。
exterior	外部。外側。外観。
external	外部。外面。外形。外観。
extinguisher	消火器。
extra	号外。余分のもの。番外。エクストラ。追加料金。
extract	抽出物。エキス。抜粋。
extreme	極端。
eye	目。見分ける力。視力。視覚。視線。
eyebrow	まゆ。まゆ毛。
eyelid	まぶた。
eyesight	視力。視界。
fable	寓話。たとえ話。
face	顔。表情。表面。外観。面目。
facility	設備。施設。機関。便利さ。器用。腕前。
fact	事実。真相。犯行。
factor	要素。要因。因数。約数。代理人。
factory	工場。製作所。
faculty	才能。能力。機能。働き。学部。教職員。
Fahrenheit	カ氏温度計。
failure	失敗。不成功。失敗者。怠慢。不履行。不作。衰弱。
fair	品評会。博覧会。説明会。
fairy	妖精。
fairyland	妖精の国。
faith	信頼。信用。信仰。信念。誓約。誠実。
fake	模造品。偽造品。
fall	落下。転倒。降雨。降雪。低下。滅亡。秋。
fame	名声。有名なこと。評判。
family	家族。(家族の)子供たち。一族。
famine	飢きん。飢え。
fan	うちわ。扇風機。ファン。
fancy	空想。想像。好み。愛好。
fantasy	空想。夢想。空想作品。幻想曲。
fare	運賃。乗客。飲食物。料理。
farewell	別れ。別れの言葉。
farm	農場。農園。飼育場。養殖場。二軍。
farmer	農場主。農業労働者。
farmhouse	農場内の家屋。農家。
fascism	ファシズム。全体主義的政治体制。
fascist	ファシスト。独裁者。全体主義者。
fassion	流行。ファッション。流儀。
fast	断食。断食期間。
fastener	ファスナー。
fat	脂身。脂肪。
fate	運命。宿命。死。破滅。
father	父。父親。
fatigue	疲れ。疲労。
fault	欠点。短所。過失。誤り。責任。
favor	好意。親切。ひいき。支持。
favorite	お気に入り。人気者。本命。
FBI	連邦捜査局。
Fe	鉄の元素記号。
fear	恐怖。不安。心配。畏怖。
feast	祝宴。祝祭。楽しませるもの。
feather	羽。羽毛。
feature	特徴。特色。顔の造作(の一部)。顔つき。目玉商品。代表作。
Feb	二月。
February	二月。
fee	謝礼。料金。手数料。授業料。
feeder	食べる人。食べる動物。哺乳びん。
feel	手触り。肌触り。感触。気分。
feeler	触覚。触手。触毛。打診。
feeling	感覚。気持ち。触覚。感情。印象。同情。
feet	footの複数形。
feint	見せ掛け。フェイント。
fellow	男。仲間。特別研究員。フェロー。学会の会員。
felt	フェルト。フェルト製品。
female	女性。雌。
feminist	男女同権論者。フェミニスト。
fence	垣根。へい。さく。囲い。フェンス。
fencing	フェンシング。
fender	フェンダー。泥よけ。緩衝装置。
fern	シダ。
ferry	渡し船。連絡船。フェリー。
fertilizer	肥料。受精媒介者。
festival	祝祭。祭り。
feudalism	封建制度。
fever	熱。発熱。熱病。熱中。フィーバー。
few	少数の人。少数のもの。
fiber	繊維。
fiction	作り話。フィクション。
field	野原。牧草地。競技場。広がり。分野。
fifteen	十五。十五人。十五歳。十五個。
fifteenth	第十五。十五番目。(月の)十五日。(aかoneをつけて)十五分の一。
fifth	第五。五番目。(月の)五日。(aかoneをつけて)五分の一。
fifty	五十。五十人。五十個。五十歳。
fig	イチジク。
fight	戦い。けんか。格闘。論争。
fighter	戦士。闘士。戦闘機。
figure	数字。桁。図。図形。姿。人物。
file	ファイル。
Filipino	フィリピン人。
fillet	ヒレ肉。(骨のない)切り身。
filling	詰め物。中身。
film	フィルム。映画。薄い膜。
filter	ろ過器。フィルター。
fin	(魚の)ひれ。(飛行機の)垂直安定板。
finance	財政。財源。
find	掘り出し物。
finder	発見者。ファインダー。
fine	罰金。
finger	(手の)指。
fingernail	指のつめ。
fingerprint	指紋。
finish	終わり。結末。完成。仕上げ。
Finland	フィンランド。
Finn	フィンランド人。
Finnish	フィンランド語。
fire	火。火事。発砲。
firecracker	爆竹。
fireplace	暖炉。
firewood	まき。たきぎ。
fireworks	花火。
firm	商社。商店。事務所。
first	第一。一番目。一位。最初。(月の)一日。
fish	魚。
fisherman	漁師。釣り人。
fishing	釣り。魚とり。漁業。
fist	握りこぶし。げんこつ。
fit	ぴったり合うこと。適合。(病気の)発作。
five	五つ。五人。五個。五時。
fix	苦境。窮地。位置。注射。具合。修理。賄賂。買収。
fixer	八百長をさせる人。修理する人。フィクサー。
flag	旗。国旗。
flake	薄片。破片。断片。フレーク。
flame	炎。火炎。まばゆい輝き。情熱。
flamingo	フラミンゴ。
flap	垂れ下がったもの。(封筒の)垂れぶた。(魚の)えらぶた。耳。フラップ。
flash	ひらめき。(写真の)フラッシュ。ニュース速報。
flashlight	懐中電灯。閃光（せんこう）。
flask	フラスコ。
flat	平たい部分。平地。(音楽の)フラット。パンクしたタイヤ。
flavor	味。風味。香り。におい。
flea	ノミ。
fleck	しみ。そばかす。斑点。少量。
fleece	(羊などの)毛。一頭分の羊毛。ふわふわしたもの。
fleet	艦隊。船団。部隊。
flesh	(生き物の)肉。果肉。生き物。
flick	軽くたたくこと。はじくこと。めくること。(ペンキなどの)はね。
flies	flyの複数形。
flight	飛行。飛行機の旅。階段の一続き。
fling	ほうり投げ。悪口。
float	浮き。浮き袋。山車。フロート。
flock	(羊・ヤギ・鳥などの)群れ。
flood	洪水。大水。満潮。
floor	床。階。
flour	小麦粉。穀物の粉。
flow	流れ。流出。はんらん。
flower	花。草花。開花。満開。花盛り。
flu	インフルエンザ。
fluid	流体。
flush	どっと流れること。水を流すこと。殺到。赤面。
flute	フルート。横笛。
flutist	フルート奏者。笛吹き。
flutter	羽ばたき。はためき。(心臓の)動悸。動揺。
fly	フライ。ハエ。
foam	ひとかたまりの泡。
focus	焦点。
fog	mistより濃い霧。くもり。
foil	箔。「金箔」＝``gold ～''
fold	折り目。ひだ。
folder	フォルダー。ファイルをまとめて入れておく場所。
folks	人々。家族。みなさん。
follower	支持者。追っ手。
following	(theをつけて)次に述べるもの。
food	食べ物。食料。食品。
fool	ばか者。愚か者。道化師。
foot	足（くるぶしから下の部分）。長さの単位、フィート。
football	フットボール。サッカー。ラグビー。
footprint	足跡。
footstep	足取り。足音。足跡。
footwork	足さばき。フットワーク。
force	力。勢い。暴力。軍隊。部隊。影響力。効力。意味。
forecast	予報。予想。
forehead	額。前面。
foreigner	外国人。外国製品。よそ者。
forest	森林。森。
forgery	偽造。偽造罪。
fork	フォーク。熊手。分岐点。
form	形。姿。形式。書式。書き込み用紙。作法。
formation	形成。編成。構成物。隊形。
formula	(数学の)公式。式。決まり文句。
fortieth	第四十。四十番目。(aかoneをつけて)四十分の一。
fortune	富。財産。運勢。幸運。
forty	四十。四十人。四十個。四十歳。
forum	フォーラム。討論会。法廷。
fossil	化石。
foul	反則。(野球の)ファウル。
foundation	土台。基礎。理由。根拠。設立。財団。
founder	創立者。設立者。
fountain	泉。噴水。
four	四つ。四人。四歳。四時。
fourteen	十四。十四人。十四歳。
fourteenth	第十四。十四番目。(月の)十四日。(aかoneをつけて)十四分の一。
fourth	第四。四番目。(月の)四日。(aかoneをつけて)四分の一。
fox	キツネ。
fraction	分数。部分。断片。
fragment	破片。断片。
fragrance	香気。芳香。
frame	骨組み。わく。フレーム。気分。
framework	骨組み。構造。組織。
France	フランス。
franchise	製造者が販売業者に与える独占販売権。フランチャイズ。
Francis	フランシス。男子の名。
Franklin	米国の政治家・科学者で避雷針の発明者、フランクリン。
freedom	自由。率直さ。
freestyle	自由形。
freezer	冷凍庫。
freight	貨物。積み荷。貨物輸送。運賃。貨物列車。
French	フランス語。フランス人。
frequency	頻発。頻度。脈拍数。振動数。周波数。
fresher	新入生。
freshman	新入生。新入り。
Fri	金曜日。
Friday	金曜日。
fridge	冷蔵庫。
friend	友達。友人。味方。仲間。
friendship	友情。
fright	(突然の激しい)恐怖。ぞっとさせるもの。
frill	ひだ飾り。フリル。
frog	カエル。
front	正面。前面。表。戦線。前線。態度。
frontier	国境。辺境。未開拓分野。
Frorida	フロリダ。
frost	霜（しも）。
fruit	果物。果実。フルーツ。
frustration	挫折。欲求不満。フラストレーション。
fry	揚げ物。フライ。
fuel	燃料。
full	いっぱい。真っ盛り。全部。
fume	(強いにおいの)煙。排気ガス。蒸気。
fun	楽しみ。喜び。面白み。冗談。
function	機能。働き。任務。大きな催し。関数。
fund	資金。基金。財源。
funeral	葬式。葬儀。告別式。葬列。
fungi	fungusの複数形。
fungus	キノコ。菌類。
fur	毛皮。毛皮製品。湯垢・水垢。
furnace	炉。かまど。
furniture	家具。
fury	激しい怒り。憤激。
fuse	導火線。(電気の)ヒューズ。
fusion	溶解。融解。融合。
future	未来。将来。
gag	さるぐつわ。冗談。ギャグ。
gain	利益。増進。増加。
gal	女の子。ギャル。
galaxy	銀河。天の川。
gale	強風。爆発。
gallery	美術館。画廊。廊下。一般大衆。ギャラリー。
gallon	ガロン。
gamble	賭け。ばくち。ギャンブル。
gambler	ばくち打ち。ギャンブラー。
game	遊戯。遊び。ゲーム。競技。試合。獲物。
Gandhi	インド独立運動の指導者、ガンジー。
gang	一味。ギャング。一団。
gangster	悪漢。やくざの一味。不良の一味。
gap	割れ目。すき間。相違。ギャップ。
garage	車庫。ガレージ。収納庫。修理工場。
garbage	生ごみ。くず。
garden	庭。庭園。公園。遊園地。
gardener	造園師。庭師。植木職人。
gardening	造園業。庭仕事。ガーデニング。
gargle	うがい。うがい薬。
garlic	ニンニク。ガーリック。
gas	気体。ガス。ガソリン。毒ガス。
gasoline	ガソリン。
gasp	あえぎ。息切れ。
gate	門。水門。
gathering	集まり。収穫。収集。
GATT	関税と貿易に関する一般協定。
gauge	計器。尺度。
gavel	(裁判官などが用いる)小づち。
GB	大ブリテン島。
GDP	国内総生産。
gear	歯車。ギア。装置。道具一式。
gen	陸軍大将。将軍。
gene	遺伝子。
general	陸軍大将。将軍。
generator	発電機。ガス発生器。
genetics	遺伝学。
Geneva	スイスの都市、ジュネーブ。
genius	天才。生まれつきの才能。
gentleman	紳士。
geography	地理学。地理。地形。
geometry	幾何学。
Georgia	ジョージア。
germ	ばい菌。細菌。胚芽。根源。
German	ドイツ人。ドイツ語。
Germany	ドイツ。
gesture	身振り。ジェスチャー。そぶり。
geyser	泉。間欠泉。
ghost	幽霊。亡霊。おばけ。
GHQ	総司令部。
GI	アメリカ兵。
giant	巨人。大男。巨大なもの。
gift	贈り物。(生まれつきの)才能。
giggle	くすくす笑い。
ginger	ショウガ。精力。活力。
giraffe	キリン。
girl	女の子。少女。娘。
glamour	うっとりするような魅力。グラマー。
glance	一目。一見。きらめき。
glare	まばゆい光。にらみつけ。けばけばしさ。
glass	ガラス。(ガラス製の)グラス。めがね。ガラス製品。
gleam	きらめき。輝き。かすかな光。
glide	すべり。滑走。グライド。
glimpse	一見。ちらりと見ること。それとなく気づくこと。
globe	球。球体。地球儀。天体儀。(theをつけて)地球。
gloom	薄暗がり。ゆううつ。
glory	栄光。光栄。名誉。壮観。繁栄。全盛。
gloss	つや。光沢。
glossary	用語集。用語辞典。
glove	手袋。グローブ。
glow	燃えるような輝きや鮮やかさ。ほてり。
glue	にかわ。接着剤。
GNP	国民総生産。
go	行くこと。去ること。活力。試み。成功。順番。
goal	ゴール。目標。目的地。
goat	ヤギ。
god	神。
goddess	女神。
godfather	名付け親。保証人。
going	行くこと。出発。状態。進行速度。
gold	金。黄金。金貨。財宝。金色。
goldfish	金魚。
golf	ゴルフ。
golfer	ゴルフをする人。ゴルファー。
gong	ゴング。どら。
good	善。親切。利益。
goodness	善良さ。親切さ。優秀さ。
goods	財産。所有物。商品。貨物。
goodwill	好意。親善。友好。
goose	(duckよりも大きい)ガチョウ。
gorilla	ゴリラ。
gossip	うわさ話。ゴシップ。世間話。うわさ好き。
government	政治。統治。行政。政府。
governor	州知事。総督。総裁。
gown	ガウン。
gr	グロス。十二ダース。
grab	ぐいっとつかむこと。
grace	優美。上品。親切。猶予。恩恵。長所。感謝の祈り。
grade	等級。階級。学年。成績。小学校。
graduate	卒業生。
graduation	卒業。卒業式。
grain	穀物。つぶ。ほんの少し。木目。きめ。性質。
gram	グラム。
gramme	グラム。
grammer	文法。
grandchild	孫。
granddad	おじいちゃん。
grandfather	祖父。
grandmather	祖母。
grandparent	祖父。祖母。
granny	おばあちゃん。
grant	補助金。交付金。奨学金。
grape	ブドウ。
grapefruit	グレープフルーツ。
graph	図表。グラフ。
grasp	しっかりつかむこと。把握。理解。掌握。
grass	草。牧草。芝生。草地。草原。牧草地。
grasshopper	キリギリス。バッタ。イナゴ。
grassland	牧草地。牧場。
gratitude	感謝。謝意。
grave	墓場。墓穴。墓。死。
gravel	砂利。
gravity	重力。重大性。
gray	灰色。ねずみ色。グレー。
grease	獣脂。グリース。油脂。
greatness	偉大さ。重要さ。広大さ。
Greece	ギリシャ。
Greek	ギリシャ人。ギリシャ語。
green	緑。緑色。緑色野菜。緑地。芝生。
Greenland	グリーンランド。
greeting	あいさつ。
grief	深い悲しみ。なげき。
grill	焼き網。焼肉。焼き魚。グリル。
grin	歯を見せて笑うこと。
grind	(粉を)ひくこと。磨くこと。つらい仕事。がり勉。
grip	しっかりつかむこと。握力。取っ手。理解力。
groan	うめき声。うなり声。不満の声。ミシミシ（ギシギシ）いう音。
grocery	食料雑貨店。食料品店。
groom	花婿。
groove	みぞ。習慣。
gross	「国民総生産」＝``～ national product''
ground	地面。土地。立場。下地。
group	群れ。グループ。
grove	林。小さい森。
grower	栽培者。
growl	うなり。うなり声。
growth	成長。発育。発達。増大。栽培。腫瘍。
grumble	ぶつぶつ言うこと。不平。
guarantee	保証。保証書。保証人。
guard	番人。見張り。警戒。防御。
guess	推量。推測。
guest	来客。ゲスト。
guidance	指導。案内。指導。ガイダンス。
guide	案内者。ガイド。案内書。手引き。
guidebook	案内書。旅行案内。ガイドブック。
guilt	罪。罪悪。罪悪感。
guitar	ギター。
gulf	(bayよりも大きい)湾。深い穴。渦巻き。
gull	カモメ。
gulp	ぐっと飲むこと。一飲み。
gum	ガム。ゴムのり。``chewing ～''
gun	銃。鉄砲。大砲。拳銃。ピストル。
gunfire	発砲。銃撃。砲火。
gunshot	銃撃。砲撃。射程。
guppy	観賞用の小型熱帯魚、グッピー。
gust	突然の噴出。一陣の風。突発。
gut	腸。
guy	男。ヤツ。
gym	体育館。体操場。ジム。体操。体育。
gymnasium	体育館。室内体操場。
gypsy	ジプシー。放浪者。
ha	ヘクタール。
habit	くせ。習慣。習性。
hail	あられ。ひょう。呼びかけ。ばんざい。
hair	毛。毛髪。
haircut	散髪。
hairdresser	(髪の)美容師。
hairstyle	髪型。ヘアスタイル。
half	半分。二分の一。30分。前半、後半。
hall	大広間。集会場。ホール。玄関。
Halloween	ハロウィン。
halt	(aをつけて)停止。
halves	halfの複数形。
ham	ハム。アマチュア無線。
hamburger	ハンバーガー。
Hamlet	ハムレット。
hammer	ハンマー。かなづち。
hammock	ハンモック。
hamster	ハムスター。
hand	手。人手。支配。
handbag	ハンドバッグ。
handball	ハンドボール。
handbook	案内書。手引書。
handicap	ハンディキャップ。不利な条件。障害。
handkerchief	ハンカチ。
handle	柄。ハンドル。取っ手。
handwriting	手書き。肉筆。筆跡。
hanger	物をつるす道具。ハンガー。
hangglider	ハンググライダー。
hangover	二日酔い。残存物。後遺症。
happening	偶発事。出来事。
happiness	幸福。楽しさ。うれしさ。満足。幸運。
harbor	港。避難所。隠れ場所。
hardcover	堅い表紙の本。
hardness	硬度。堅さ。厳しさ。困難。
hardship	苦難。難儀。
hardware	(コンピューターの)機械部分。ハードウェア。
hare	野ウサギ。
harm	害。危害。悪意。
harmony	調和。一致。和音。ハーモニー。
harnesss	馬具。
harp	たて琴。ハープ。
harvest	収穫。収穫高。結果。
hash	ハヤシ肉料理。混乱状態。(古い作品の)焼き直し。
haste	急ぐこと。あわてること。
hat	(ふちのある)帽子。
hatchet	手おの。まさかり。
hate	憎しみ。憎悪。
haul	ぐいと引くこと。運搬。一網の漁獲量。
haunt	たまり場。生息地。
Hawaii	ハワイ。
Hawaiian	ハワイ人。ハワイ語。
hawk	タカ。タカ派。詐欺師。
hay	干し草。
haystack	干し草の山。
hazard	危険な要因。危険。偶然。運。危険物。(ゴルフの)障害物。
he	彼。
head	頭。頭部。首。長。表。水源地。
headache	頭痛。
heading	見出し。推進方向。ヘディング。
headlight	ヘッドライト。
headlines	(ニュースなどの)主要項目。ヘッドライン。
headquarters	本部。本社。本局。司令部。
healer	治療する人。医師。
health	健康。
heap	山。たくさん。どっさり。
hearing	聞き取り。聴力。聞こえる範囲。公聴会。
heart	心臓。胸部。心。感情。愛情。勇気。興味。中心。ハート。
heartbeat	心臓拍動。心拍。心拍数。
hearth	いろり。炉辺。こんろ。
heat	熱。熱源。温度。(競技の)一回。
heaven	天国。天。空。
Hebrew	ヘブライ人。ヘブライ語。
hectare	ヘクタール。
hedge	生け垣。垣根。障壁。
hedgehog	ハリネズミ。ヤマアラシ。
heed	注意。
heel	かかと。
height	高さ。高度。高台。
heir	相続人。跡取り。継承者。
Helen	ヘレン。女子の名。
heli	ヘリコプター。
helicopter	ヘリコプター。
hell	地獄。
hello	こんにちは。
helmet	ヘルメット。かぶと。
help	助け。援助。
helper	お手伝い。ヘルパー。助ける人。
hemisphere	半球体。半球。
hen	めんどり。
her	彼女を。彼女に。
herd	(牛・馬・羊などの)群れ。
heritage	遺産。相続財産。
hero	英雄。偉人。主人公。
heroin	ヘロイン。モルヒネで作る麻薬。
heroine	女傑。ヒロイン。女主人公。
hers	彼女のもの。
hertz	ヘルツ。
hesitation	ためらい。ちゅうちょ。
hexagon	六角形。
hierarchy	階級制度。階層。位階制。
high	高み。高値。
highlight	ハイライト。光輝部。
highness	高いこと。
highway	主要道路。公道。交通路。ハイウェー。
hijack	ハイジャック。
hike	ハイキング。徒歩旅行。
hiker	ハイキングをする人。
hiking	ハイキング。徒歩旅行。
hill	丘。小山。
him	彼を。彼に。
Hindu	ヒンズー教信者。インド人。
Hinduism	ヒンズー教。
hinge	ちょうつがい。要点。
hint	暗示。ヒント。
hip	でん部。ヒップ。
hippo	カバ。
hippopotamus	カバ。
hire	賃貸。賃借。雇用。使用料。
hiss	シューという音。
historian	歴史家。歴史学者。
history	歴史。史実。歴史書。履歴。
hit	打撃。命中。成功。安打。ヒット。
hitchhike	ヒッチハイク。
hive	ミツバチの巣箱。
hobby	趣味。道楽。
hockey	ホッケー。
hog	豚。
hoist	引き上げ。押し上げ。巻き上げ機。起重機。
hold	持つこと。持つ所。予約。支配力。押さえ込み。
holder	入れ物。所有者。
holding	握ること。持ち株会社所有の会社。所蔵。ホールディング。
hole	穴。くぼみ。巣穴。ホール。
holiday	祝祭日。休日。休暇。
Holland	オランダ。
hollow	くぼみ。穴。くぼ地。谷間。
Hollywood	映画産業の中心地、ハリウッド。米国映画界。
home	家庭。我が家。故郷。家。基地。ホーム。
homeland	祖国。
homeroom	ホームルーム。
hometown	現在住んでいる町。
homework	家庭学習。宿題。内職。
homicide	殺人。殺人犯。
honesty	正直。誠実。
honey	はちみつ。いとしい人。
honeymoon	新婚旅行。蜜月。ハネムーン。
honor	名誉。名声。尊敬。勲章。儀礼。
hood	ずきん。フード。覆い。
hook	ひっかけるためのもの。フック。釣り針。
hoop	(おけなどの)たが。(金属・木などの)輪。
hop	片足とび。飛び跳ねること。ホップ。
hope	希望。望み。期待。
horizon	地平線。水平線。(知識などの)範囲。
horn	つの。警笛。(楽器の)ホルン。
hornet	スズメバチ。
horror	恐怖。ぞっとするもの。
horse	馬。跳馬。あん馬。騎兵。馬の形をした台。
horseback	馬の背。
horseman	馬乗り。騎手。馬の飼育家。
horseshoe	馬蹄。蹄鉄。
hose	ホース。水管。
hospital	病院。
hospitality	親切なもてなし。
host	主人。ホスト。
hostess	女主人。ホステス。
hostility	敵意。敵対行動。
hotel	ホテル。旅館。
hound	猟犬。
hour	一時間。時間。(theをつけて)現在。
hourglass	砂時計。水時計。
house	家。住宅。建物。小屋。
household	世帯。所帯。家庭。
housekeeper	家政婦。家事をする人。
housemaker	主婦。家政婦。
howl	遠吠え。わめき声。うなり。大笑い。
HR	ホームラン。
hue	色。色合い。
hug	抱きしめること。抱擁。
hula	フラダンス。
hum	ブンブンいう音。雑音。
human	人間。
humanism	人間主義。ヒューマニズム。人間性。
humanity	人類。慈悲。人道。人間性。
humming	ブンブンいう音。鼻歌。
humor	ユーモア。上品なしゃれ。気分。気質。
hundred	百。百人。百個。百歳。
hundredth	第百。百番目。(aかtheをつけて)百分の一。
Hungarian	ハンガリー人。ハンガリー語。
Hungary	ハンガリー。
hunger	飢え。空腹。
hunt	狩り。狩猟。探すこと。
hunter	猟師。ハンター。捜し求める人。
hunting	狩猟。探求。
hurricane	ハリケーン。
hurry	急ぎ。大急ぎ。急ぐ必要。
hurt	傷。けが。苦痛。損害。
husband	夫。
hut	小屋。
hybrid	雑種。
hydrogen	水素。
hyena	ハイエナ。
hymn	賛美歌。聖歌。賛美。
hyphen	ハイフン（-）。
hysteria	ヒステリー。病的興奮。
Hz	ヘルツ。
IC	集積回路。
ice	氷。氷菓子。
Iceland	アイスランド。
ID	身分証明書。
idea	考え。計画。意見。想像。
ideal	理想。
idealism	理想主義。
identity	同一性。一致。身元。アイデンティティ。
idiom	イディオム。慣用語法。熟語。語法。
idleness	怠けていること。無駄。
idol	アイドル。偶像。
ignition	発火。点火。発火装置。
ignorance	無知。無学。知らないこと。
iguana	イグアナ。
illness	病気。
illumination	イルミネーション。明るくすること。照明。
illustration	挿絵。図解。イラスト。
image	像。姿。概念。映像。イメージ。
imagination	想像。想像力。
imitation	まね。模倣。模造品。
immigrant	（他国からの）移民。入国者。
impact	衝突。衝撃。影響。効果。
implement	道具。器具。履行。手段。
import	輸入。輸入品。意味。
importance	重要性。重要。
impression	印象。感銘。考え。感想。
imprint	(押した)印、跡。印象。奥付。
improvement	改良。改善。
impulse	衝撃。推進力。刺激。衝動。
in	インチ。約2.54cm。
incentive	誘因。動機。報奨。
inch	インチ。約2.54cm。
incident	出来事。事件。事変。付随条件。
inclination	好み。傾き。傾斜。
inclusion	含有。包含。
income	収入。所得。
inconsistency	矛盾。不一致。
inconvenience	不便。不自由。迷惑。
increase	増加。増大。
independence	独立。自主。
index	索引。目録。指標。指数。
India	インド。
Indian	インド人。
indication	指示。目安。表示。
indicator	表示する人・もの。表示器。計器。標識。
indifference	無関心。どうでもよいこと。
individualism	個人主義。
individualist	個人主義者。
Indonesia	インドネシア。
Indonesian	インドネシア人。インドネシア語。
induction	誘導。帰納法。誘発。(聖職・公職への)就任(式)。徴兵。
industry	産業。工業。勤勉。
inequality	不平等。不公平。不等式。平らでないこと。
infancy	幼年期。
infant	幼児。
infection	伝染。感染。伝染病。
inference	推論。推測。推理。
infinity	無限。無限大。
inflation	インフレーション。インフレ。
influence	影響。影響力。
influenza	インフルエンザ。
information	情報。通知。知識。案内所。
inhabitant	居住者。住人。
inheritance	相続。継承。
initial	頭文字。
initiation	加入。入会。入社。創設。イニシエーション。
initiative	主導権。決定力。独創力。
injection	注射。浣腸。注入。
injury	傷。負傷。けが。損害。害。
injustice	不正。不法。不当。
ink	インク。
inn	宿屋。
inning	(野球の)イニング。回。
innocence	無邪気。無罪。潔白。
innovation	革新。刷新。
input	データ入力。インプット。
inquiries	inquiryの複数形。
inquiry	問合せ。照会。調査。研究。
insanity	精神障害。錯乱。狂気。
insect	昆虫。
insert	挿入物。差し込み。折込。
inside	内側。内部。胃腸。内面。
insight	洞察力。見識。
insistence	主張。断言。強要。
inspection	調査。精査。検査。
inspector	調査官。検査官。監督官。
inspiration	霊感。インスピレーション。着想。刺激。
installation	就任。取り付け。軍事施設。設備。インストール。
installment	(分割払い)の一回分。(シリーズの)一回分。
instance	実例。場合。
instant	瞬間。即席。
instinct	本能。
institute	学会。研究機関。研究所。講習会。
institution	協会。施設。慣例。設立。
instruction	教育。教え。命令。
instructor	教師。講師。
instrument	器具。器械。楽器。
insulation	絶縁体。絶縁。
insult	侮辱。無礼。
insurance	保険。保険金。
integer	整数。
intellect	知性。理解力。
intelligence	知能。知力。理解力。情報。情報機関。
intensity	強烈さ。激しさ。強度。
intent	意図。意向。目的。意味。
intention	意図。意向。決意。故意。
interchange	交換。やり取り。交互に続くこと。インターチェンジ。
intercourse	性交。交際。交わり。
interest	興味。関心。関心事。利益。利子。利害関係。
interference	妨害。邪魔。干渉。妨害行為。
interior	内部。インテリア。奥地。内政。
interpretation	通訳。解釈。説明。
interpreter	通訳者。解釈者。
interruption	妨害。中断。妨害物。さえぎる物。
intersection	交差。交差点。
interval	間隔。音程。
interview	面接。インタビュー。記者会見。
introduction	紹介。導入。採用。伝来。序論。入門書。
invader	侵入者。侵略者。
invasion	侵入。侵略。殺到。侵害。侵犯。
invention	発明。考案。発明品。
inventor	発明家。考案者。
inverse	逆。反対。
investigation	調査。取調べ。研究。
investment	投資。出資。投資額。
investor	投資家。
invitation	招待。招待状。
invoice	インボイス。送り状。
involvement	関与。積極的参加。熱中。
IOC	国際オリンピック委員会。
iodine	ヨウ素。ヨード。
ion	イオン。
IOU	借用書。``I owe you''の略。
Iowa	アイオワ。
IQ	知能指数。
Iran	イラン。
Iraq	イラク。
Ireland	アイルランド。
Irish	アイルランド人。アイルランド語。
iron	鉄。アイロン。手かせ足かせ。
irony	皮肉。反語。アイロニー。
irritation	いらだち。焦燥。立腹。炎症。
island	島。
isle	小島。
isolation	孤立。分離。隔離。
Israel	イスラエル。
Israeli	イスラエル人。
Isram	イスラム教。
issue	発行。発行物、号。問題点。結果。子孫。流出。排出。収益。
it	それ。情報技術。
Italian	イタリア人。イタリア語。
Italy	イタリア。
itch	かゆみ。うずうずする欲望。
item	項目。品目。特徴。演目。アイテム。ねた。記事。
ivory	象牙。(象などの)きば。
jab	突き。ジャブ。
jack	ジャッキ。起重機。男。ジャック。
jacket	上着。ジャケット。(書物の)カバー。
jail	刑務所。拘置所。
jailbreak	脱獄。
jam	ジャム。
Jamaica	ジャマイカ。
James	ジェームズ。男子の名。
Jan	一月。
Jane	ジェーン。女子の名。
January	一月。
Japan	日本。
Japanese	日本人。日本語。
jar	(広口の)びん。つぼ。かめ。
jasmine	ジャスミン。
Java	ジャワ島。
jaw	あご。口。おしゃべり。お説教。
jazz	(音楽の)ジャズ。
jeans	ジーンズ。ジーパン。
jeep	ジープ。
jelly	ゼリー。寒天。ゼリー菓子。
jellyfish	クラゲ。
jerk	ぐいと動かすこと。けいれん。引きつり。ジャーク。
Jerusalem	聖地、エルサレム。
jest	冗談。しゃれ。
jet	ジェット機。噴出。噴射。吹き出し口。
jewel	宝石。宝飾品。貴重なもの。
jeweler	宝石職人。宝石商。
Jewish	ユダヤ人。
jigsaw	糸のこぎり。ジグソー。
jingle	チリンチリン鳴る音。電話をかけること。
jinx	縁起の悪いこと。ジンクス。
job	仕事。職業。やっかい。
jockey	競馬の騎手。ジョッキー。
jogging	ジョギング。
John	ジョン。男子の名。
join	縫い目。継ぎ目。
joint	継ぎ目。合わせ目。関節。
joke	冗談。しゃれ。ジョーク。
joker	冗談を言う人。ジョーカー。
journal	日誌。定期刊行物。新聞。
journalism	ジャーナリズム。
journalist	新聞・雑誌記者。ジャーナリスト。
journey	旅行。
joy	喜び。歓喜。うれしいこと。
Judaism	ユダヤ教。
judge	裁判官。審判員。鑑定士。ジャッジ。
judgment	裁判。判決。判断。意見。審判。
jug	(取っ手がある)水差し、つぼ。
juice	ジュース。
Jul	七月。
July	七月。
jump	飛び上がること。跳躍。ジャンプ。
jumper	ジャンプ競技選手。飛び降り自殺者。
Jun	六月。
junction	連結。接合。連結点。接合部。
June	六月。
junior	年下の人。後輩。ジュニア。
junk	廃品。くず。中古品。骨董品。ジャンク。
Jupiter	木星。
jury	陪審。審査員。
justice	正義。公正。裁判。処罰。裁判官。
kangaroo	カンガルー。
keeper	番人。経営者。飼い主。キーパー。
keeping	保存。保管。管理。維持。扶養。飼育。調和。
kennel	犬小屋。動物の巣。あばら家。
kerosene	灯油。イギリスで言うparaffinと同じ。
kettle	湯わかし。やかん。
key	かぎ。手がかり。キー。
keyboard	キーボード。鍵盤。
kg	キログラム。
kick	けること。キック。苦情、不平。解雇。
kid	子供。若者。子ヤギ。
killer	殺人者。殺し屋。
kilogram	キログラム。
kiloliter	キロリットル。
kilometer	キロメートル。
kind	種類。部類。種族。本質。性質。
kindergarten	幼稚園。
kindness	親切。思いやり。やさしさ。
king	王。国王。
kingdom	王国。世界。界。
kiss	キス。接吻。
kit	一式。衣服。装備。キット。
kitchen	台所。キッチン。調理場。
kite	たこ。トビ。
kitten	子猫。
kitty	子猫ちゃん。
kl	キロリットル。
km	キロメートル。
knee	ひざ。
knife	ナイフ。小刀。包丁。刃。(手術用の)メス。
knight	騎士。ナイト。ナイト爵。
knives	knifeの複数形。
knob	ドアの取っ手。ノブ。小さな塊。小山。
knock	打つこと。打つ音。ノック。打撃。酷評。
knockout	たたきのめすこと。ノックアウト。
knot	結び目。こぶ。ノット。
knowledge	知識。知っていること。認識。
KO	たたきのめすこと。ノックアウト。
Korea	朝鮮。
Korean	朝鮮人。朝鮮語。
LA	ロサンジェルス。
lab	実験。実習。
label	ラベル。レッテル。荷札。
labor	労働。労働力。労力。(骨の折れる)仕事。労働者。産みの苦しみ。
laboratory	研究所。実験室。実験。実習。
laborer	労働者。作業員。
labyrinth	迷宮。迷路。
lace	レース。靴のひも。
lack	不足。欠乏。欠如。必要なもの。
ladder	はしご。(靴下・ストッキングの)伝線、ほつれ。
lady	婦人。夫人。淑女。
ladybug	テントウムシ。
lake	湖。
lamb	子羊。子羊の肉。
lamp	ランプ。明かり。灯火。
land	陸。陸地。国。国家。土地。
landing	上陸。着陸。(階段の)踊り場。
landowner	土地所有者。地主。
landscape	風景。景観。景色。風景画。地形。
landslide	地すべり。がけ崩れ。山崩れ。
lane	細道。小道。車線。航路。レーン。
language	言語。言葉。国語。用語。言葉遣い。語学。
lantern	ランタン。ちょうちん。角灯。
lap	ひざ。ひざの部分。一周。一往復。
lapse	ささいな過ち。経過。堕落。失効。廃止。
lash	むちの一打ち。むち打ち。すばやい動き。まつげ。
last	最後。最近のもの。(theをつけて)最後の人。
Latin	ラテン語。ラテン民族。
latitude	緯度。自由。
laugh	笑い。笑い声。
laughter	笑い。笑い声。
launch	発射。進水。打ち上げ。発射台。進水台。
laundry	洗濯屋。クリーニング屋。洗濯場。洗濯物。
lava	溶岩。
lavatory	洗面所。手洗い。トイレ。洗面台。便器。
law	法。法律。おきて。法則。
lawmaker	立法者。議員。
lawn	芝生。芝地。
lawyer	弁護士。法律家。法律学者。
layer	積む人。敷く人。(重なった)層。一塗り。
layout	配置。割付。並べること。レイアウト。
lead	先頭。優勢。リード。先例。手がかり。鉛。
leader	指導者。リーダー。
leaf	(草木の)葉。一枚。箔。花びら。
leaflet	ちらし。ビラ。小冊子。小さい葉。
league	競技連盟。リーグ。部類。同盟。
leak	漏れること。漏らすこと。漏れ口。リーク。
leaning	傾き、傾斜。傾向、好み。
leap	飛び跳ねること。跳躍。飛躍。
learner	学習者。初学者。弟子。
learning	学問。学識。学ぶこと。学習。
lease	賃貸借契約。リース。
leather	(動物の)革、なめし革。革製品。
leave	許し、許可。別れ。休暇。
lecture	講義。講演。お説教。
left	左。左側。
leg	脚。(旅行・催しなどの)一行程。
legend	伝説。言い伝え。
leisure	ひま。余暇。レジャー。
lemon	レモン。
lender	貸す人。
length	長さ。期間。
lens	レンズ。(目の)水晶体。
Leonard	レオナルド。男子の名。
leopard	(動物の)ヒョウ。
lesson	授業。けいこ。レッスン。課。教訓。
letter	手紙。書簡。文字。字。
lettuce	レタス。
level	レベル。水平面。水準器。高さ。水準。
lever	てこ。レバー。
Li	リチウムの元素記号。
liability	義務。債務。法的責任。傾向。不利な点。
liar	うそつき。
lib	解放運動。liberationの短縮形。
liberation	解放運動。
liberty	(支配・束縛からの)自由。解放。自由権。
librarian	図書館員。司書。
library	図書館。図書室。蔵書。書斎。
lick	なめること。一なめ。
lid	ふた。まぶた。
lie	(重大な)うそ。
life	生命。命。人生。一生。生活。伝記。活力。実物大。
lifeboat	救命ボート。助け舟。
lifetime	一生。生涯。寿命。存続期間。
lift	上げること。上昇。昇降機。リフト。(乗り物に)乗せること。手助け。
light	明かり。灯火。光。光線。昼。夜明け。火。
lighter	点火器。ライター。
lighthouse	灯台。
lightning	稲光。稲妻。
lightweight	ライト級。
likeness	似ていること。類似点。外観。
liking	好み。趣味。
lily	ユリ。
limb	肢。手足(の一本)。(鳥の)翼。
lime	石灰。ライム。
limit	限界、限度。制限、許容量。
line	線。すじ。糸状のもの。(文章などの)行。航路。路線。進路。国境。ライン。
linen	リネン。亜麻布。亜麻糸。リネン製品(シーツ・テーブルクロスなど)。
liner	定期船。定期航空機。線を引く道具。ライナー。
linguist	言語学者。
linguistics	言語学。
link	結び付けるもの。(鎖の)輪。化学結合。リンク。
lion	ライオン。
lip	くちびる。
liquid	液体。
liquor	(蒸留した)アルコール飲料。酒。
list	目録。表。名簿。リスト。
listnener	聞き手。
liter	リットル。
literature	文学。文献。
lithium	リチウム。
little	少し。少量。
liver	肝臓。レバー。
lives	lifeの複数形。
livestock	家畜類。
living	生存。生活様式。暮らし。
lizard	トカゲ。
LL	language laboratoryの略。
load	荷。積み荷。負担。(銃などの)装填。荷重、負荷。
loaf	(パン・ケーキなどの)一かたまり。ローフ。
loan	貸付金。ローン。貸し付け。借金。外来語。
lobby	ロビー。圧力団体。陳情。
lobster	ロブスター。甲殻類。
location	位置、場所。位置の選定。撮影地。
lock	錠。錠前。水門。発射装置、引き金。ロック。
locker	ロッカー。かぎのかかる物入れ。
locomotive	機関車。
locust	バッタ。イナゴ。セミ。
lodge	山小屋。山荘。ロッジ。
loft	屋根裏。屋根裏部屋。上階。ロフト。
log	丸太。日誌。記録。
logic	論理。論法。論理学。
lollipop	ぺろぺろキャンデー。
London	イギリスの首都、ロンドン。
longing	あこがれ、切望。
longitude	経度。経線。
look	見ること。外観、様子。見た目。容姿、顔つき。
loop	輪っか。環状線。
loot	戦利品。略奪。貴重なもの。大金。
lord	支配者。君主。貴族、上院議員。
loser	敗者。失敗者。損をした人。負け犬。
loss	失うこと。損失。損害。敗北。むだ使い。衰え。
lot	たくさん。多数。くじ。運。当番。「たくさんの～」＝``a ～ of ...''
lotion	洗い薬。化粧水。ローション。
lounge	休憩室。ラウンジ。長いす。
louse	シラミ。
love	愛、愛情。恋愛、恋。(男性から見た女性の)恋人、愛人。愛する人。
lover	(女性から見た男性の)恋人。愛好者。
low	モーという鳴き声。
loyalty	誠実。忠実。忠義。
luck	運。幸運。
Lucy	ルーシー。女子の名。
luggage	旅行かばん。手荷物。
lumber	材木。がらくた。
lump	かたまり。こぶ、腫れ物。
lunch	昼食、ランチ。軽食。
lunchtime	昼食時間。ランチタイム。
lung	肺。
lure	誘惑するもの。おとり。疑似餌、ルアー。わな、落とし穴。
lust	欲。強い欲望。
lux	照度の単位、ルクス。
luxury	ぜいたく、豪華。ぜいたく品。くつろぎ。快適さ。
ma	お母ちゃん。
macaroni	マカロニ。
Mach	マッハ。
machine	機械。機械装置。機構。
machinery	機械類。装置。機械部分。機構。
madam	奥様。お嬢様。
madman	狂人。
magazine	雑誌。定期刊行物。弾薬庫。弾倉。マガジン。
magic	魔法。魔術。手品。不思議な力。
magician	手品師。魔法使い。
magma	マグマ。
magnesium	マグネシウム。
magnet	磁石。
magnitude	規模。偉大さ。マグニチュード。等星。
maid	未婚の女性。お手伝い。メイド。
maiden	少女。未婚の女性。
mail	郵便。郵便物。メール。
main	主管。幹線。本線。メイン。
mainland	本土。
maintenance	維持。保守。メンテナンス。支持。主張。扶養。養育費。
majesty	威厳。陛下。
major	専攻科目。成人。(音楽の)長調。
majority	大多数。過半数。成年。
maker	作る人。製造者。製作者。メーカー。
making	作ること。製造。製造法。製作過程。
malaria	マラリア。
male	男性。雄。
malice	悪意。敵意。恨み。
mama	ママ。お母ちゃん。
mammal	哺乳類。
mammoth	マンモス。
man	男。男子。人類。人間。
management	経営。管理。
manager	支配人。経営者。
maneater	人食い人種。人食い動物。
manganese	マンガン。
mango	マンゴー。
manhole	マンホール。
mania	熱狂。熱中。マニア。
manicure	マニキュア。
manifesto	マニフェスト。
manipulation	操作。改ざん。触診。
mankind	人類。人間。男性。男子。
mannequin	マネキン人形。
manner	方法。態度。行儀作法。習慣。
mantle	マント。おおい。ふた。マントル。
manual	手動。手引き。案内書。マニュアル。
manufacture	製造。製作。製造業。(複数形で)製品。
manuscript	手書き。手書きのもの。原稿。
many	多数。
map	地図。天体図。
maple	カエデ。
Mar	三月。
marathon	マラソン競走。
marble	大理石。ビー玉遊び。
March	三月。行進。行進曲。
mare	雌馬。ロバ・ラバなどの雌。
margarine	マーガリン。
margin	ふち、へり、端。余白。利ざや。マージン。ゆとり。
Maria	マリア。女子の名。
marigold	マリーゴールド。
marine	海兵隊員。船舶。艦船。
marionette	マリオネット。操り人形。
mark	しるし。目印。記号。マーク。痕跡。点数。的。成功。特徴。(theをつけて)標準。
market	市。市場。需要。販路。マーケット。
marketing	マーケティング。商品の売買。
marketplace	市場。市が開かれる場所。
marmalade	マーマレード。
marriage	結婚。結婚生活。結婚式。
Mars	火星。
marshal	元帥。署長。連邦保安官。執行官。
marshmallow	マシュマロ。
marvel	驚異。驚くべきもの。
Marx	ドイツの社会主義者、マルクス。
Marxist	マルクス主義者。
mascara	マスカラ。
mash	どろどろのもの。マッシュ。マッシュポテト。
mask	仮面。覆面。マスク。
mass	かたまり。大部分。多数。一般大衆。「マスメディア」＝``～ media''
massage	あんま。マッサージ。
mast	マスト。帆柱。まっすぐな柱。
master	主人。長。教師。名人。マスター。修士。
masterpiece	傑作。代表作。
mat	マット。
match	マッチ。試合。競争相手。似合うもの。結婚。
mate	仲間。友達。伴侶。
material	原料。材料。資材。資料。生地。必要な道具、用具。
materialism	物質中心主義。唯物論。
materialist	物質中心主義者。唯物論者。
maternity	母性。産科。妊婦服。
math	数学。
mathematics	数学。
matter	事柄、問題。物質。(theをつけて)困ったこと。
mattress	マットレス。
maxim	格言。
maximum	最大。最大値。
May	五月。
mayonnaise	マヨネーズ。
mayor	市長。村長。
maze	迷路。迷宮。
MC	司会者。進行係。
me	私を。私に。
meadow	牧草地。草地。
meal	食事。
meaning	意味。訳。意図。目的。意義。
means	方法。手段。財産。資産。
meantime	(theをつけて)その間。そのうち。
measure	寸法。分量。ものさし。計量器。尺度。
meat	食肉。食用肉。肉。
Mecca	イスラム教の聖地、メッカ。
mechanic	機械工。整備士。
medal	メダル。勲章。
medalist	メダリスト。メダル製作者。メダル収集家。
meddler	おせっかい焼き。
media	mediumの複数形。
medicine	薬。医薬品。医術。
meditation	熟慮。瞑想。
Mediterranean	(theをつけて)地中海。
medium	手段。方法。媒体。
medley	寄せ集め。メドレー。
meeting	会。会合。集会。出会い。遭遇。面会。
megaphone	メガホン。
melodies	melodyの複数形。
melodrama	メロドラマ。感傷的劇。
melody	美しい調子。メロディー。旋律。
melon	メロン。
member	一員。会員。メンバー。議員。
membership	一員であること。会員の地位。会費。
memento	思い出の品。記念品。かたみ。
memo	メモ。
memorial	記念。
memory	記憶。記憶力。記念。メモリー。
men	manの複数形。
menace	危険。脅威。脅迫。
mend	修繕。改良。修理箇所。
menses	月経。
mentality	精神力。心理。精神性。
mention	言及。名指し。公式に認められること。
menu	献立表。メニュー。
merchandise	商品。
Mercury	水星。マーキュリー。
mercy	慈悲。哀れみ。情け。
merit	長所。価値。とりえ。(複数形で)功績。
mermaid	人魚。
mesh	網の目。網。メッシュ。
mess	混乱。紛糾。窮地。散乱。
message	伝言。メッセージ。
messenger	メッセンジャー。使者。伝達人。
Messiah	救世主。
metal	金属。金属元素。
metaphor	隠喩。メタファー。
meteor	流星。隕石。
meteorite	隕石。
meter	自動計量器。メーター。メートル。
method	手法。方式。順序。几帳面。
metropolis	中心地。大都会。
mew	子猫やカモメの鳴き声。
Mexican	メキシコ人。
Mexico	メキシコ。
Mg	マグネシウムの元素記号。
mice	mouseの複数形。
microphone	マイクロホン。マイク。
microscope	顕微鏡。
midday	正午。真昼。
middle	中間。真ん中。中央。内部。最中。
midnight	真夜中。夜半。
midpoint	中間点。中点。
midsummer	真夏。
midwinter	真冬。
migration	移住。移住者。
mike	マイク。
mile	マイル。
mileage	マイル数。マイルあたりの運賃。燃費。
milestone	里程標。マイル標石。一里塚。
milk	乳。牛乳。ミルク。
mill	製粉場。工場。製造所。
miller	製粉業者。粉屋。
milligram	ミリグラム。
millimeter	ミリメートル。
million	百万。ミリオン。
millionaire	百万長者。大金持ち。大富豪。
mince	細かく刻んだもの。
mind	心。精神。知性。考え。記憶。理性。
mine	私のもの。鉱山。地雷。
miner	鉱山労働者。採鉱者。地雷工兵。
mineral	鉱物。無機物。
mini	小型のもの。ミニ。
miniature	縮小模型。細密画。小型カメラ。ミニチュア。
minimum	最小。最小限度。
minister	大臣。公使。牧師。「総理大臣」＝``the Prime ～''
Ministry	内閣。省。
minor	未成年者。二流の人。短調。副専攻科目。
minority	少数。少数派。少数民族。
mint	ハッカ。ミント。ミント菓子。
minus	マイナス。負数。不足。損失。
minute	(時間の)分。ちょっとの間。(角度の)分。覚え書き。
miracle	奇跡。ミラクル。
mirror	鏡。手本。
mischief	(悪意のない)いたずら。害。危害。いたずらっ子。
misconduct	非行。不品行。
misery	悲惨さ。みじめさ。
misfortune	不運。不幸。災難。
misgiving	(複数形で)疑惑。懸念。不安。心配。
miss	失敗。ミス。
missile	ミサイル。弾道弾。飛び道具。
mission	使節団。任務、使命。布教。
missionary	宣教師。
mist	霧。もや(fogよりも薄くhazeより濃いもの)。(目の)かすみ。
mistake	間違い。思い違い。
Mister	ミスター。称号を持たない男子の名の前につける敬称。
mistress	愛人。女性主人。女王。
mistrust	不信。疑惑。
misuse	誤用。悪用。乱用。
MIT	マサチューセッツ工科大学。
mix	ミックス。混合物。
mixer	泡立て器。攪拌器。ミキサー車。音声調節装置。
mixture	混合。混合物。
ml	ミリリットル。
mm	ミリメートル。
Mn	マンガンの元素記号。
moan	うめき。うめき声。
mob	暴徒。群衆。集団。
mode	流儀。特定の状態。慣習。流行。モード。
model	模型。型。手本。モデル。
module	交換可能な構成部分。モジュール。構成単位。寸法。
moisture	水分。水蒸気。湿気。
mold	鋳型。流し型。かび。
mole	ほくろ。あざ。モグラ。
molecule	分子。微粒子。
mom	お母さん。
moment	瞬間。ちょっとの間。時期。機会。重大。現況。
momentum	はずみ。勢い。運動量。
Mon	月曜日。
monarch	君主。元首。
Monday	月曜日。
money	お金。金銭。富。
Mongol	モンゴル人。モンゴル語。
monitor	モニター。監視装置。表示装置。
monk	修道士。僧。
monkey	(尾の長い小形の)サル。いたずらっ子。
monopoly	独占。専売。独占権。専売品。
monorail	モノレール。
monster	怪物。化け物。巨大なもの。
montage	モンタージュ。
month	(暦の上での)月。一ヶ月間。
monument	記念碑。史跡。
moo	(牛の)モーという鳴き声。
mood	気分。気持ち。不機嫌。
moon	月。月の光。
moonlight	月光。
moral	教訓。(複数形で)道徳。
more	もっとたくさん。
morning	朝。午前。
mortality	死亡率。死亡数。大量死。死すべき運命。
mosaic	モザイク。モザイク模様。
Moscow	モスクワ。
mosque	モスク。イスラム教寺院。
mosquito	蚊。
moss	コケ。
motel	モーテル。無料駐車場の付いたホテル。
moth	ガ（蛾）。
mother	母。
motif	モチーフ。題材。
motion	動き。運動。動作。動議。
motivation	自発性。積極性。動機付け。
motive	動機。誘因。
motor	発動機。モーター。電動機。自動車。オートバイ。
motorbike	小型オートバイ。
motorcycle	オートバイ。
mount	山。
mountain	山。山脈。連山。
mourning	悲しむこと。哀悼の意を示すこと。
mouse	ハツカネズミ（ratよりも小さい）。
mouth	口。
mouthpiece	マウスピース。
move	動き。動作。引越し。行動。
movement	運動。動き。動作。移動。
movie	映画。
mower	草刈り機。芝刈り機。
MP	アメリカ陸軍の憲兵。
mph	時速...マイル。miles per hour。
mucus	粘液。
mud	泥。ぬかるみ。
muffin	マフィン。カップ型に入れて焼いた小型パン。
muffler	マフラー。えり巻き。消音器。
mule	ラバ。雄のロバと雌の馬の雑種。
multitude	多数。群集。一般大衆。庶民。
murder	殺人。
murderer	殺人者。人殺し。
murmur	ささやき。つぶやき。ざわめき。せせらぎ。
muscle	筋肉。
museum	博物館。美術館。
mushroom	キノコ。
music	音楽。美しい調べ。楽譜。
musician	音楽家。
muskmelon	マスクメロン。
mustard	からし。マスタード。
mutter	つぶやき。不平。ゴロゴロと響く音。ざわざわという音。
MVP	最優秀選手。most valuable playerの略。
mysteries	mysteryの複数形。
mystery	神秘。推理小説。ミステリー。
myth	神話。
nail	(指の)つめ。くぎ。びょう。
name	名前。評判。有名人。
nap	うたた寝。昼寝。
napkin	ナプキン。おむつ。
Naples	イタリア南西部の港市、ナポリ。
Napoleon	フランスの英雄、ナポレオン。
narration	物語ること。叙述。語り。ナレーション。
narrator	物語る人。語り手。ナレーター。
NASA	アメリカ航空宇宙局、ナサ。
nation	国民。国。国家。
nationalism	愛国主義。民族主義。ナショナリズム。
nationalist	国粋主義。民族主義者。
nationality	国籍。
NATO	北大西洋条約機構。
naturalist	自然主義者。博物学者。
nature	自然。性質。本質。種類。
navel	へそ。中央。
navigation	ナビ。
navigator	航海者。航行者。操縦者。進路を指示する人。ナビゲーター。
navy	海軍。
Ne	ネオンの元素記号。
necessity	必要。(複数形で)必要なもの。
neck	首。えり。
necklace	首飾り。ネックレス。
need	必要。(複数形で)必要なもの。貧困。
needle	針。
neglect	無視。放置。怠慢。
negotiation	交渉。話し合い。商談。
Negro	黒人。ニグロ。
neighbor	近所の人。隣人。
neighborhood	近所。付近。
neon	ネオン。
nephew	甥（おい）。
Neptune	海王星。ネプチューン。
nerve	神経。勇気。
nest	巣。すみか。巣窟。
net	網。ネット。わな。落とし穴。
network	網細工。ネットワーク。
neutron	中性子。ニュートロン。
newcomer	来たばかりの人。新来者。
news	ニュース。新聞記事。変わったこと。たより。
newscaster	ニュースキャスター。
newsletter	ニューズレター。公報。時事通信。
newspaper	新聞。新聞社。新聞紙。
Newton	万有引力を発見した科学者ニュートン。
next	次の人。次の物。
Ni	ニッケルの元素記号。
nickel	ニッケル。
nickname	あだ名。愛称。ニックネーム。
niece	姪（めい）。
night	夜。夜間。
Nightingale	ナイチンゲール。
nightmare	悪夢。
nine	九つ。九個。九人。九歳。
nineteen	十九。十九個。十九人。十九歳。
ninety	九十。九十個。九十歳。
ninth	第九。九番目。(月の)九日。(theをつけて)九分の一。
nitrogen	窒素。
Nobel	ノーベル。
nobility	気高さ。高潔。(theをつけて)貴族(階級)。
nobody	だれでもない。無名の人。
nod	うなずくこと。居眠り。
noise	物音。騒音。ノイズ。
nomad	遊牧民。放浪者。
none	何もない。
nonsense	無意味。ナンセンス。
noon	正午。真昼。
normal	普通。正常。平熱。
north	(theをつけて)北。北部。
northeast	北東。北東部。
northwest	北西。北西部。
nose	鼻。嗅覚。突出部。機首。
notation	表記法。表示。記録。
notch	V字型の刻み目。階級。
note	覚え書き。注釈。ノート。短い手紙。音色。注意。紙幣。手形。
notebook	ノート。手帳。
nothing	何もない。無。
notice	注意。注目。通知。掲示。予告。警告。
notion	考え。概念。意向。思いつき。
noun	名詞。
nourishment	滋養物。栄養。食物。養育。
Nov	十一月。
novel	小説。
novelist	小説家。
novelty	目新しさ。斬新さ。珍しい物。
November	十一月。
now	今。現在。
nozzle	吹き出し口。発射口。ノズル。
nucleus	核。細胞核。原子核。
nude	裸。裸体。
nuisance	迷惑。
number	数。数字。総数。番号。曲目。ナンバー。
nurse	看護婦。看護人。ナース。
nursery	保育園。託児所。
nut	木の実。留めねじ。ナット。
nutmeg	ナツメグ。
nutrition	栄養補給。栄養分。栄養学。
nutrition	栄養補給。栄養分。栄養学。
NY	ニューヨーク。
nylon	ナイロン。
nymph	美しい精霊。美女。乙女。ニンフ。
oak	強固な木。オーク。オーク材。
oar	(ボートの)かい。オール。
oasis	オアシス。憩いの場。
oath	誓い。宣誓。断言。ののしり言葉。
oatmeal	オートミール。オートムギをひき割りにしたもの。朝食用かゆ。
obedience	服従。従順。忠実。教区。
obituary	死亡記事。
object	物。物体。目的。対象。目的語。
objection	反対。異議。
obligation	義務。責任。恩。債務。
oblivion	忘れられている状態。無意識の状態。恩赦。
observation	観察。観測。気づくこと。注意。意見。
observer	観察者。観測者。立会人。オブザーバー。
obstacle	邪魔。障害。妨害。
occasion	(特定の)時。場合。機会。特別な行事。理由。必要。
Occident	(theをつけて)西洋。
occupation	職業。仕事。占有。占領。
occurrence	事件。出来事。出現。存在。産出。
ocean	(theをつけて)大洋。海洋。海。
Oct	十月。
octave	一音階。オクターブ。
October	十月。
octopus	(動物の)タコ。
odds	見込み。有利な条件。優勢。勝ち目。賭け率。オッズ。
odor	におい。香り。
offense	違反。違法行為。攻撃。侮辱。立腹。無礼。
offer	申し出。提案。申し込み。
office	事務所。営業所。執務室。地位。職務。
officer	役員。公務員。将校。士官。警官。船長。
offset	差し引き。埋め合わせ。オフセット印刷。
oil	油。石油。油絵。
oink	豚の鳴き声。
OK	承認。許可。同意。オーケー。
okay	承認。許可。同意。オーケー。
olive	オリーブ。
omen	前兆。前触れ。予感。予言。
omission	省略。脱落。怠慢。不作為。
once	一度。一回。
one	一つ。一人。一歳。一時。
onion	タマネギ。
opener	開ける道具。最初の出し物。初戦。
opening	穴。開始。始め。開くこと。欠員。空き地。
opera	オペラ。歌劇。
operation	運転。操作。作用。実施。軍事行動。
operator	操作する人。電話交換手。外科手術者。
opinion	意見。見解。評価。
opium	アヘン。
opponent	敵対者。
opportunity	好機。機会。
opposition	抵抗。反対。対立。敵対者。
optimism	楽天主義。楽観主義。
optimist	楽天家。のんき者。楽天主義者。
option	選択権。選択の自由。
orange	オレンジ。みかん。
orangutan	オランウータン。
orbit	軌道。
orchard	果樹園。果樹。
orchestra	オーケストラ。管弦楽団。
order	命令。指図。順序。順番。規律。調子。注文。為替。
organ	(身体の)器官。(政府などの)機関。機関誌。(楽器の)オルガン。
organization	組織。構造。組織化。団体。
organizer	組織者。オルグ。まとめ役。
Orient	(theをつけて)東洋。
orientation	方位。方向性。志向。信条。適応。オリエンテーション。
origin	起源。始まり。生まれ。
originality	独創性。本物であること。
ornament	飾り。装飾。装飾品。
orphan	孤児。みなし子。親のない子。
orthodox	正統派。
ostrich	ダチョウ。
ounce	重さの単位、オンス。
ours	私たちのもの。
outcome	結果。結末。
outdoors	(theをつけて)野外。
outfit	一式。一行。したく。準備。
outing	遠足。外出。遠出。出場。
outlaw	無法者。お尋ね者。追放者。
outlet	はけ口。販路。出口。直売店。アウトレット。コンセント。
outline	輪郭。線画。概略。アウトライン。
outlook	眺め。展望。見通し。見解。見張り台。
output	生産。生産高。出力。アウトプット。
outrage	激怒。乱暴。侮辱。無礼。
outside	外側。外部。外見。
outsider	門外漢。部外者。
oval	卵形。長円形。
oven	オーブン。
overcoat	オーバーコート。外套。上塗り。
overflow	氾濫。あふれ。過多。排水口。排水管。
overlap	重なり。重複部分。はみ出し部分。オーバーラップ。
overload	積みすぎ。過負荷。
overseas	外国。国外。
overtime	超過時間。残業手当。延長戦。
overwork	働きすぎ。過労。
owl	フクロウ。ミミズク。
owner	持ち主。所有者。オーナー。
ox	雄牛。
oxen	oxの複数形。
oxygen	酸素。
oyster	カキ。アコヤガイ。
oz	重さの単位、オンス。
ozone	オゾン。
pa	お父ちゃん。
pace	一歩。歩み。歩幅。歩調。足並み。速度。
pack	包み。一箱。一包み。群れ。パック。
package	荷物。包み。小包。容器。包装。一箱。
packer	荷造り人。荷造り機。包装業者。缶詰業者。
packet	小包。定期船。
packing	荷造り。缶詰製造。輸送。詰め物。パッキング。
pad	当て物。パッド。帳面。発射台。
page	ページ。
pain	痛み。苦痛。
paint	ペンキ。塗料。絵の具。
painter	画家。ペンキ屋。
pair	一対。一組。ペア。
pajamas	パジャマ。
pal	友達。仲間。仲良し。
palace	宮殿。王宮。大邸宅。
palette	パレット。
palm	手のひら。
pamphlet	パンフレット。小冊子。小論文。
pancake	パンケーキ。
panda	パンダ。
pane	窓ガラス。
panel	はめ板。パネル。出席者。審査員。陪審員。
panic	大混乱。パニック。経済恐慌。
pansy	パンジー。三色スミレ。
panties	パンティー。
pantomime	パントマイム。身振り。茶番劇。
pants	ズボン。パンツ。
papa	パパ。お父ちゃん。
paper	紙。用紙。小論文。新聞。
par	同等。標準。額面価格。パー。
parachute	落下傘。パラシュート。
parade	行列。行進。パレード。
paradise	楽園。極楽。天国。
paradox	逆説。パラドックス。矛盾。詭弁。
paragraph	(文章の)段落。小記事。パラグラフ。
parallel	平行線。平行面。匹敵するもの。緯度。
paralysis	麻痺（まひ）。
parasite	寄生。寄生虫。居候。
parcel	小包。包み。小荷物。一区画。一片。一口。
pardon	寛容。勘弁。許し。恩赦。
parent	親。
parentheses	parenthesisの複数形。
parenthesis	丸カッコ。
Paris	フランスの首都、パリ。
park	公園。遊園地。広場。駐車場。
parliament	(英国の)国会。議会。立法府。
parlor	営業所。店。パーラー。
parody	パロディ。替え歌。こっけいな物まね。
parrot	オウム。
part	部分。役。役割。部品。側。パート。
participant	参加者。関係者。協力者。一味。
particle	微粒子。
parties	partyの複数形。
partisan	味方。同志。遊撃兵。パルチザン。
partner	相手。仲間。パートナー。配偶者。
party	パーティー。会合。集まり。政党。一隊。部隊。
pass	許可証。合格。送球。パス。厄介な状況。
passage	通路。細道。水路。通行。進行。通過。廊下。航路。船賃。一節。航行。
passenger	乗客。通行人。
passing	通行。通過。(事件の)発生。合格。可決。輸送。見落とし。
passion	情熱。熱情。激怒。恋心。
passport	旅券。パスポート。
password	合言葉。パスワード。
past	過去。
paste	(物を貼る)のり。練り粉のようなもの。ペースト。
pastel	パステル（クレヨンの一種）。
pastime	娯楽。気晴らし。
pasture	牧草地。牧場。牧草。
pat	軽くたたくこと。
patch	つぎはぎ。小区間。ばんそうこう。眼帯。斑点。パッチ。
patchwork	つぎはぎ細工。パッチワーク。
patent	特許。特許権。パテント。
path	道。小道。歩道。通路。進路。
patience	我慢。忍耐。辛抱強さ。
patient	患者。
patriot	愛国者。
patrol	巡回。巡視。パトロール。
patron	後援者。パトロン。常連。
pattern	模様。柄。模範。手本。原型。型紙。型。様式。
pause	休止。中断。ためらい。合間。区切り。
pavement	舗装道路。舗道。
pavilion	仮設の建物。大型テント。パビリオン。病棟。
pay	賃金。給料。
payment	支払い。納入。支払い金額。
PC	パソコン。
pea	エンドウ。えんどう豆。「グリーンピース」＝``green ～s''
peace	平和。平穏。無事。
peacetime	平時。平和な時。
peach	モモ。ピーチ。
peacock	雄クジャク。
peak	山頂。とがったものの先端。絶頂。ピーク。
peanut	ピーナッツ。落花生。
pearl	真珠。真珠に似たもの。貴重なもの。
peasant	小作人。農民。
pebble	丸い小石。
pedal	ペダル。踏み板。
pedestrian	歩行者。徒歩旅行者。通行人。
peek	(aをつけて)のぞき見。ちらっと見ること。
peep	(aをつけて)のぞき見。のぞき穴。(theをつけて)見え始め。
peephole	のぞき穴。
peg	釘。くい。
Pegasus	ペガサス。天馬。
pelican	ペリカン。
pen	ペン。万年筆。(家畜の)おり。刑務所。
penalty	刑罰。罰金。罰点。ペナルティ。
pence	(金額としての)pennyの複数形。
pencil	鉛筆。
pendant	ペンダント。耳飾り。たれ飾り。シャンデリア。
penguin	ペンギン。
peninsula	半島。
pennant	(横長の)三角旗。信号旗。優勝旗。ペナント。
penny	ペニー。
pension	年金。恩給。助成金。手当。
pentagon	五角形。
people	人々。国民。民族。人たち。
pepper	コショウ。香辛料。
peppermint	ペパーミント。ハッカ。
percent	パーセント。
percentage	百分率。割合。
perch	止まり木。高い場所。
perfection	完成。仕上げ。完全さ。
performance	実行。遂行。公演。演奏。演技。業績。性能。
performer	行為者。実行者。演技者。演奏者。
perfume	香水。香料。いい香り。芳香。
peril	危険。危難。危機。
period	(一定の)期間。時代。授業時間。時限。終止符。ピリオド。
permission	許し。許可。
person	人。個人。身体。体。姿。
personality	個性。性格。人格。有名人。
personnel	全職員。人員。人事部。人事課。
persuasion	説得。説得力。確信。信念。宗派。
pessimism	悲観主義。厭世主義。
pessimist	悲観論者。厭世主義者。
pest	害虫。害獣。やっかい者。
pet	ペット。愛玩動物。お気に入り。
Peter	ピーター。男子の名。
petrol	ガソリン。
petroleum	石油。
phantom	幽霊。幻想。錯覚。
phase	局面。段階。位相。様相。
phenomenon	現象。異常なもの。珍しいこと。
philosopher	哲学者。哲人。
philosophy	哲学。原理。悟り。
phoenix	不死鳥。フェニックス。
phone	電話。電話機。受話器。
photo	写真。
photograph	写真。
photographer	写真家。
phrase	成句。熟語。慣用句。フレーズ。言い回し。
physician	内科医。
physicist	物理学者。
physics	物理学。
pianist	ピアニスト。ピアノ演奏者。
piano	ピアノ。
pick	選択。選択したもの。つるはし。ほじるもの。(theをつけて)えり抜き。
picker	つつく人。ほじる道具。(果実・花などを)摘む人。採集者。
pickle	漬け物。ピクルス。
pickup	乗せること。小型トラック。向上。上昇。捕球。掘り出し物。逮捕。ピックアップ。
picnic	ピクニック。遠足。
picture	絵。絵画。写真。
pie	パイ。
piece	部分。破片。一枚。一本。一切れ。一点。一編。一曲。
pierrot	道化役。ピエロ。
pig	豚。
pigeon	ハト。若い女性。だまされやすい人。
pigment	絵の具。顔料。色素。
pile	積み重ね。堆積。山。多数。大金。大建築物。
pilgrim	巡礼者。旅人。放浪者。
pill	錠剤。丸薬。ピル。避妊薬。
pillar	柱。支柱。中心人物。
pillow	まくら。
pilot	パイロット。操縦士。案内人。種火。
pin	ピン。留め針。止め釘。
pinch	つまむこと。痛さ。一つまみ。苦難。ピンチ。
pine	松。
pineapple	パイナップル。
pink	桃色。ピンク。
pinpoint	ピンの先。正確な位置。
pioneer	開拓者。先駆者。草分け。パイオニア。
pipe	管。筒。パイプ。
pipeline	輸送管路。パイプライン。橋渡し役。
pirate	海賊。略奪者。著作権侵害者。盗作者。
pistol	ピストル。拳銃。
piston	ピストン。
pit	穴。くぼみ。落とし穴。縦穴。給油や整備をする所。ピット。
pitch	投球。程度。音の調子。傾斜。ピッチ。
pitcher	投手。ピッチャー。(取っ手つきの)水差し。
pity	哀れみ。同情。残念なこと。
pivot	回転軸。軸。ピボット。(天秤などの)支点。
pizza	ピッツァ。ピザ。
place	場所。所。地域。土地。所定の場所。箇所。席。座席。地位。順位。
plague	疫病。災い。
plan	計画。案。プラン。設計図。略図。
plane	飛行機。平面。面。
planet	惑星。
plankton	プランクトン。
planner	計画者。立案者。
plant	植物。草木。設備。工場。
plantation	大農場。植林地。
planter	栽培者。種まき機。大農園経営者。プランター。
plaster	しっくい。石膏。膏薬。絆創膏。
plastic	プラスチック。
plate	(浅い)皿。料理一皿分。平板。プレート。
plateau	高原。台地。
platform	壇。教壇。プラットホーム。
platinum	白金。プラチナ。
play	遊び。気晴らし。劇。芝居。競技。試合ぶり。
player	選手。役者。演奏者。プレーヤー。
playground	遊び場。運動場。行楽地。
plea	弁解。申し立て。嘆願。
pleasure	喜び。楽しさ。愉快。満足。
pledge	誓い。誓約。担保。(友情・忠誠などの)しるし。保証。
plenties	plentyの複数形。
plenty	たくさん。十分。多量。豊富さ。豊かさ。
plot	たくらみ。陰謀。(小説などの)筋。プロット。図面。小区画地。
plug	差し込み。プラグ。栓。消火栓。
plum	西洋スモモ。プラム。
plumage	(全体の)羽毛。羽。派手な服。
plunder	略奪。不法占有。横領。盗品。
plus	正の数。正符号。プラス。
Pluto	冥王星。
plutonium	プルトニウム。
PM	午後。
PO	郵便局。
POB	郵便私書箱。
pocket	ポケット。
poem	詩。
poet	詩人。
poetry	(集合的に)詩。作詞。詩歌。韻文。
point	先端。点。地点。得点。要点。目的。程度。ポイント。
pointer	指し示すもの。ポインター。
poison	毒。毒薬。弊害。
poker	突くもの。火かき棒。(トランプの)ポーカー。
Poland	ポーランド。
Pole	ポーランド人。
police	(theをつけて)警察。治安。公安。
policeman	警官。巡査。
policewoman	婦人警官。婦警。
policy	政策。方針。手段。ポリシー。
Polish	ポーランド語。
politician	政治家。政治屋。
politics	政治。政治学。政見。
poll	投票。投票数。選挙人名簿。世論調査。
pollution	汚染。公害。不潔。汚れ。
polygon	多角形。
pond	池。沼。泉水。
pony	子馬。ポニー。小型のもの。
pool	水たまり。プール。
pop	ポンという音。発泡性飲料水。
popcorn	ポップコーン。
pope	(theをつけて)ローマ法王。
poplar	ポプラ。ポプラ材。
population	人口。住民数。
porch	張り出し玄関。ポーチ。
pork	豚肉。
port	港。港町。港市。
porter	運搬人。(駅の)赤帽。ポーター。
portion	一部分。分け前。一人前。運命。
portrait	肖像。肖像画。似顔絵。描写。
Portugal	ポルトガル。
Portuguese	ポルトガル人。ポルトガル語。
pose	姿勢。ポーズ。見せ掛け。
position	位置。ポジション。姿勢。職。地位。見解。
possession	所有。占有。所持。所有物。領地。領土。
possibility	可能性。見込み。
post	郵便。ポスト。柱。地位。職。持ち場。
postage	郵便料金。
postcard	はがき。
poster	ポスター。広告ビラ。
postscript	追伸。
posture	姿勢。態度。
pot	つぼ。かめ。はち。ポット。
potato	イモ。
pottery	陶器類。
pouch	小袋。ポーチ。
poultry	飼い鳥の類。
pound	ポンド。イギリスの貨幣単位。重さの単位（約454グラム）。
poverty	貧乏。貧困。欠乏。不足。不毛。
powder	粉末。粉。おしろい。粉薬。火薬。
power	力。知力。体力。権力。強国。パワー。
PR	広報。宣伝活動。public relationsの略。
practice	練習。けいこ。実行。実際。習慣。業務。開業。
praise	賞賛。ほめ言葉。(神への)賛美。賛歌。
prank	（悪意のない）いたずら。
prayer	祈る人。祈り。願い事。
preacher	説教師。伝道者。牧師。訓戒者。唱道者。
precedent	前例。先例。慣例。判例。
precision	正確。的確。精密さ。明確。精度。
predator	捕食者。捕食動物。略奪する人。
prediction	予言。予報。予見。予測。
preface	序文。序論。前置き。はしがき。発端。
preference	好み。ひいき。優位。好きなもの。優先権。特恵。
prejudice	偏見。先入観。嫌悪感。
premium	プレミアム。賞。手数料。謝礼。保険料。奨励金。
preparation	準備。用意。予習。調合。料理。
prescription	処方箋。処方薬。指示。時効。
presence	存在。出席。面前。プレゼンス。
present	現在。現時点。現在時制。
presentation	提示。発表。説明。プレゼン。贈呈。紹介。披露。
preserve	保存するもの。ジャム。禁猟区。禁漁区。保護区。
president	(theをつけて)大統領。学長。社長。会長。総裁。
press	押すこと。圧迫。出版。圧縮。切迫。
pressure	圧力。圧縮。圧迫。強制。プレッシャー。
pretense	見せ掛け。まね。口実。言い訳。
prevention	防止。予防。
preview	試写会。試演。予告編。番組予告。プレビュー。
prey	えじき。犠牲。捕食。
price	値段。価格。代償。懸賞金。
prick	針で刺すこと。ちくちくする痛み。刺し傷。
pride	誇り。自尊心。うぬぼれ。自慢。
priest	聖職者。司祭。
prime	(theをつけて)全盛期。初期。素数。
prince	王子。皇子。プリンス。公爵。
princess	王女。皇女。プリンセス。公爵夫人。
principal	校長。学長。長。主役。主犯。本人。
principle	原理。原則。法則。節操。(複数形で)信条。
print	印刷。印刷物。プリント。版画。
priority	優先順位。優先権。
prism	プリズム。角柱。
prison	刑務所。拘置所。監獄。
prisoner	捕虜。囚人。
privacy	私生活。個人情報。プライバシー。
privilege	特権。特典。(theをつけて)基本的権利。
prize	ほうび。賞。賞品。賞金。景品。目的物。
pro	専門家。プロ。玄人。賛成者。
probability	確率。見込み。蓋然性。起こりうること。
probation	仮採用。執行猶予。保護観察。
problem	問題。課題。
procedure	手続き。手順。処置。方法。進行。
process	過程。経過。製法。工程。作用。プロセス。
procession	行進。行列。列。
prod	つつくこと。突き棒。刺し針。
producer	生産者。製作者。プロデューサー。演出家。
product	生産物。製品。成果。作品。積。生成物。
production	生産。製造。製作。産物。製品。製作所。
profession	職業。専門職。(theをつけて)同業者。
professor	教授。
profile	横顔。外形。概要紹介。プロフィール。
profit	収益。利潤。利益。得。
program	プログラム。番組。予定。計画。
progress	前進。進行。進歩。発達。上達。
prohibition	禁止。禁止令。
project	計画。企画。計画事業。プロジェクト。
projection	突出。突起。発射。投影。映写。計画。見通し。
projector	投影機。プロジェクター。放射器。計画者。
prom	(高校・大学などの公式)舞踏会。
promise	約束。誓い。有望。気配。
promoter	プロモーター。促進者。主催者。発起人。
promotion	昇格。昇進。進級。助成。促進。販売促進。宣伝。
pronoun	代名詞。
pronunciation	発音。
proof	証明。証拠。試験。校正刷り。
propaganda	プロパガンダ。
propane	プロパン(ガス)。
propeller	プロペラ。
prophet	預言者。
proportion	割合。比率。つりあい。部分。比例。
proposal	提案。申し出。プロポーズ。
proposition	提案。申し出。仕事。問題。主題。命題。
prose	散文。
prospect	見込み。公算。見通し。展望。
prosperity	繁栄。繁盛。幸運。
prostitute	売春婦。
prostitution	売春。
protection	保護。擁護。防護するもの。保護者。
protector	保護者。保護する物。プロテクター。
protein	たんぱく質。
protest	抗議。異議。主張。
Protestant	新教徒。
proton	陽子。プロトン。
prototype	原型。試作品。手本。模範。
protractor	分度器。
proverb	ことわざ。格言。
provision	供給。支給。用意。準備。条項。(複数形で)食糧。
prudence	用心深さ。慎重さ。思慮分別。
prune	プルーン。干しスモモ。濃い赤紫色。
PS	追伸。公立小・中学校。
psychology	心理学。
Pt	プラチナの元素記号。
PTA	父母と教師の会（parent-teacher association）。
PTO	裏面に続く（please turn over）。
Pu	プルトニウムの元素記号。
pub	パブ。大衆酒場。
public	(theをつけて)公衆。世間。一般人。
publication	公表。発表。出版。発行。出版物。
publisher	出版社。出版業者。発行者。
pudding	プディング。
puff	一吹き。息。(タバコの)一服。ふくらみ。パフ。
pull	引くこと。引力。引き手。一こぎ。一服。
pulp	どろどろしたもの。果肉。(製紙原料の)パルプ。
pulse	脈拍。鼓動。波動。振動。意向。気分。
pump	ポンプ。
pumpkin	カボチャ。
punch	げんこつで殴ること。パンチ。
punctuation	句読点。
punishment	罰。刑罰。処罰。虐待。
pupil	生徒。教え子。弟子。ひとみ。瞳孔。
puppy	子犬。犬ころ。青二才。
purple	紫色。帝位。王位。
purpose	目的。目標。決心。決意。
purse	財布。がま口。
pursuit	追跡。追求。(複数形で)研究。業務。趣味。
push	押し。突き。奮闘。努力。ねばり。
pusher	押しの強い人。押し売りする人。押すもの。
putt	(ゴルフの)パット(の一打)。
putter	(ゴルフの)パター。パットする人。
puzzle	パズル。難問。(aをつけて)当惑。
pyramid	ピラミッド。金字塔。
python	ニシキヘビ。
quack	アヒルの鳴き声。
quake	地震。震え。揺れ。
qualification	資格。免許状。資格証明書。適性。資格取得。制限。条件。
quality	質。品質。特質。本質。高級。上等。
quantity	量。数量。
quantum	定量。量子。
quarrel	口論。口げんか。
quarter	四分の一。十五分。四半期。方角。二十五セント。
queen	女王。王妃。クイーン。
query	疑問。質問。疑問符。問合せ。照会。
question	質問。問い。問題。疑問。
queue	(順番を待つ人・車などの)列。待ち行列。おさげ。
quiet	静けさ。静寂。平静。平和。
quilt	キルト。
quiz	クイズ。小テスト。尋問。
Ra	ラジウムの元素記号。
rabbit	ウサギ。
raccoon	アライグマ。
race	競走。レース。人種。民族。品種。
racer	競走者。レーサー。速度の速いもの。
rack	ラック。棚。台。掛け。破滅。首肉。あばら肉。
racket	ラケット。騒音。大騒ぎ。密売。悪事。
radar	レーダー。電波探知機。
radiation	放射。放射線。放射状。
radiator	放熱体。放熱器。ラジエーター。冷却装置。
radio	(theをつけて)ラジオ。無線通信。
radioactivity	放射能。
radium	ラジウム。
radius	半径。
radon	ラドン。
rag	くず。ぼろきれ。切れ端。
rage	激怒。激しさ。強い欲望。大流行。
raid	襲撃。急襲。不法侵入。大攻勢。
rail	横木。横棒。手すり。レール。鉄道。
railroad	鉄道。鉄道線路。鉄道会社。
railway	線路。鉄道。
rain	雨。降雨。雨天。
rainbow	虹。
raincoat	レインコート。
rainfall	降雨。降雨量。
raisin	干しぶどう。
rally	大集会。大会。回復。ラリー。
ranch	大牧場。大農場。農場。飼育場。
random	無作為。
range	範囲。領域。射程。列。レンジ。射撃場。
rank	列。並び。階級。階層。等級。身分。ランク。
ranking	順位。等級付け。ランキング。
rap	軽くたたくこと。トントンたたく音。
rape	強姦。レイプ。侵犯。
rapture	大喜び。有頂天。狂喜。
raspberry	ラズベリー。暗い赤紫色。
rat	大型のネズミ。卑怯者。裏切り者。
rate	割合。率。進行度。速さ。等級。
ratio	比。比率。割合。
ration	配給。配給量。
rattle	ガタガタいう音。
rattlesnake	ガラガラヘビ。
ravage	破壊行為。破壊。略奪。
ray	光線。放射線。
razor	かみそり。
reach	届く範囲。(一面の)広がり。
reaction	反応。反作用。反発。反抗。反動。
reactor	反応する人。原子炉。
reader	読者。読書家。読本。リーダー。
reading	読むこと。読書。読み物。記事。解釈。
realism	現実主義。写実主義。リアリズム。実在論。
realist	現実主義者。写実主義者。実在論者。
reality	現実。実在。本質。実物そっくりであること。
realm	領域。範囲。分野。王国。
reaper	刈る人。刈り取り機。
rear	後ろ。後部。背後。裏側。
reason	理由。わけ。動機。理性。判断力。道理。
reasoning	推論。推理。論法。
rebellion	反逆。反乱。反抗。
rebirth	再生。更生。復活。蘇生。
rebound	はね返り。反響。反動。
recall	呼び返すこと。リコール。回想。取り消し。撤回。
receipt	受け取ること。受領。領収書。レシート。
receiver	受け取り人。受話器。受像機。受信機。レシーバー。
reception	歓迎会。レセプション。
recess	休み。休憩。引っ込んだ部分。
recipe	調理法。レシピ。秘訣。
recital	独奏会。独唱会。リサイタル。朗読。
recognition	認識。承認。容認。認定。表彰。報償。お礼。
recollection	思い出すこと。回想。思い出。
record	記録。記載。経歴。成績。レコード。
recorder	記録係。記録者。記録装置。レコーダー。リコーダー。
recovery	回復。取り戻すこと。復帰。復旧。
recreation	気晴らし。レクリエーション。
rectangle	長方形。矩形。
red	赤。赤色。(theをつけて)赤字。
reduction	減少。縮小。割引。約分。通分。還元。
reel	(糸・テープなどを巻く)リール。一巻き。よろめき。
referee	審判員。レフェリー。
reference	参照。参考。言及。参照箇所。出展。関係。
refinement	洗練。精錬。純化。
reflection	反射。反響。熟考。非難。
reform	改革。改良。改善。更生。
reformation	更生。改良。改善。改革。刷新。
reformer	改良者。革新者。改革論者。改良装置。
refrain	繰り返し文句。反復句。リフレーン。
refreshment	元気の回復。気分をさわやかにすること。休息。
refrigerator	冷蔵庫。
refuge	避難。保護。避難所。
refusal	拒絶。拒否。辞退。
regard	敬意。尊敬。注意。凝視。好意。よろしくという伝言。
regime	政治体制。政治制度。政権。制度。体制。
region	地方。地域。地帯。領域。部位。
register	登記簿。登録簿。名簿。記録。レジスター。
regret	後悔。残念。気の毒。(複数形で)お断り状。
regularity	規則正しさ。秩序。正規性。
regulation	規則。規定。条例。調整。加減。調節。
reign	支配。当地。治世。
rein	たづな。制御手段。けん制。
reindeer	トナカイ。
reject	廃棄物。不合格品。
relation	関係。関連。親戚関係。
relaxation	ゆるみ。休養。くつろぎ。
relay	交替。リレー。中継。
release	解放。釈放。発射。投下。公表。封切り。発売。
reliability	信頼性。
reliance	頼みの綱。頼りになるもの。
relief	緩和。軽減。安堵。救援。息抜き。交替。浮き彫り。
religion	宗教。宗派。信仰。
remainder	(theをつけて)残り。残り物。差。剰余。
remains	残り。残高。遺跡。遺体。
remark	(簡単な)意見。感想。批評。注目。発言。
remedy	治療法。救済手段。特効薬。
remembrance	記憶。思い出。記念品。(複数形で)よろしくとの伝言。
reminder	思い出させるもの。記念品。かたみ。
removal	除去。切除。転勤。転居。解任。
Renaissance	(theをつけて)文芸復興。ルネッサンス。
rendezvous	待ち合わせ。ランデブー。集合場所。集結地。
renewal	再開。再建。復活。再生。蘇生。回復。再契約。更新。書き換え。
rent	賃借料。家賃。部屋代。
rental	賃貸料。賃借使用量。レンタル。賃借物。
repair	修繕。修理。手入れ。行くこと。
repeat	繰り返し。反復。再上演。再放送。
repetition	繰り返し。反復。復唱。写し。複写。
replacement	元へ戻すこと。返済。復職。置き換え。交替。
replica	レプリカ。写し。複写。複製。
reply	答え。返事。
report	報告。レポート。報告書。報道。風評。うわさ。評判。
reporter	報告者。通報者。情報提供者。記者。通信員。レポーター。
representation	表現。描写。代理。演出。
reproduction	再生。再現。複写。複製。複写物。
republic	共和国。共和政体。
reputation	評判。名声。
request	要求。以来。願い事。
requirement	要件。必要条件。資格。必要品。
rescue	救助。救出。
research	研究。調査。
researcher	研究員。調査者。
resemblance	類似。類似点。類似したもの。
resentment	憤慨。怒り。敵意。恨み。
reservation	予約。保留。遠慮。制限。条件。
reserve	たくわえ。保留。予備。控えめ。遠慮。制限。条件。
residence	邸宅。住居。駐在。所在。残留。
resident	居住者。在住者。
resistance	抵抗。反対。抵抗力。
resistant	抵抗者。反対者。
resolution	決断。決意。決心。決議。分解。分析。解像度。
resort	行楽地。保養地。たまり場。頼り。
resource	資源。物資。手段。機知。機転。源泉。退屈しのぎ。
respect	尊敬。敬意。尊重。重視。敬意の表現。点。関係。関連。
response	応答。反応。反響。
responsibility	責任。責務。負担。
rest	休息。休憩。休養。睡眠。安静。台。休止。残り。
restaurant	レストラン。料理店。食堂。
restoration	回復。復旧。復興。復活。返還。返却。復帰。修復。
restraint	自制。慎み。忍耐。制限。規制。抑制。
restriction	制限。限定。制約。遠慮。
result	結果。成果。効果。答え。
retail	小売り。
retailer	小売商人。受け売りする人。言いふらす人。
retina	(目の)網膜。
retirement	退去。退却。引退。退職。隠居。
retort	しっぺ返し。
retreat	後退。退却。隠退。
return	帰ること。帰還。帰宅。返却。繰り返し。循環。返事。利益。
reuse	再利用。
revenge	報復。仕返し。復讐。
reverence	尊敬。畏怖。敬礼。おじぎ。
reverse	逆転。(theをつけて)逆。反対。裏側。
review	批評。評論。復習。再調査。概説。概観。反省。
revision	校正。改訂。改訂版。復習。
revival	蘇生。復活。再流行。復興。
revolt	反乱。反抗。反逆。反感。
revolution	革命。大変革。回転。公転。
revolver	回転式連発ピストル。リボルバー。回転装置。
reward	ほうび。報酬。報奨金。謝礼金。
rheumatism	リューマチ。
rhino	サイ。
rhyme	韻。押韻。同韻語。押韻詩。
rhythm	リズム。律動。周期的運動。
rib	ろっ骨。あばら骨。あばら肉。
ribbon	リボン。飾りひも。ひも状のもの。
rice	イネ。米。ご飯。
riches	富。財宝。豊かさ。
riddle	謎。
ride	乗ること。道のり。所要時間。
rider	乗る人。騎手。
ridge	山の背。尾根。背筋。(畑などの)うね。あぜ。(屋根の)むね。
rifle	ライフル銃。小銃。
right	右。右側。
rim	(円形のものの)ふち。へり。(車輪の)わく。外輪。リム。
ring	輪。輪形のもの。指輪。リング。
rinse	すすぎ洗い。すすぎ水。リンス。
rip	裂け目。ほころび。傷口。
rise	上昇。増加。昇進。上り坂。起源。出現。
risk	危険性。恐れ。リスク。
rival	競争相手。ライバル。
river	川。
Rn	ラドンの元素記号。
road	道路。街道。...街。
roadside	(theをつけて)道ばた。
roar	ほえ声。うなり声。とどろき。
roast	焼き肉。焼いた物。
robber	強盗。追いはぎ。
robe	(長くゆったりとした)外衣。ローブ。
Robert	ロバート。男子の名。
robot	ロボット。人造人間。
rock	岩。岩石。(複数形で)暗礁。
rocket	ロケット。ロケット弾。打ち上げ花火。
rod	さお。棒。むち。(theをつけて)むち打ち。
role	役。役柄。役目。役割。
roll	巻物。一巻き。名簿。出席簿。回転。ころがり。
roller	ローラー。地ならし機。ころ。
Roman	古代ローマ人。
romance	恋愛関係。ロマンス。ロマンチックなこと。
Rome	ローマ。古代ローマ帝国。
roof	屋根。屋上。屋根状のもの。
rookie	(プロの)新人。ルーキー。新入り。
room	部屋。室。場所。空間。余地。
root	根。根元。付け根。根本。原因。祖先。ルーツ。
rope	なわ。綱。ロープ。投げなわ。
rose	バラ。ばら色。
rot	腐敗。腐敗物。腐敗病。
rotation	回転。循環。自転。交替。輪作。
round	円。輪。丸いもの。回転。一勝負。ラウンド。
route	(目的地までの)道。道すじ。ルート。
routine	ルーチン。型にはまった手順。日常の仕事。
row	列。並び。座席の列。こぐこと。
rubber	ゴム。ゴム製品。
rubbish	くず。がらくた。
ruby	ルビー。紅玉。深紅色。
rug	(床の一部に敷く)じゅうたん。敷き物。
Rugby	ラグビー。
ruin	破滅。破産。崩壊。
rule	規則。法則。ルール。慣例。きまり。普通のこと。支配。
ruler	統治者。支配者。定規。
rumor	うわさ。
run	走ること。一走り。競走。運行。操業。連続。
runner	走る人。走者。ランナー。使い走り。
running	走ること。ランニング。経営。運転。競走。競馬。
runway	滑走路。走路。(野獣の)通り道。(劇場の)花道。
rush	突進。殺到。多忙。
Russia	ロシア。
Russian	ロシア人。ロシア語。
rust	さび。
rustle	カサカサいう音。
sack	麻袋。一袋分。ゆるやかな上着。
sacrifice	いけにえ。犠牲。
saddle	鞍（くら）。サドル。
sadness	悲しみ。悲しさ。
safe	金庫。貯蔵庫。
safety	安全。無事。安全性。安全装置。セーフティ。
sail	(船の)帆。航海。航程。帆船。
sailor	水夫。船乗り。水兵。
saint	聖者。聖人。
salad	サラダ。
salary	給料。サラリー。
sale	販売。売却。売れ行き。特売。
salesman	販売員。店員。外交員。セールスマン。
salmon	(魚の)サケ。サーモン。
salon	(美容・服飾などの)店。客間。サロン。
salt	食塩。塩。
salvage	海難救助。沈没船の引き上げ。救助料。サルベージ。
same	(theをつけて)同じもの。
sample	見本。標本。サンプル。実例。
sanctuary	神聖な場所。聖域。禁猟区。鳥獣保護区。
sand	砂。砂浜。
sandwich	サンドイッチ。
sanitation	公衆衛生。衛生設備。下水設備。
sardine	イワシ。
Sat	土曜日。
satellite	衛星。人工衛星。衛星国。衛星都市。
satisfaction	満足。満足させること。
Saturday	土曜日。
Saturn	土星。サターン。
sauce	(料理に使う)ソース。
saucer	受け皿。浅い皿状のもの。
sausage	ソーセージ。腸詰め。
savanna	サバンナ。木が少ない草原。(亜)熱帯地方の大草原。
saving	節約。倹約。貯金。救助。救済。
savior	救済者。救い手。
savor	風味。香り。持ち味。魅力。
saw	のこぎり。
sax	サックス。サクソホーン。
saxophone	サックス。サクソホーン。
say	言いたいこと。発言権。
saying	言うこと。ことわざ。格言。
scale	目盛り。物差し。縮尺。規模。音階。てんびんの皿。
scalp	(頭髪のついた)頭皮。
scan	ざっと見ること。綿密な検査。精査。スキャン。
scandal	醜聞。スキャンダル。恥辱。悪評。陰口。
scapegoat	他人の罪を負う者。身代わり。スケープゴート。
scar	傷跡。
scare	おびえ。恐怖。恐慌。
scarf	スカーフ。えり巻き。結びネクタイ。
scarlet	緋色。深紅色。
scenario	シナリオ。脚本。台本。筋書き。
scene	現場。一場面。景色。シーン。大騒ぎ。
scenery	景色。風景。景観。舞台装置。
scent	におい。芳香。香水。(aをつけて)嗅覚。
schedule	時刻表。予定。予定表。スケジュール。表。
scheme	計画。体系。図表。図解。陰謀。配列。
scholar	学者。奨学金受給者。
scholarship	奨学金。学問。学識。育英会。
school	学校。授業。(theをつけて)全校生徒。学部。学派。
schoolboy	男生徒。
schoolchild	学童。
schoolgirl	女生徒。
schoolmaster	男の教師。
schoolmistress	女の教師。
schoolteacher	学校教師。
science	科学。理科。
scientist	科学者。
scissors	はさみ。
scoop	ひしゃく。大さじ。一すくい。特ダネ。スクープ。
scope	(能力・理解・活動などの)範囲。限界。機会。広がり。
score	得点。スコア。成績。二十。
scorn	軽蔑。さげすみ。あざけり。
scorpion	サソリ。
Scot	スコットランド人。
Scotish	スコットランド人。スコットランド語。
Scotland	スコットランド。
scout	スカウト。斥候。偵察。
scrap	かけら。切れはし。くず鉄。くず。スクラップ。(新聞の)切り抜き。
scratch	ひっかくこと。かすり傷。なぐり書き。
scream	悲鳴。金切り声。鋭い音。
screen	ついたて。びょうぶ。映写幕。スクリーン。
screw	ねじ。スクリュー。一ねじり。
scribble	走り書き。落書き。
scroll	巻き物。渦巻き。スクロール。
scrub	ごしごしこすること。
scuba	スキューバ。
sculptor	彫刻家。
sculpture	彫刻。彫刻品。彫像。
SE	南東。
sea	海。
seafood	海産食品。
seal	紋章。印鑑。判。封印。シール。口封じ。
seam	縫い目。継ぎ目。縫合した跡。
seaman	船乗り。上等水兵。男の人魚。
search	捜査。捜索。検索。
seaside	(theをつけて)海辺。浜辺。海岸。
season	季節。時期。盛り。
seasoning	(薬味・香料などの)調味(料)。味付け。
seat	席。座席。座。シート。中心地。
seaweed	海藻。海草。
sec	秒。
second	(theをつけて)二番目。(月の)二日。二世。二塁手。
secret	秘密。内緒。秘訣。神秘。不思議。
secretary	秘書。書記。幹事。書記官。
section	切ること。切開。切り取った部分。階級。課。売り場。節。セクション。
sector	扇形。
security	安全。安全確保。安心感。警備。担保。保証人。
seed	種。種子。実。シード。
seeing	見ること。視覚。視力。
seeker	探求者。捜索装置。追尾装置。
segment	線分。切片。一番組。
selection	選択。選抜。選ばれたもの。淘汰。
self	自分。自己。自身。個性。本性。自我。
seller	売る人。売り手。販売人。売れる商品。
selves	selfの複数形。
semicolon	セミコロン（;）。
senate	上院。議会。元老院。理事会。評議会。
senator	議員。上院議員。元老院議員。評議員。
sender	送り主。発送人。送信機。
senior	年長者。先輩。上級生。
sensation	感覚。感じ。気持ち。興奮。感動。大評判。大騒ぎ。
sense	感覚。感じ。気持ち。意味。分別。
sensitivity	敏感さ。感受性。感度。
sensor	センサー。感知装置。
sentence	文章。文。判決。宣告。
sentiment	感情。情。気持ち。意見。情緒。感傷。
Sep	九月。
separation	分離。区分。分割。割れ目。離職。除隊。
September	九月。
sequence	連続。連続物。順序。結果。数列。
series	一続き。連続。シリーズ。級数。直列。
sermon	説教。
servant	召使い。使用人。家来。公務員。
serve	サーブ。
server	給仕。サーバー。
service	奉仕。サービス。勤務。兵役。(乗り物などの)便。礼拝。
sesame	ゴマ。
session	開会。開廷。会合。会期。セッション。
set	セット。一式。連中。舞台装置。
setting	セットすること。没すること。周囲の環境。セッティング。
seven	七。七人。七個。七歳。七時。
seventeen	十七。十七人。十七個。十七歳。
seventh	第七。七番目。(月の)七日。(aかoneをつけて)七分の一。
seventy	七十。七十人。七十個。七十歳。
sewage	下水。
sewer	下水管。
sex	性。性別。セックス。
SF	空想科学小説。
shade	陰。物陰。日陰。日よけ。色合い。
shadow	影。映像。暗がり。幻想。
shaft	柄。矢。やり。シャフト。
shake	振ること。振動。動揺。
sham	まがいもの。覆い。詐欺師。
shame	恥。恥ずかしさ。恥辱。
shampoo	洗髪。シャンプー。
shape	形。形状。姿。状態。幻影。
share	分け前。分担。役割。株。市場占有率。
shark	サメ。
sharp	シャープ。嬰記号。
shave	ひげをそること。削り道具。削りくず。
shaving	削りくず。ひげをそること。削ること。
shawl	肩掛け。ショール。
she	彼女。
sheep	羊。
sheet	敷布。シーツ。一枚。印刷物。広がり。
shelf	棚。岩だな。浅瀬。暗礁。
shell	殻。甲。さや。砲弾。薬きょう。
shelter	避難所。すみか。避難。保護。シェルター。
shelves	shelfの複数形。
shepherd	羊飼い。牧師。保護者。牧羊犬。
shield	盾。防御。シールド。
shift	移動。転換。推移。交替。交替時間。シフト。
shine	輝き。晴天。日光。靴を磨くこと。
ship	(大型の)船。飛行船。宇宙船。
shirt	(男子用の)ワイシャツ。シャツ。肌着。
shock	衝撃。激突。ショック。
shoe	靴。
shop	店。小売店。
shopping	買い物。ショッピング。
shore	海岸。湖岸。湖畔。河岸。陸。陸地。
shoreline	海岸線。
shortage	不足。欠乏。
shortcut	近道。手抜き。
shorts	半ズボン。ショーツ。パンツ。
shot	発射。発砲。射程。弾丸。撃つ人。ショット。注射。一服。
shotgun	散弾銃。猟銃。
shoulder	肩。
shout	叫び。叫び声。
shove	(aをつけて)突くこと。一押し。
shovel	シャベル。シャベル一杯分。
show	ショー。見せ物。点j回。見せること。表示。
showcase	陳列用ガラス箱。ショーケース。
shower	にわか雨。夕立。シャワー。シャワーを浴びること。
showroom	陳列室。ショールーム。
shriek	金切り声。悲鳴。鋭い音。
shrimp	小エビ。
shrine	聖堂。神社。聖地。
shrub	低木。シュラブ。
shuffle	足を引きずること。トランプを混ぜること。シャッフル。
shutter	よろい戸。シャッター。
shuttle	定期往復便。シャトル。
Si	珪素の元素記号。
sickness	病気。吐き気。
side	側。面。側面。すぐそば。わき腹。
sieve	ふるい。ざる。こし器。
sigh	ため息。
sight	光景。眺め。視力。視覚。視界。見ること。
sightseeing	観光。見物。
sign	合図。標識。看板。しるし。記号。
signal	信号。信号機。シグナル。
signature	署名。サイン。
significance	意味。意義。趣旨。重要性。
silence	無言。沈黙。静かにすること。静けさ。静寂。
silhouette	シルエット。影絵。影法師。輪郭。
silicon	珪素。シリコン。
silk	絹。生糸。
silkworm	蚕（カイコ）。
silver	銀。シルバー。
similarity	類似。相似。(通例複数形で)類似点。
simplicity	簡単。単純。簡素。
sin	罪。罪悪。無作法。
sincerity	誠実さ。真実。真剣さ。
sine	サイン。正弦。
Singapore	シンガポール。
singer	歌う人。歌手。鳴き鳥。
singing	歌うこと。唱歌。鳴き声。
sink	(台所の)流し。下水溝。
sinker	おもり。シンカー。ドーナッツ。
sinking	沈没。低下。衰弱。
sir	男性に対する敬称または改まった呼び方。
siren	サイレン。
sister	姉。妹。女性会員。修道女。シスター。
site	用地。敷地。サイト。遺跡。
situation	状況。状態。立場。情勢。
six	六。六人。六個。六歳。六時。
sixteen	十六。十六人。十六個。十六歳。
sixth	第六。六番目。(月の)六日。(aかoneをつけて)六分の一。
sixty	六十。六十人。六十個。六十歳。
size	大きさ。サイズ。寸法。
skate	(複数形で)スケート靴。
skating	スケート。
skeleton	骨格。骸骨。骨組み。骨子。スケルトン。
sketch	写生画。スケッチ。草案。
ski	スキー。
skier	スキーヤー。スキーをする人。
skill	腕前。手腕。熟練。技能。
skin	皮膚。肌。皮。薄い膜。
skip	軽く跳ぶこと。スキップ。省略。
skirt	スカート。(衣服の)すそ。
skull	頭蓋骨。スカル。
sky	大空。上空。天。天国。
skyscraper	超高層ビル。摩天楼。
slack	ゆるみ。たるみ。
slam	荒っぽく閉めること。バタンという音。
slang	俗語。スラング。
slant	傾斜。勾配。坂。斜面。傾向。
slap	平手打ち。平手打ちのような音。
slash	深手。むち打ち。切り込み。スラッシュ。
slaughter	食肉解体。大量虐殺。
slave	奴隷。
slavery	奴隷の身分。奴隷制度。とりこ。骨折り仕事。
sleep	眠り。睡眠。
sleeve	(衣服の)そで。たもと。スリーブ。
slice	薄く切った一切れ。薄片。スライス。
slide	滑り台。滑走路。すべること。スライド。
slider	すべるもの。スライダー。
slip	すべること。すべって転ぶこと。過失。スリップ。
slipper	室内用の上履き。スリッパ。
slit	細長い切れ目。(スカートなどの)切り込み。
slogan	スローガン。標語。
slope	斜面。坂。スロープ。傾斜。
slot	細長い穴。スロット。
slug	ナメクジ。
slum	(theをつけて複数形で)スラム街。貧困地区。
slump	不調。スランプ。
smack	味。風味。香り。持ち味。一口。平手打ち。
smart	痛み。うずき。ずきずきする痛み。
smash	粉砕。砕ける音。一撃。衝突。破産。大当たり。スマッシュ。
smell	におい。香り。悪臭。嗅覚。
smile	微笑み。スマイル。
smog	スモッグ。煙霧。
smoke	煙。タバコを吸うこと。
smoking	喫煙。けむること。いぶること。
Sn	スズの元素記号。
snail	カタツムリ。
snake	ヘビ。
snap	パチンという音。スナップ写真。楽な仕事。ぱくっとかむこと。
snapshot	スナップ写真。
snask	軽食。スナック。
sneaker	スニーカー。こそこそする人。
sniff	鼻でくんくんかぐこと。
snore	いびき。いびきの音。
snort	鼻を鳴らすこと。シューと吹き出す音。
snow	雪。降雪。積雪。
snowball	雪玉。雪つぶて。スノーボール。
snowman	雪だるま。
soak	浸すこと。ずぶぬれ。浸透。大酒飲み。
soap	石鹸。シャボン。
sob	むせび泣き。すすり泣き。
soccer	サッカー。
socialism	社会主義。
socialist	社会主義者。
society	社会。世間。組合。団体。社交界。
sock	(ふつう複数形で)靴下。ソックス。
socket	ソケット。
soda	ソーダ。ソーダ水。
sofa	長いす。ソファー。
softball	ソフトボール。
soil	土壌。土。国土。地。
soldier	軍人。兵士。戦士。闘士。
sole	足底。靴底。底の部分。ソール。
solid	固体。固形物。立体。
solitude	孤独。
solo	独奏。独唱。ソロ。
some	いくつかのもの。数名の人。
somebody	誰か。ある人。
someone	誰か。ある人。
something	あるもの。何か。
son	息子。
sonata	ソナタ。奏鳴曲。
song	歌。唱歌。歌曲。声楽。歌唱。(鳥などの)鳴き声。
soprano	ソプラノ。最高音域。
sore	痛む所。傷。ただれ。腫れ物。
sorrow	悲しみ。
sort	種類。性格。品質。タイプの人。ソート。方法。並べ替え。
SOS	遭難信号。救援・救助を求めること。
soul	魂。精神。中心人物。人。
sound	音。物音。音響。音声。
soup	スープ。
source	水源。原因。情報源。ソース。
south	(theをつけて)南。南部。
southeast	南東。南東部。
southwest	南西。南西部。
sovereign	元首。君主。独立国。
Soviet	(ソ連の)会議。ソビエト。
sox	sockの複数形の一つ。
soy	しょうゆ。大豆。
soybean	大豆。
space	空間。宇宙。空き。スペース。
spacecraft	宇宙船。
spade	(農具の)すき。ふみくわ。スペード。
spaghetti	スパゲッティ。
Spain	スペイン。
span	スパン。(短い)時間。長さ。
Spaniard	スペイン人。
Spanish	スペイン語。
spanner	スパナ。
spare	予備のもの。スペア。
spark	火花。火の粉。活気。ひらめき。輝き。スパーク。
sparrow	スズメ。
speaker	話す人。語り手。拡声器。スピーカー。
speaking	話すこと。談話。演説。
spear	(武器の)やり。
special	特別のもの。特使。特派員。特別列車。号外。特製。
specialist	専門家。専門医。
specialty	特殊性。専攻。名産。特製品。
species	種。種類。
specimen	見本。実例。標本。試料。
speck	小さな点。しみ。細粒。
spectacle	壮観。見もの。(大規模な)見せ物。めがね。スペクタクル。
spectator	観客。見物人。目撃者。
spectrum	スペクトル。
speech	演説。談話。話。発言。言論。話す力。言語。話法。
speed	速度。速さ。スピード。
speedometer	速度計。
spelling	(語の)つづり。つづり方。スペル。
sphere	球。球体。天体。
spice	薬味。香辛料。スパイス。
spider	クモ。
spike	大釘。先のとがった金属。スパイク。
spill	こぼれること。流出。
spin	回転。解釈。下落。スピン。
spinach	ホウレンソウ。
spine	脊柱。背骨。(サボテンなどの)とげ。背。
spiral	らせん。らせん状のもの。巻き貝。
spirit	精神。心。霊的存在。気力。
spit	つば。つばを吐くこと。
splendor	豪華。華麗。壮観。輝き。
split	裂くこと。割ること。裂け目。割れ目。仲間割れ。
spoil	強奪品。略奪品。利権。賞品。掘り出し物。
sponge	スポンジ。海綿。
sponsor	広告主。スポンサー。保証人。名付け親。
spool	糸巻き。巻き枠。スプール。
spoon	さじ。スプーン。
sport	スポーツ。運動。協議。
sportsman	スポーツマン。
spot	斑点。ぶち。しみ。地点。スポット。
spotlight	スポットライト。世間の注目。照射灯。
spout	噴出口。噴出。どしゃ降り。
spray	しぶき。水しぶき。噴霧器。スプレー。
spread	広がること。広がり。スプレッド。
spring	春。ぜんまい。ばね。弾力。はねること。
sprinkle	振りまくこと。振り掛けること。小雨。
sprinkler	振り掛ける道具。スプリンクラー。じょうろ。散水車。
sprinter	短距離選手。スプリンター。
sprout	芽。新芽。若枝。
spur	拍車。はげまし。刺激。
spurt	ほとばしり。噴出。力走。スパート。急騰。急成長。
spy	スパイ。
square	正方形。四角。正方形のもの。広場。
squash	押しつぶすこと。ペシャとつぶれる音。窮屈。スカッシュ。
squeak	ネズミの鳴き声。
squeeze	絞ること。抱きしめること。引き締め。一しぼり。雑踏。
squirrel	リス。
SS	汽船。...号。steamshipの略。
stability	安定性。持続性。固定。
stable	馬小屋。牛舎。家畜小屋。
stack	(干し草などの)山。積み重ね。煙突。スタック。
stadium	屋外競技場。スタジアム。野球場。
staff	職員。社員。スタッフ。参謀。
stage	舞台。ステージ。演劇。舞台。段階。
stagger	よろめき。
stain	よごれ。しみ。汚点。ステイン。
stair	段。(複数形で)階段。
stalk	茎。主軸。細長い支え。(細い)脚。高い煙突。
stamp	スタンプ。判。印。郵便切手。印紙。
stance	立場。構え。スタンス。
stand	...台。...立て。屋台。売店。スタンド。
standard	標準。水準。旗。基本単位。本位。
standing	身分。地位。名声。持続。継続。
staple	とじ金。ステープル。Ｕ字型のくぎ。
stapler	ホチキス。紙とじ器。
star	星。恒星。星型のもの。スター。
starch	でんぷん。のり。堅苦しさ。活力。
stare	じっと見ること。凝視。
starfish	ヒトデ。
start	出発。開始。スタート。びっくりすること。
starter	スタート係。始動装置。スターター。出発する人。
state	状態。様子。国。州。地位。身分。
statement	陳述。声明。声明書。計算書。報告書。
statesman	(優れた)政治家。
station	駅。停車場。署。所。局。社会的地位。持ち場。
stationery	文房具。便せん。
statistics	統計学。統計。
statue	彫像。像。
status	地位。身分。高い地位。状態。情勢。
stay	滞在。滞在期間。
steady	決まったデートの相手。
steak	ステーキ。厚い切り身。
steal	盗み。盗品。儲け物。
steam	蒸気。スチーム。湯気。精力。
steamer	汽船。蒸し器。
steel	はがね。鋼鉄。鋼鉄製品。
steep	急斜面。
stem	幹。茎。柄。へた。船首。
step	歩み。一歩。足取り。足音。足跡。段。
stereo	ステレオ。立体音響。立体写真。
stew	シチュー。
stick	棒。こん棒。つえ。棒状のもの。
stimulus	刺激(するもの)。励み。刺激物。興奮剤。
stink	悪臭。
stir	軽い動き。かき混ぜること。(aをつけて)騒ぎ。
stitch	一針。一縫い。
stock	在庫品。貯蔵。株式。株。ストック。原料。
stocking	長靴下。ストッキング。
stomach	胃。腹。食欲。好み。
stone	石材。石。宝石。墓石。
stool	(ひじ掛け・背のない)腰掛け。スツール。踏み台。便器。
stoop	かがむこと。前傾。猫背。前かがみ。
stop	停止。休止。中止。停車。着陸。(バスの)停留所。
stopper	栓。止める人。ストッパー。
stopwatch	ストップウォッチ。
storage	貯蔵。保管。貯蔵所。倉庫。蓄電。
store	商店。店。蓄え。貯蔵。蓄積。倉庫。保管所。
stories	storyの複数形。
storm	嵐。暴風雨。猛攻撃。
story	物語。話。小説。
stout	スタウト。強い黒ビール。肥満した人。
stove	ストーブ。こんろ。レンジ。
strain	張り。曲げる力。変形。ひずみ。捻挫。緊張。
straits	海峡。苦境。
stranger	見知らぬ人。他人。(土地に)不案内な人。部外者。外国人。
strap	ひも。革ひも。つり革。ストラップ。
strategy	兵法。戦略。戦術。策略。
straw	わら。麦わら。ストロー。
strawberry	イチゴ。
stray	野良犬。野良猫。迷い出た家畜。
streak	筋。線。しま。稲妻。光線。傾向。
stream	流れ。小川。連続。
street	通り。街路。...街。ストリート。
strength	強さ。強度。
stress	強調。重点。圧迫。圧力。ストレス。強勢。アクセント。
stretch	伸び。広がり。ストレッチ。直線コース。乱用。こじつけ。
stretcher	担架。伸ばすもの。誇張。
stride	大また。一またぎ。いつもの調子。
strike	打つこと。攻撃。空爆。ストライク。ストライキ。大当たり。
string	糸。細ひも。threadより太い。一続き。弦。繊維。すじ。
stripe	縞（しま）。縞々の記章。種類。(複数形で)囚人服。トラ。
stroke	打つこと。一打ち。一撃。脳卒中。往復運動。ストローク。
structure	構造。構成。構造物。建築物。体系。
struggle	もがき。苦闘。奮闘。闘争。
stub	切り株。棒状のものの短い残り。控え。半券。
student	学生。生徒。研究生。学者。
studies	studyの複数形。
studio	仕事場。工房。放送室。録音室。撮影場。スタジオ。
study	勉強。研究。勉強部屋。書斎。研究室。
stuff	物。しろもの。物質。材料。原料。
stun	気絶させるもの。
style	様式。流儀。方法。文体。ぜいたく。
sub	代理人。代用品。補欠。予約申し込み。
subject	学科。主題。話題。題目。
submarine	潜水艦。
subscriber	購読者。応募者。加入者。寄付者。賛成者。記名者。
substance	物質。物。要旨。要点。実質。内容。実体。
substitute	代わりのもの。代理人。身代わり。補欠。
suburb	郊外。近郊。
subway	地下鉄。地下道。
success	成功。成功者。
succession	連続。継続。継承。
such	このようなこと。そのようなもの。
suck	吸うこと。一口。一なめ。
sufferer	苦しんでいる人。被害者。病人。
suffering	苦しみ。苦痛。
sugar	砂糖。糖。糖類。
suggestion	提案。提言。示唆。けはい。連想。
suicide	自殺。
suit	(服の)一そろい。...服。...着。スーツ。訴訟。願い。要請。
suitcase	スーツケース。
suite	一そろい。特別室。スイート。組曲。
sulfur	硫黄。
sum	合計。総計。総額。和。
summary	要約。概要。あらまし。まとめ。
summer	夏。夏季。
summit	頂上。頂点。最高首脳会談。サミット。
sun	太陽。日光。日なた。日曜日。
Sunday	日曜日。
sunflower	ヒマワリ。
sunlight	日光。
sunrise	日の出。
sunset	日の入り。日没。
sunshine	日光。日なた。
sunspot	太陽黒点。そばかす。
superior	上官。先輩。目上の人。
supermarket	スーパーマーケット。
superstar	スーパースター。
superstition	迷信。
supervisor	監督者。管理人。
supper	(昼にdinnerを食べた後の)夕食。夕食会。
supplement	補足。付録。補角。栄養補助食品。
supply	供給。補給。蓄え。用意。
support	支持。援助。サポート。支持者。
supporter	支持者。支え。サポーター。
surface	表面。外側。うわべ。外面。
surfboard	サーフボード。波乗り板。
surfing	サーフィン。波乗り。
surgeon	外科医。軍医。船医。
surgery	外科。手術。手術室。診療室。
surname	姓。苗字。
surprise	驚き。サプライズ。不意打ち。奇襲。
survey	調査。測量。概観。概説。
surveyor	測量士。監視者。検査官。
survival	生き残ること。生存。サバイバル。
survivor	生き残った人。生存者。
suspect	容疑者。
suspender	ズボンつり。靴下留め。つるすもの。
suspense	気がかり。懸念。はらはらすること。サスペンス。中断。
suspicion	疑い。容疑。疑念。
SW	南西。南西部。
swallow	ツバメ。飲み込むこと。一飲み。
swamp	沼地。沼。湿地。湿原。
swan	白鳥。
swap	交換。取替え。
swarm	ミツバチの群れ。群れ。大群。
sway	揺れること。動揺。影響力。
sweat	汗。水滴。露。
sweater	セーター。
Swede	スウェーデン人。
Sweden	スウェーデン。
Swedish	スウェーデン語。
sweep	掃除。一掃。押し寄せること。圧勝。一振り。
sweeper	掃除人。掃除機。
sweet	甘み。甘い物。スイーツ。恋人。
swell	増大。膨張。うねり。隆起。
swimmer	泳ぐ人。
swimming	泳ぐこと。水泳。めまい。
swing	ブランコ。振幅。振動。振ること。スイング。
Swiss	スイス人。
Switzerland	スイス。
sword	刀。剣。(theをつけて)武力。
syllable	音節。シラブル。
symbol	象徴。シンボル。記号。符号。
symmetry	対称。釣り合い。
sympathy	同情。思いやり。賛成。同調。共鳴。共振。交感。
symphony	交響曲。シンフォニー。
syrup	シロップ。
system	組織。体系。制度。方式。人体。システム。
table	テーブル。食卓。表。
tablecloth	テーブル掛け。テーブルクロス。
tablet	銘板。錠剤。板状のもの。タブレット。
taboo	タブー。禁忌。禁制。
tackle	タックル。釣り道具一式。巻き上げ装置。
tactics	戦術。戦法。作戦。
tadpole	オタマジャクシ。
tag	下げ札。荷札。タグ。
tail	尾。しっぽ。後部。末尾。
tailor	(紳士服を注文で作る)テーラー。洋服屋。
take	一回の捕獲量。売上高。取り分。一回で撮影する場面。
tale	話。物語。
talent	才能。手腕。腕前。タレント。芸能人。
talk	話。談話。おしゃべり。(短い)講演。
tan	日焼け。黄褐色。タン皮。
tangent	接線。タンジェント。正接。
tangle	もつれ。紛糾。けんか。
tank	タンク。戦車。
tanker	タンカー。
tap	軽く打つこと。タップ。栓。飲み口。蛇口。
tape	テープ。録音テープ。巻尺。
tar	タール。
target	的。標的。目標。ターゲット。
task	（一定期間内にやるべき）仕事。タスク。
taste	味。味覚。趣味。好み。鑑賞力。一口。
tattoo	入れ墨。タトゥー。
tax	税。税金。
taxi	タクシー。
taxpayer	納税者。
tea	茶。
teacher	先生。教師。教える人。
teaching	教え。教授。授業。
team	チーム。組。(一台の車を引く)牛馬の組。
teapot	ティーポット。茶びん。きゅうす。
tear	涙。裂け目。
tease	からかう人。からかうこと。
teaspoon	ティースプーン。茶さじ。
technician	技術者。テクニシャン。
technique	手法。技法。技術。テクニック。
technology	科学技術。専門語。応用科学。テクノロジー。
tee	(文字の)Ｔ。Ｔ型のもの。ティー。
teenager	十三歳から十九歳の子供。
teeth	toothの複数形。
telegram	電報。
telegraph	電報。...通信。電信機。
telephone	電話。電話機。
telescope	望遠鏡。
television	テレビ放送。テレビ。
teller	語り手。出納係。計算係。統計集計係。
temper	気分。機嫌。気性。
temperature	温度。気温。体温。発熱状態。
tempo	拍子。テンポ。
temptation	誘惑。
ten	十。十人。十個。十歳。十時。
tenant	借地人。借家人。居住者。住人。テナント。
tendency	傾向。気配。体質。素質。
tennis	テニス。庭球。
tenor	成年男子の最高音域。テナー。テノール。
tense	時制。
tension	張り。緊張。不安。張力。圧力。電圧。
tent	テント。
tenth	第十。十番目。(月の)十日。(aかoneをつけて)十分の一。
term	用語。語句。学期。期間。期限。契約条件。
terminal	末端。終着駅。端子。端末。ターミナル。
terrace	テラス。高台。台地。
territory	領土。領地。広大な土地。
terror	恐怖。恐ろしさ。恐ろしいもの。
test	試験。テスト。検査。
text	本文。テキスト。
textbook	教科書。
Thailand	タイ国。
thanks	感謝の言葉。感謝の気持ち。ありがとう。
that	あれ。それ。
thaw	解けること。雪解け。霜解け。解氷。
theater	劇場。映画館。
theme	主題。テーマ。話題。作文。
theorem	定理。
theory	理論。学説。憶測。
therapy	治療。療法。セラピー。
thermometer	温度計。体温計。
thermos	魔法びん。
these	これら。
they	彼ら（彼女ら）。
thief	泥棒。盗人。こそどろ。
thieves	thiefの複数形。
thigh	太もも。
thing	物事。
thinking	考えること。思考。考え方。考え。
third	第三。三番目。(月の)三日。(aかoneをつけて)三分の一。
thirst	(のどの)かわき。水分不足。渇望。
thirteen	十三。十三人。十三個。十三歳。
thirty	三十。三十人。三十個。三十歳。
this	これ。このもの。この人。
Thomas	トーマス。男子の名。
thorn	(植物の)とげ。針。とげのある植物。
those	あれら。それら。
thought	思考。考え。思いつき。思いやり。思想。
thousand	千。千人。千個。
thread	糸。細線。すじ。スレッド。
threat	脅し。脅迫。脅威。悪い前兆。
three	三。三人。三個。三歳。
threshold	敷居。入り口。門口。しきい値。
thrill	ぞくぞくさせるもの。スリル。
thriller	ぞくぞくさせるもの。スリラー物。
throne	王座。王位。
throng	群衆。人だかり。雑踏。大勢。
throw	投げること。投球。投げる距離。
thrust	押し。突き。推力。推進力。
thumb	親指。
thunder	雷。雷鳴。
Thur	木曜日。
Thursday	木曜日。
Tibet	チベット。
tick	時計などがカチカチいう音。ダニ。
ticket	切符。乗車券。入場券。チケット。
tickle	くすぐること。くすぐったさ。
ticktack	時計などがカチカチいう音。
tide	潮。潮流。流れ。形勢。
tie	結びひも。ネクタイ。同点。
tiger	トラ。
tile	タイル。屋根がわら。タイル状のもの。
timber	材木。森林。
time	時間。時刻。時。時期。期間。
tin	スズ。ブリキ。缶詰。
tip	先。先端。頂上。チップ。心づけ。祝儀。
tire	タイヤ。
tissue	ティッシュ。(生物の)組織。薄い織物。
title	題目。表題。タイトル。肩書き。選手権。
toast	トースト。乾杯。祝杯。
tobacco	刻みタバコ。喫煙。
toe	足の指。つま先。
toil	苦労。骨折り。
toilet	便器。化粧室。身じたく。
toll	使用料。運賃。通行料金。鐘を鳴らすこと。
tomato	トマト。
tomorrow	明日。
ton	重さの単位、トン。千キログラム。
tone	音調。音色。色合い。口調。トーン。体調。
tongue	舌。言語。言葉使い。舌肉。
tonight	今夜。今晩。
tool	道具。ツール。
tooth	歯。
toothache	歯痛。
toothbrush	歯ブラシ。
top	頂上。てっぺん。最上部。上部。トップ。(野球の)表。
topic	話題。トピック。
torch	たいまつ。トーチ。懐中電灯。
tornado	トルネード。大竜巻。
torrent	急流。激流。(複数形で)どしゃぶり。
tortoise	(陸上または淡水の)カメ。
torture	拷問。苦痛。
toss	ほうること。トス。(上下の)揺れ。(theをつけて)コイン投げ。
total	合計。総額。
touch	触れること。接触。手触り。感触。一筆。タッチ。
tour	小旅行。視察。見学。遠征。ツアー。
tourist	観光客。旅行者。
tournament	勝ち抜き大会。トーナメント。
towel	タオル。手ぬぐい。
tower	塔。タワー。
town	町。中心都市。都会。
toy	おもちゃ。
trace	跡。痕跡。足跡。微量。
track	通った跡。足跡。路線。進路。トラック。
tractor	トラクター。牽引車。
trade	商業。商売。商取引。貿易。トレード。
trademark	商標。トレードマーク。
trader	商人。貿易業者。貿易船。証券売買者。
tradition	伝説。言い伝え。伝統。
traffic	交通。往来。通行。運輸。トラフィック。
tragedy	悲劇。惨事。
trailer	トレーラー。後を追うもの。予告編。
train	列車。電車。汽車。
training	訓練。練習。トレーニング。調子。
tramp	放浪者。重い足音。徒歩。
trample	ドシンドシンと踏みつけること。
trampoline	トランポリン。
transistor	トランジスタ。
translation	翻訳。
translator	翻訳者。通訳。
transmission	伝達。送信。伝播。遺伝。トランスミッション。
transport	運送。輸送。運輸。
trap	わな。落とし穴。トラップ。
travel	旅行。
traveler	旅行者。旅人。旅客。
tray	盆。受け皿。
treasure	宝物。財宝。財産。貴重品。
treatment	取り扱い。待遇。治療。治療法。手当て。
treaty	条約。協定。条約文書。
tree	木。樹木。立ち木。
trek	(徒歩の難儀な)小旅行。
tremble	震え。震動。
trend	動向。傾向。流行。トレンド。方向。
trespass	不法侵入。邪魔。迷惑。
trial	裁判。試用。試運転。試み。
triangle	三角形。トライアングル。
tribe	部族。族。類。
trick	ごまかし。いたずら。手品。錯覚。トリック。
trigger	(鉄砲の)引き金。起爆装置。
trim	刈り込み。整頓。整理。装飾。
trip	旅行。
triple	三倍。三倍の数量。
triumph	大勝利。大成功。
troop	軍隊。警官隊。群れ。団。隊。兵士。
trophy	優勝記念品。トロフィー。
trot	早足。小走り。
trouble	困難。迷惑。紛争。もめごと。トラブル。
trousers	ズボン。
truck	貨物自動車。トラック。手押し車。
trumpet	トランペット。
trunk	(旅行用の)トランク。胴体。象の鼻。(複数形で)トランクス。
trust	信用。信頼。期待。
truth	真理。真実。
try	やってみること。試み。トライ。
tub	おけ。たらい。湯ぶね。小型容器。
tube	管。筒。チューブ。地下鉄。ブラウン管。
Tue	火曜日。
Tues	火曜日。
Tuesday	火曜日。
tulip	チューリップ。
tumble	転倒。転落。宙返り。混乱。乱雑。
tuna	マグロ。
tune	調べ。調子。同調。調和。
tuner	チューナー。同調器。(楽器の)調律師。
tunnel	トンネル。地下道。坑道。
turbine	タービン。
turbulence	乱気流。大荒れ。
Turk	トルコ人。
Turkey	トルコ。七面鳥。
Turkish	トルコ語。
turn	回すこと。方向転換。変化。番。ターン。
turtle	海ガメ。
TV	テレビ。
tweezers	毛抜き。ピンセット。
twelfth	第十二。十二番目。(aかoneをつけて)十二分の一。
twelve	十二。十二個。十二人。十二歳。
twenty	二十。二十個。二十人。二十歳。
twice	二度。二回。二倍。
twig	小枝。細枝。
twilight	薄明かり。たそがれ。夕暮れ時。
twin	双子（ふたご）の片方。(複数形で)双子。
twinkle	きらめき。輝き。ピカピカ。
twist	ねじれ。
two	二。二個。二人。二時。二歳。
type	型。様式。タイプ。典型。活字。
typewriter	タイプライター。
typhoon	台風。
tyranny	暴政。過酷。専制政治。
tyrant	暴君。専制君主。
UFO	未確認飛行物体。
UK	(theをつけて)英国。連合王国。
umbrella	傘。
umpire	審判員。アンパイア。仲裁人。
UN	国際連合。国連。
uncle	おじ。おじさん。
underground	地下。地下鉄。
underline	下線。アンダーライン。
understanding	理解。理解力。
underwear	肌着類。下着。
unemployment	失業。
UNESCO	ユネスコ。
UNICEF	ユニセフ。
uniform	制服。ユニフォーム。
union	連合。団結。組合。連邦。結婚。
unit	単位。設備一式。
universe	(theをつけて)宇宙。
university	大学。
unrest	不安。心配。動揺。
upset	転倒。転覆。転落。混乱。心の乱れ。不調。
upstairs	二階から上の階。上階。
uranium	ウラニウム。ウラン。
urine	尿。小便。
US	合衆国。
USA	アメリカ合衆国。
usage	使用法。取り扱い。
use	使用。使用方法。用途。役に立つこと。
USSR	ソビエト連邦。
Utopia	ユートピア。理想郷。
vacancy	空き。空っぽ。空室。空席。放心状態。
vacation	休暇。バケーション。
vaccine	ワクチン。
vaccum	真空。電気掃除機。空虚。
valley	谷。谷間。渓谷。流域。
valuable	(通例複数形で)貴重品。
value	価値。値打ち。価格。値段。数値。
valve	弁。バルブ。
vampire	吸血鬼。
van	大型貨物自動車。バン。
vanity	うぬぼれ。むなしさ。無益。空虚。
vapor	蒸気。水蒸気。湯気。もや。
variation	変化。変動。変化量。バリエーション。
variety	多様性。(さまざまな)種類。変種。バラエティー。
Vatican	(theをつけて)バチカン宮殿。ローマ教皇庁。
vector	ベクトル。方向量。
vegetable	野菜。植物。植物人間。
vehicle	乗り物。車。
veil	ベール。顔覆い。
vein	静脈。葉脈。鉱脈。水脈。気分。手法。
velocity	速度。速さ。
vent	通気孔。はけ口。発散。ベント。
venture	(危険な)冒険。投機。
Venus	ビーナス。金星。
verb	動詞。
verse	詩。詩歌。韻文。
version	翻訳。説明。版。バージョン。
vessel	血管。(植物の)導管。
vice	悪徳。不道徳。欠陥。悪い習慣。
victim	犠牲者。被害者。犠牲。いけにえ。
Victoria	ビクトリア。女子の名。
victory	勝利。
video	ビデオ。映像。テレビ。
videotape	ビデオテープ。
Vietnam	ベトナム。
Vietnamese	ベトナム人。ベトナム語。
view	見ること。眺め。見晴らし。考え。意見。視野。
viewer	観察者。見物人。視聴者。ビューアー。
village	(小さな)町。村。hamletより大きくtownより小さい。
villain	悪党。悪者。
vine	ブドウの木。
vinegar	食用酢。ビネガー。
violence	暴力。乱暴。暴行。
violet	スミレ。青紫色。
violin	バイオリン。
VIP	重要人物。要人。
virgin	処女。
virtue	徳。美徳。節操。美点。長所。効能。
virus	ウイルス。病原体。
vision	視覚。視力。想像力。先見の明。空想。
visit	訪問。訪れること。滞在。視察。
visitor	訪問者。来客。観光客。滞在客。視察者。
vitality	活力。体力。生命力。バイタリティー。
vitamin	ビタミン。
vocal	ボーカル。
vocalist	歌手。声楽家。ボーカリスト。
voice	声。音声。意見。
volcano	火山。
volleyball	バレーボール。
volt	電圧・電位差の単位ボルト。
volume	...巻。書物。本。体積。容積。音量。たくさん。
volunteer	志願者。志願兵。義勇兵。ボランティア。
vote	投票。投票権。
vow	誓い。誓約。
vowel	母音。
voyage	航海。船旅。空の旅。宇宙旅行。
waffle	ワッフル。
wage	賃金。
wagon	荷馬車。ワゴン。
wail	泣き叫び。泣き叫ぶ声。もの悲しい音。
waist	腰。腰部。胴部。ウエスト。
wait	待つこと。待ち時間。
waiter	ウエーター。給仕人。
waitress	ウエートレス。女の給仕人。
walk	歩くこと。散歩。散歩道。
wall	壁。塀。
wallet	紙入れ。札入れ。財布。
wallpaper	壁紙。
walnut	クルミ。
want	不足。欠乏。必要。貧困。
war	戦争。戦い。
ward	病棟。病室。(行政区画としての)区。被後見人。監房。
wardrobe	洋服だんす。衣装戸棚。衣装部屋。
warfare	交戦。交戦状態。
warmer	暖めるもの。加温器。
warmth	暖かさ。ぬくみ。温かさ。思いやり。熱心。熱情。
warning	警告。注意。警報。
warplane	軍用機。
warrant	令状。正当な理由。担保物件。保証。
warship	軍艦。
wartime	戦時。
wash	洗うこと。洗濯。洗浄。洗濯物。
washer	座金。ワッシャー。洗濯機。洗うもの。
Washington	アメリカの首都、ワシントン。
wasp	スズメバチ。ジガバチ。
waste	浪費。むだ使い。くず。廃棄物。荒れ地。
watch	見張り。警戒。監視。時計。見張り人。番人。
watchdog	番犬。
water	水。水位。水面。
watercolor	水彩絵の具。水彩画。
watermelon	スイカ。
watt	電力の単位、ワット。
wave	波。うねり。ウェーブ。波動。
wavelength	波長。
wax	ワックス。
way	道。道すじ。道のり。方法。習慣。
we	私たち。我々。
weakness	弱さ。虚弱。弱点。
wealth	富。財。財産。豊富な...。
weapon	武器。兵器。
wear	衣服。着用。消耗。耐久力。
weather	天気。天候。気象。
web	巣。網。
Wed	水曜日。
wedding	結婚式。婚礼。結婚記念日。
Wednesday	水曜日。
weed	雑草。不快なもの。弱弱しい人。タバコ。
week	週。一週間。七日間。
weekday	平日。週日。ウイークデー。
weekend	週末。
weight	重さ。重量。重み。
welcome	歓迎。
welfare	幸福。福祉。福利。
well	井戸。井。泉。
west	西。西部。
wet	湿気。湿り。雨降り。雨天。
whale	クジラ。
what	何。
wheat	小麦。
wheel	車輪。車。輪。舵輪。ハンドル。自転車。
where	どこ。
whip	むち。むち打ち。ホイップ。
whirl	旋回。渦巻き。ひとっ走り。めまい。
whisker	ほおひげ。ひげ。
whisky	ウイスキー。
whisle	口笛。汽笛。警笛。ホイッスル。
whisper	ささやき。サラサラいう音。うわさ。
white	白。白色。白衣。白人。
WHO	世界保健機関。
whole	全体。
wholesale	卸売り。
widow	未亡人。やもめ。
width	広さ。幅。横幅。
wife	妻。夫人。
wildlife	野生生物。
will	意思。決心。願い。意向。遺言。
William	ウィリアム。男子の名。
willow	ヤナギ。
win	勝利。成功。
wind	風。強風。暴風。息。呼吸。曲がり。うねり。ねじること。
windmill	風車。
window	窓。窓枠。窓ガラス。ウィンドウ。
wine	ブドウ酒。
wing	翼。羽。
wink	まばたき。ウィンク。
winner	勝者。優勝者。受賞者。入賞者。
winter	冬。
wipe	ふくこと。ぬぐうこと。
wiper	ぬぐうもの。ワイパー。
wire	針金。電線。電報。
wisdom	賢明さ。英知。見識。学識。
wish	願い。望み。望みの物。願い事。好意。
wit	機知。とんち。ウィット。
witch	魔女。(女の)魔法使い。
witness	目撃者。立会人。証拠物件。証拠。証言。
wives	wifeの複数形。
wizard	(男の)魔法使い。
wolf	オオカミ。
wolves	wolfの複数形。
woman	(成人した)女。女性。夫人。
women	womanの複数形。
won	韓国の貨幣単位、ウォン。
wonder	不思議なもの。驚嘆。奇跡。驚き。
wood	森。木材。
woodland	森林地。
wool	羊毛。毛糸。毛織物。
word	語。単語。言葉。約束。
work	仕事。作業。労働。勉強。勤め先。作品。
worker	働く人。労働者。勉強する人。
workshop	作業場。工場。研究会。
world	世界。世の中。
worm	(やわらかい)虫。
worry	心配。不安。心配事。悩みの種。
worship	崇拝。尊敬。礼拝。
worth	価値。値打ち。
wound	傷。負傷。けが。
wrap	ラップ。包むもの。(複数形で)秘密。
wreck	破損。難破。海難。難破船。残骸。
wrestler	レスラー。
wrestling	レスリング。
wrinkle	しわ。ひだ。
wrist	手首。
writer	書く人。筆者。著者。作家。
writing	書くこと。執筆。筆跡。著作。
wrong	悪。不当。不正行為。悪事。
Xe	キセノンの元素記号。
xerox	複写機。ゼロックス。
Xmas	クリスマス。
yacht	ヨット。
Yankee	ヤンキー。
yard	庭。中庭。構内。ヤード。
yawn	あくび。
yd	ヤード。
year	年。一年。学年。(複数形で)年齢。
yell	金切り声。わめき。(応援の)エール。
yellow	黄。黄色。
yen	日本の貨幣の単位、円。
yesterday	昨日。
yield	産出。収穫。収益。利回り。イールド。
you	あなた。
youth	若さ。青年時代。青春。若者。
zeal	熱心。
zebra	シマウマ。
zero	ゼロ。零。
zinc	亜鉛。
zip	チャック。元気。ゼロ点。郵便番号。ピュッという音。
zipper	チャック。
Zn	亜鉛の元素記号。
zone	地帯。地域。ゾーン。
zoo	動物園。
zzz	グーグー。いびきの音。
