# 「★二重マス用四字熟語カナ辞書.tsv」第一版　片山博文MZ
# This file is public domain software.
アクセンクトウ	悪戦苦闘
アンチュウモサク	暗中模索
イキトウゴウ	意気投合
イクドウオン	異口同音
イシンデンシン	以心伝心
イチイセンシン	一意専心
イチゴイチエ	一期一会
イチジツセンシュウ	一日千秋
イチネンホッキ	一念発起
イチブシジュウ	一部始終
イチモウダジン	一網打尽
イッキイチユウ	一喜一憂
イッキトウセン	一騎当千
イッキョイチドウ	一挙一動
イッキョリョウトク	一挙両得
イッコクセンキン	一刻千金
イッショクソクハツ	一触即発
イッシンドウタイ	一心同体
イッシンフラン	一心不乱
イッセイチダイ	一世一代
イッセキニチョウ	一石二鳥
イッチョウイッセキ	一朝一夕
イッチョウイッタン	一長一短
イットウリョウダン	一刀両断
イミシンチョウ	意味深長
インガオウホウ	因果応報
ウオウサオウ	右往左往
オカメハチモク	傍目八目
オンコチシン	温故知新
アッコウゾウゴン	悪口雑言
イキショウチン	意気消沈
イキヨウヨウ	意気揚揚
イチイタイスイ	一衣帯水
イチゲンコジ	一言居士
イチゴンハンク	一言半句
イチジセンキン	一字千金
イチボウセンリ	一望千里
イチモクリョウゼン	一目瞭然
イチモンイットウ	一問一答
イチリイチガイ	一利一害
イッカクセンキン	一攫千金
イッサイガッサイ	一切合切
イッショケンメイ	一所懸命
イッチハンカイ	一知半解
イットクイッシツ	一得一失
イフウドウドウ	威風堂々
ウゾウムゾウ	有象無象
ウミセンヤマセン	海千山千
ウヨキョクセツ	紆余曲折
ウンサンムショウ	雲散霧消
エイコセイスイ	栄枯盛衰
カチョウフウゲツ	花鳥風月
ガデンインスイ	我田引水
ガリョウテンセイ	画竜点睛
カンゼンムケツ	完全無欠
キキイッパツ	危機一髪
キシカイセイ	起死回生
キショウテンケツ	起承転結
ギシンアンキ	疑心暗鬼
キソウテンガイ	奇想天外
キドアイラク	喜怒哀楽
ギュウインバショク	牛飲馬食
キュウテンチョッカ	急転直下
ギョクセキコンコウ	玉石混淆
クウゼンゼツゴ	空前絶後
コウゲンレイショク	巧言令色
コウヘイムシ	公平無私
コウメイセイダイ	公明正大
ゴエツドウシュウ	呉越同舟
ゴリムチュウ	五里霧中
ゴンゴドウダン	言語道断
ガシンショウタン	臥薪嘗胆
カロトウセン	夏炉冬扇
カンガイムリョウ	感慨無量
カンキュウジザイ	緩急自在
カンゼンチョウアク	勧善懲悪
キショクマンメン	喜色満面
キョウソンキョウエイ	共存共栄
キョウミシンシン	興味津津
キンカギョクジョウ	金科玉条
クシンサンタン	苦心惨憺
ゲンコウイッチ	言行一致
ケンドジュウライ	捲土重来
コウガンムチ	厚顔無恥
コウダイムヘン	広大無辺
コグンフントウ	孤軍奮闘
ココントウザイ	古今東西
コシタンタン	虎視眈眈
ゴゾウロップ	五臓六腑
コハルビヨリ	小春日和
ゴフウジュウウ	五風十雨
ゴブゴブ	五分五分
コリツムエン	孤立無援
サンカンシオン	三寒四温
ジガジサン	自画自賛
ジキュウジソク	自給自足
シクハック	四苦八苦
シコウサクゴ	試行錯誤
ジゴウジトク	自業自得
シチテンバットウ	七転八倒
シメンソカ	四面楚歌
ジャクニクキョウショク	弱肉強食
シュウシイッカン	終始一貫
ジユウジザイ	自由自在
ジュウニントイロ	十人十色
シュシャセンタク	取捨選択
ジュンプウマンパン	順風満帆
シヨウマッセツ	枝葉末節
シンキイッテン	心機一転
シンショウボウダイ	針小棒大
シンラバンショウ	森羅万象
セイコウウドク	晴耕雨読
セイテンハクジツ	青天白日
ゼッタイゼツメイ	絶体絶命
センザイイチグウ	千載一遇
センサバンベツ	千差万別
ゼンダイミモン	前代未聞
サイサンサイシ	再三再四
サイショクケンビ	才色兼備
サンパイキュウハイ	三拝九拝
シチテンハッキ	七転八起
シツジツゴウケン	質実剛健
ジモンジトウ	自問自答
ジュウオウムジン	縦横無尽
シュカクテントウ	主客転倒
ショウジャヒッスイ	盛者必衰
ショウシンショウメイ	正真正銘
シリメツレツ	支離滅裂
シンシュツキボツ	神出鬼没
シンボウエンリョ	深謀遠慮
セイシンセイイ	誠心誠意
セイセイドウドウ	正々堂々
セッサタクマ	切磋琢磨
センキャクバンライ	千客万来
ゼンゴフカク	前後不覚
ゼンジンミトウ	前人未到
ゼントヨウヨウ	前途洋々
センペンバンカ	千変万化
タイキバンセイ	大器晩成
ダイタンフテキ	大胆不敵
ダイドウショウイ	大同小異
タントウチョクニュウ	単刀直入
チョウレイボカイ	朝令暮改
テキザイテキショ	適材適所
デンコウセッカ	電光石火
テンペンチイ	天変地異
トウホンセイソウ	東奔西走
ドクリツドッポ	独立独歩
タイガンジョウジュ	大願成就
タイキショウヨウ	大器小用
タイギメイブン	大義名分
タイゲンソウゴ	大言壮語
タイゼンジジャク	泰然自若
タジタナン	多事多難
タシュタヨウ	多種多様
チュウヤケンコウ	昼夜兼行
チョウサンボシ	朝三暮四
チョトツモウシン	猪突猛進
チンシモッコウ	沈思黙考
ツツウラウラ	津津浦浦
テットウテツビ	徹頭徹尾
テマエガッテ	手前勝手
テンイムホウ	天衣無縫
テンカムソウ	天下無双
テンシンランマン	天真爛漫
ドウコウイキョク	同工異曲
ドウショウイム	同床異夢
トクイマンメン	得意満面
ドクダンセンコウ	独断専行
ニソクサンモン	二束三文
ニッシンゲッポ	日進月歩
バジトウフウ	馬耳東風
ハッポウビジン	八方美人
ハランバンジョウ	波瀾万丈
ハンシンハンギ	半信半疑
ヒャッパツヒャクチュウ	百発百中
フゲンジッコウ	不言実行
フミンフキュウ	不眠不休
フワライドウ	付和雷同
ヘイシンテイトウ	平身低頭
ボウジャクブジン	傍若無人
ナイユウガイカン	内憂外患
ナンギョウクギョウ	難行苦行
ナンセンホクバ	南船北馬
ニシャタクイツ	二者択一
ハガンイッショウ	破顔一笑
ハクシャセイショウ	白砂青松
ハンシハンジョウ	半死半生
ヒャクセンレンマ	百戦錬磨
ヒャッカリョウラン	百花繚乱
ヒョウリイッタイ	表裏一体
ヒロウコンパイ	疲労困憊
ヒンコウホウセイ	品行方正
フウコウメイビ	風光明媚
フソクフリ	不即不離
フロウフシ	不老不死
フンコツサイシン	粉骨砕身
ヘイオンブジ	平穏無事
ヘンゲンジザイ	変幻自在
ボウインボウショク	暴飲暴食
ホウフクゼットウ	抱腹絶倒
ホンマツテントウ	本末転倒
ムガムチュウ	無我夢中
ユウジュウフダン	優柔不断
ユウメイムジツ	有名無実
ユダンタイテキ	油断大敵
ヨウイシュウトウ	用意周到
リュウトウダビ	竜頭蛇尾
リンキオウヘン	臨機応変
ロウニャクナンニョ	老若男女
マンジョウイッチ	満場一致
マンシンソウイ	満身創痍
ムイムサク	無為無策
ムビョウソクサイ	無病息災
ムミカンソウ	無味乾燥
メイキョウシスイ	明鏡止水
メイメイハクハク	明々白々
メイヨバンカイ	名誉挽回
メンボクヤクジョ	面目躍如
モンガイフシュツ	門外不出
ユイガドクソン	唯我独尊
ユウショウレッパイ	優勝劣敗
ユウモウカカン	勇猛果敢
ユウユウジテキ	悠々自適
ヨウトウクニク	羊頭狗肉
リガイトクシツ	利害得失
リゴウシュウサン	離合集散
リッシンシュッセ	立身出世
リュウリュウシンク	粒々辛苦
リロセイゼン	理路整然
ワキアイアイ	和気藹々
