# FILENAME: BasicDict-JPN-Kanji-Freedom.tsv
# NAME-ENG: Basic Japanese Kanji Freedom Dictionary, 10th Edition
# NAME-JPN: 基本辞書データ（漢字、自由）第十版
# COPYRIGHT: (C) 2013-2022 katahiromz.
# LICENSE: MIT
# NOTE: ABSOLUTELY NO WARRANTY.
# DATE: 2022-03-08
一万円札	いちまんえんさつ。
一世一代	いっせいちだい。
一丸	いちがん。
一人前	いちにんまえ。
一人旅	ひとりたび。
一件落着	いっけんらくちゃく。
一任	いちにん。
一体感	いったいかん。
一例	いちれい。
一億	いちおく。
一兆	いっちょう。
一光年	いっこうねん。
一円玉	いちまんえんだま。
一刀両断	いっとうりょうだん。
一切	いっさい。
一刻千金	いっこくせんきん。
一割	いちわり。
一向	いっこう。
一周	いっしゅう。
一味	いちみ。
一回転	いっかいてん。
一国一城	いっこくいちじょう。
一国二制度	いっこくにせいど。
一場面	いちばめん。
一塁	いちるい。
一変	いっぺん。
一夜	いちや。
一大事	いちだいじ。
一姫二太郎	いちひめにたろう。
一字一句	いちじいっく。
一存	いちぞん。
一学期	いちがっき。
一安心	ひとあんしん。
一家	いっか。
一家心中	いっかしんじゅう。
一帯	いったい。
一年契約	いちねんけいやく。
一年生	いちねんせい。
一心不乱	いっしんふらん。
一心同体	いっしんどうたい。
一応	いちおう。
一念発起	いちねんほっき。
一方通行	いっぽうつうこう。
一日	いちにち。
一日千秋	いちじつせんしゅう
一昔	ひとむかし。
一月	いちがつ。
一服	いっぷく。
一朝一夕	いっちょういっせき
一期一会	いちごいちえ。
一杯	いっぱい。
一枚岩	いちまいいわ。
一様	いちよう。
一次方程式	いちじほうていしき。
一歩前進	いっぽぜんしん。
一流	いちりゅう。
一生	いっしょう。
一番	いちばん。
一番星	いちばんぼし。
一目	ひとめ。
一目散	いちもくさん
一直線	いっちょくせん。
一瞬	いっしゅん。
一石二鳥	いっせきにちょう。
一神教	いっしんきょう
一等	いっとう。
一等賞	いっとうしょう。
一糸	いっし。
一網打尽	いちもうだじん。
一緒	いっしょ。
一群	いちぐん。
一致	いっち。
一般人	いっぱんじん。
一般会計	いっぱんかいけい。
一般会計補正予算	いっぱんかいけいほせいよさん。
一般常識	いっぱんじょうしき。
一般教書演説	いっぱんきょうしょえんぜつ。
一般競争入札	いっぱんきょうそうにゅうさつ。
一般職	いっぱんしょく。
一般討論	いっぱんとうろん。
一般質問	いっぱんしつもん。
一般道路	いっぱんどうろ。
一見	いっけん。
一触即発	いっしょくそくはつ。
一身上	いっしんじょう。
一輪	いちりん。
一輪車	いちりんしゃ。
一週間	いっしゅうかん。
一進一退	いっしんいったい。
一部	いちぶ。
一部始終	いちぶしじゅう。
一酸化炭素	いっさんかたんそ。
一長一短	いっちょういったん。
七五三	しちごさん。
七味唐辛子	しちみとうがらし
七夕	たなばた。
七夕祭	たなばたまつり。
七日	なのか。
七月	しちがつ。
七福神	しちふくじん。
七草	ななくさ。
七転八倒	しちてんばっとう
七面鳥	しちめんちょう。
万一	まんいち。
万事	ばんじ。
万人	ばんにん
万全	ばんぜん。
万国	ばんこく。
万年筆	まんねんひつ。
万有引力	ばんゆういんりょく。
万歩計	まんぽけい。
万物	ばんぶつ。
万病	まんびょう。
万能	ばんのう。
丈夫	じょうぶ。
三倍速	さんばいそく。
三原色	さんげんしょく。
三味線	しゃみせん。
三塁	さんるい。
三大文明	さんだいぶんめい。
三女	さんじょ
三学期	さんがっき。
三寒四温	さんかんしおん。
三年生	さんねんせい。
三年間	さんねんかん。
三拍子	さんびょうし。
三振	さんしん。
三日	みっか。
三日月	みかずき。
三月	さんがつ。
三権分立	さんけんぶんりつ。
三次元	さんじげん。
三男	さんなん。
三等分	さんとうぶん。
三角	さんかく。
三角定規	さんかくじょうぎ。
三角州	さんかくす。
三角形	さんかくけい。
三角柱	さんかくちゅう。
三輪車	さんりんしゃ。
三連休	さんれんきゅう。
三重	さんじゅう。
三重県	みえけん。
三階	さんかい。
三面記事	さんめんきじ。
三面鏡	さんめんきょう。
上下	じょうげ。
上下対称	じょうげたいしょう。
上下関係	じょうげかんけい。
上京	じょうきょう。
上半期	かみはんき。
上半身	じょうはんしん。
上司	じょうし。
上品	じょうひん。
上場企業	じょうじょうきぎょう。
上意下達	じょういかたつ。
上手	じょうず。
上方修正	じょうほうしゅうせい。
上昇	じょうしょう。
上昇気流	じょうしょうきりゅう。
上映	じょうえい。
上機嫌	じょうきげん。
上水道	じょうすいどう。
上流	じょうりゅう。
上流階級	じょうりゅうかいきゅう。
上演	じょうえん。
上着	うわぎ。
上空	じょうくう。
上等	じょうとう。
上級	じょうきゅう。
上級生	じょうきゅうせい。
上記	じょうき。
上質	じょじゅしつ。
上辺	うわべ。
上達	じょうたつ。
上陸	じょうりく。
下剤	げざい。
下半期	しもはんき。
下半身	かはんしん。
下品	げひん。
下宿	げしゅく。
下山	げざん。
下心	したごころ。
下手	へた。
下方修正	かほうしゅうせい。
下校	げこう。
下水	げすい。
下水道	げすいどう。
下流	かりゅう。
下準備	したじゅんび。
下火	したび。
下着	したぎ。
下級生	かきゅうせい。
下絵	したえ。
下線	かせん。
下見	したみ。
下調	したしらべ。
下車	げしゃ。
下降	かこう。
下駄	げた。
不作	ふさく。
不便	ふべん。
不信感	ふしんかん。
不健全	ふけんぜん。
不健康	ふけんこう。
不備	ふび。
不具合	ふぐあい。
不利	ふり。
不利益	ふりえき。
不動産	ふどうさん。
不動産事業	ふどうさんじぎょう。
不動産会社	ふどうさんがいしゃ。
不動産投資	ふどうさんとうし。
不動産株	ふどうさんかぶ。
不動産業	ふどうさんぎょう。
不動産業者	ふどうさんぎょうしゃ。
不十分	ふじゅうぶん。
不参加	ふさんか。
不可抗力	ふかこうりょく。
不可欠	ふかけつ。
不可能	ふかのう。
不可解	ふかかい。
不可逆	ふかぎゃく。
不合格	ふごうかく。
不器用	ぶきよう。
不在	ふざい。
不始末	ふしまつ。
不安	ふあん。
不完全	ふかんぜん。
不完全燃焼	ふかんぜんねんしょう。
不定	ふてい。
不審	ふしん。
不導体	ふどうたい。
不平	ふへい。
不平不満	ふへいふまん。
不平等	ふびょうどう。
不幸	ふこう。
不必要	ふひつよう。
不快	ふかい。
不快指数	ふかいしすう。
不思議	ふしぎ。
不成立	ふせいりつ。
不戦勝	ふせんしょう。
不手際	ふてぎわ。
不振	ふしん。
不採用	ふさいよう。
不支持率	ふしじりつ。
不明	ふめい。
不景気	ふけいき。
不条理	ふじょうり。
不機嫌	ふきげん。
不正	ふせい。
不正受給	ふせいじゅきゅう。
不正確	ふせいかく。
不正競争防止法	ふせいきょうそうぼうしほう。
不正解	ふせいかい。
不正請求	ふせいせいきゅう。
不正防止	ふせいぼうし。
不死身	ふじみ。
不毛	ふもう。
不気味	ぶきみ。
不況	ふきょう。
不注意	ふちゅうい。
不測	ふそく。
不満	ふまん。
不潔	ふけつ。
不燃性	ふねんせい。
不用品	ふようひん。
不用意	ふようい。
不登校	ふとうこう。
不登校児童	ふとうこうじどう。
不眠症	ふみんしょう。
不確定	ふかくてい。
不細工	ぶさいく。
不経済	ふけいざい。
不老不死	ふろうふし。
不自然	ふしぜん。
不自由	ふじゆう。
不良	ふりょう。
不良品	ふりょうひん。
不要	ふよう。
不規則	ふきそく。
不親切	ふしんせつ。
不言実行	ふげんじっこう。
不誠実	ふせいじつ。
不調	ふちょう。
不買運動	ふばいうんどう。
不起訴処分	ふきそしょぶん。
不足	ふそく。
不足気味	ふそくぎみ。
不透明感	ふとうめいかん。
不通	ふつう。
不運	ふうん。
不適切	ふてきせつ。
不都合	ふつごう。
与党	よとう。
与野党	よやとう。
世代	せだい。
世代交代	せだいこうたい。
世帯	せたい。
世帯収入	せたいしゅうにゅう。
世界	せかい。
世界一	せかいいち。
世界一周	せかいいっしゅう。
世界共通	せかいきょうつう。
世界史	せかいし。
世界同時株安	せかいどうじかぶやす。
世界地図	せかいちず。
世界市場	せかいしじょう。
世界平和	せかいへいわ。
世界情勢	せかいじょうせい。
世界新記録	せかいしんきろく。
世界最大	せかいさいだい。
世界有数	せかいゆうすう。
世界経済	せかいけいざい。
世界経済危機	せかいけいざいきき。
世界規模	せかいきぼ。
世界記録	せかいきろく。
世界選手権	せかいせんしゅけん。
世界遺産	せかいいさん。
世相	せそう。
世紀	せいき。
世紀末	せいきまつ。
世話	せわ。
世論	よろん。
世論調査	よろんちょうさ。
世辞	せじ。
世間	せけん。
世間体	せけんてい。
世間話	せけんばなし。
両側	りょうがわ。
両岸	りょうぎし。
両成敗	りょうせいばい。
両手	りょうて。
両方	りょうほう。
両替	ろうがえ。
両替機	りょうがえき。
両生類	りょうせいるい。
両目	りょうめ。
両立	りょうりつ。
両者	りょうしゃ。
両親	りょうしん。
両足	りょうあし。
両面印刷	りょうめんいんさつ。
中世	ちゅうせい。
中傷	ちゅうしょう。
中南米	ちゅうなんべい。
中古品	ちゅうこひん。
中古車	ちゅうこしゃ。
中和	ちゅうわ。
中国	ちゅうごく。
中国人	ちゅうごくじん。
中国人旅行客	ちゅうごくじんりょこうきゃく。
中国人民元	ちゅうごくじんみんげん。
中国人民解放軍	ちゅうごくじんみんかいほうぐん。
中国人民銀行	ちゅうごくじんみんぎんこう。
中国人観光客	ちゅうごくじんかんこうきゃく。
中国企業	ちゅうごくきぎょう。
中国共産党	ちゅうごくきょうさんとう。
中国地方	ちゅうごくちほう。
中国政府	ちゅうごくせいふ。
中国経済	ちゅうごくけいざい。
中国製	ちゅうごくせい。
中国語	ちゅうごくご。
中央	ちゅうおう。
中央分離帯	ちゅうおうぶんりたい。
中央政府	ちゅうおうせいふ。
中央線	ちゅうおうせん。
中学受験	ちゅうがくじゅけん。
中学校	ちゅうがっこう。
中学生	ちゅうがくせい。
中小企業	ちゅうしょうきぎょう。
中年	ちゅうねん。
中庭	なかにわ。
中心	ちゅうしん。
中心地	ちゅうしんち。
中心市街地	ちゅうおうしがいち。
中心的存在	ちゅうしんてきそんざい。
中性	ちゅうせい。
中指	なかゆび。
中断	ちゅうだん。
中東	ちゅうとう。
中東地域	ちゅうとうちいき。
中東情勢	ちゅうとうじょうせい。
中止	ちゅうし。
中毒	ちゅうどく。
中毒死	ちゅうどくし。
中空	ちゅうくう。
中立	ちゅうりつ。
中立公正	ちゅうりつこうへい。
中立国	ちゅうりつこく。
中絶	ちゅうぜつ。
中継	ちゅうけい。
中華	ちゅうか。
中華人民共和国	ちゅうかじんみんきょうわこく。
中華思想	ちゅうかしそう。
中華料理	ちゅうかりょうり。
中距離	ちゅうきょり。
中途採用	ちゅうとさいよう。
中途採用者	ちゅうとさいようしゃ。
中部	ちゅうぶ。
中部地方	ちゅうぶちほう。
中間	ちゅうかん。
中間報告	ちゅうかんほうこく。
中間層	ちゅうかんそう。
中間所得層	ちゅうかんしょとくそう。
中間決算	ちゅうかんけっさん。
中間管理職	ちゅうかんかんりしょく。
中間貯蔵施設	ちゅうかんちょぞうしせつ。
中間選挙	ちゅうかんせんきょ。
丸太	まるた。
丸顔	まるがお。
主人	しゅじん。
主人公	しゅじんこう。
主力	しゅりょく。
主力産業	しゅりょくさんぎょう。
主婦	しゅふ。
主将	しゅしょう。
主導権	しゅどうけん。
主張	しゅちょう。
主役	しゅやく。
主従	しゅじゅう。
主権侵害	しゅけんしんがい。
主流	しゅりゅう。
主演	しゅえん。
主犯	しゅはん。
主義	しゅぎ。
主要	しゅよう。
主要通貨	しゅようつうか。
主要都市	しゅようとし。
主観的	しゅかんてき。
主語	しゅご。
主題	しゅだい。
主食	しゅしょく。
乗務員	じょうむいん。
乗客	じょうきゃく。
乗用車	じょうようしゃ。
乗車	じょうしゃ。
乗車券	じょうしゃけん。
乗車口	じょうしゃぐち。
乗車駅	じょうしゃえき。
乗馬	じょうば。
九州	きゅうしゅう。
九州地方	きゅうしゅうちほう。
九州場所	きゅうしゅうばしょ。
九日	ここのか。
九月	くがつ。
乱入	らんにゅう。
乱反射	らんはんしゃ。
乱射	らんしゃ。
乱暴	らんぼう。
乱暴者	らんぼうもの。
乱発	らんぱつ。
乱立	らんりつ。
乱視	らんし。
乱雑	らんざつ。
乳児	にゅうじ。
乳化剤	にゅうかざい。
乳房	にゅうぼう。
乳歯	にゅうし。
乳母	うば。
乳母車	うばぐるま。
乳液	にゅうえき。
乳牛	にゅうぎゅう。
乳製品	にゅうせいひん。
乳首	ちくび。
乾杯	かんぱい。
乾燥	かんそう。
乾燥機	かんそうき。
乾物	かんぶつ。
乾電池	かんでんち。
了解	りょうかい。
予備	よび。
予告	よこく。
予報	よほう。
予定	よてい。
予定地	よていち。
予定日	よていび。
予定表	よていひょう。
予想	よそう。
予想外	よそうがい。
予想金額	よそうきんがく。
予感	よかん。
予断	よだん。
予測	よそく。
予知能力	よちのうりょく。
予算	よさん。
予算委員会	よさんいいんかい。
予算成立	よさんせいりつ。
予算案	よさんあん。
予算編成	よさんへんせい。
予算規模	よさんきぼ。
予算配分	よさんはいぶん。
予約	よやく。
予習	よしゅう。
予行	よこう。
予言	よげん。
予選	よせん。
予防	よぼう。
予防医学	よぼういがく。
予防接種	よぼうせっしゅ。
事件	じけん。
事件簿	じけんぼ。
事例	じれい。
事前	じぜん。
事務	じむ。
事務処理	じむしょり。
事務効率化	じむこうりつか。
事務所	じむしょ。
事務用品	じむようひん。
事務職	じむしょく。
事実	じじつ。
事実誤認	じじつごにん。
事情	じじょう。
事態収束	じたいしゅうしゅう。
事故	じこ。
事故死	じこし。
事故物件	じこぶっけん。
事業	じぎょう。
事業拡大	じぎょうかくだい。
事業者	じぎょうしゃ。
事業計画	じぎょうけいかく。
二世帯住宅	にせたいじゅうたく。
二刀流	にとうりゅう。
二十一世紀	にじゅういっせいき。
二十世紀	にじっせいき。
二十四節気	にじゅうしせっき。
二十日	はつか。
二塁	にるい。
二大政党制	にだいせいとうせい。
二学期	にがっき。
二年生	にねんせい。
二日	ふつか。
二月	にがつ。
二枚目	にまいめ。
二次創作物	にじそうさくぶつ。
二次災害	にじさいがい。
二等分	にとうぶん。
二等分線	にとうぶんせん。
二等辺三角形	にとうへんさんかくけい。
二者択一	にしゃたくいつ。
二足歩行	にそくほこう。
二酸化炭素	にさんかたんそ。
二酸化炭素排出量	にさんかたんそはいしゅつりょう。
二重	にじゅう。
二重人格	にじゅうじんかく。
二階	にかい。
互角	ごかく。
五人組	ごにんぐみ。
五体満足	ごたいまんぞく。
五兆円	ごちょうえん。
五分五分	ごぶごぶ。
五十歩百歩	ごじっぽひゃっぽ。
五十音順	ごじゅうおんじゅん。
五千円札	ごせんえんさつ。
五年生	ごねんせい。
五感	ごかん。
五日	いつか。
五月	ごがつ。
五月雨	さみだれ。
五角形	ごかくけい。
五輪	ごりん。
井戸	いど。
井戸水	いどみず。
井戸端	いどばた。
井戸端会議	いどばたかいぎ。
亜熱帯	あねったい。
亜熱帯気候	あねったいきこう。
亜鉛	あえん。
亡命	ぼうめい。
亡国	ぼうこく。
亡者	もうじゃ。
交互	こうご。
交付	こうふ。
交付金	こうふきん。
交代	こうたい。
交友関係	こうゆうかんけい。
交差	こうさ。
交差点	こうさてん。
交換	こうかん。
交換日記	こうかんにっき。
交流	こうりゅう。
交流戦	こうりゅうせん。
交渉	こうしょう。
交点	こうてん。
交通	こうつう。
交通事故	こうつうじこ。
交通事故死	こうつうじこし。
交通弱者	こうつうじゃくしゃ。
交通手段	こうつうしゅだん。
交通整理	こうつうせいり。
交通機関	こうつうきかん。
交通渋滞	こうつうじゅうたい。
交通規則	こうつうきそく。
交通違反	こうつういはん。
交際	こうさい。
交際宣言	こうさいせんげん。
京大	きょうだい。
京都府	きょうとふ。
京都議定書	きょうとぎていしょ。
人一倍	ひといちばい。
人事	じんじ。
人事制度	じんじせいど。
人事異動	じんじいどう。
人件費	じんけんひ。
人体	じんたい。
人出	ひとで。
人前	ひとまえ。
人力車	じんりきしゃ。
人口	じんこう。
人口増加	じんこうぞうか。
人口密度	じんこうみつど。
人口密集地域	じんこうみっしゅうちいき。
人口流出	じんこうりゅうしゅつ。
人口減対策	じんこうげんたいさく。
人口減少	じんこうげんしょう。
人口減少対策	じんこうげんしょうたいさく。
人口減社会	じんこうげんしゃかい。
人口調査	じんこうちょうさ。
人命	じんめい。
人工呼吸	じんこうこきゅう。
人工心臓	じんこうしんぞう。
人工物	じんこうぶつ。
人工着色料	じんこうちゃくしょくりょう。
人工血管	じんこうけっかん。
人工衛星	じんこうえいせい。
人工関節	じんこうかんせつ。
人差指	ひとさしゆび。
人形	にんぎょう。
人情	にんじょう。
人手	ひとで。
人手不足	ひとでぶそく。
人数	にんずう。
人文字	ひともじ。
人望	じんぼう。
人材	じんざい。
人材不足	じんざいぶそく。
人材交流	じんざいこうりゅう。
人材派遣	じんざいはけん。
人材確保	じんざいかくほ。
人材育成	じんざいいくせい。
人格	じんかく。
人格者	じんかくしゃ。
人権	じんけん。
人権侵害	じんけんしんがい。
人民元	じんみんげん。
人気	にんき。
人気俳優	にんきはいゆう。
人気商品	にんきしょうひん。
人気者	にんきもの。
人災	じんさい。
人為的	じんいてき。
人物	じんぶつ。
人生	じんせい。
人目	ひとめ。
人相	にんそう。
人種	じゅんしゅ。
人種差別	じんしゅさべつ。
人脈	じんみゃく。
人質	ひとじち。
人質事件	ひとじちじけん。
人質解放	ひとじちかいほう。
人身売買	じんしんばいばい。
人造人間	じんぞうにんげん。
人道的観点	じんどうてきかんてん。
人間	にんげん。
人間社会	にんげんしゃかい。
人間関係	にんげんかんけい。
人類	じんるい。
人骨	じんこつ。
人魚	にんぎょ。
今回	こんかい。
今夜	こんや。
今年	ことし。
今度	こんど。
今後	こんご。
今日	きょう。
今晩	こんばん。
今月	こんげつ。
今週	こんしゅう。
介入	かいにゅう。
介護職	かいごしょく。
介護職員	かいごしょくいん。
介護費用	かいごひよう。
仏像	ぶつぞう。
仏前	ぶつぜん。
仏教	ぶっきょう。
仏教徒	ぶっきょうと。
仏様	ほとけさま。
仏頂面	ぶっちょうづら。
仕事	しごと。
仕事内容	しごとないよう。
仕事量	しごとりょう。
仕方	しかた。
仕業	しわざ。
他人	たにん。
他力	たりき。
他国	たこく。
他殺	たさつ。
他言	たげん。
付加価値	ふかかち。
付属	ふぞく。
付根	つけね。
付着	ふちゃく。
付着物	ふちゃくぶつ。
付近	ふきん。
付録	ふろく。
代名詞	だいめいし。
代物	しろもの。
代理	だいり。
代理人	だいりにん。
代理出産	だいりしゅっさん。
代理母	だいりはは。
代用	だいよう。
代用品	だいようひん。
代行	だいこう。
代表	だいひょう。
代表作	だいひょうさく。
代表取締役	だいひょうとりしまりやく。
代表者	だいひょうしゃ。
代表質問	だいひょうしつもん。
代表選手	だいひょうせんしゅ。
代議士	だいぎし。
代金	だいきん。
代金引換	だいきんひきかえ。
以上	いじょう。
以下	いか。
以内	いない。
以前	いぜん。
以外	いがい。
以後	いご。
以心伝心	いしんでんしん。
以来	いらい。
以降	いこう。
仮名	かあｎ。
仮定	かてい。
仮想敵	かそうてき。
仮死	かし。
仮死状態	かしじょうたい。
仮病	けびょう。
仮眠	かみん。
仮称	かしょう。
仮設	かせつ。
仮設住宅	かせつじゅうたく。
仮説	かせつ。
仮面	かめん。
仲人	なこうど。
仲介業者	ちゅうかいぎょうしゃ。
仲間	なかま。
件数	けんすう。
任務	にんむ。
任命	にんめい。
任期	にんき。
任期満了	にんきまんりょう。
企業	きぎょう。
企業価値	きぎょうかち。
企業倒産	きぎょうとうさん。
企業献金	きぎょうけんきん。
企業秘密	きぎょうひみつ。
企業経営	きぎょうけいえい。
企業統治	きぎょうとうち。
企業買収	きぎょうばいしゅう。
企画	きかく。
企画書	きかくしょ。
休刊	きゅうかん。
休場	きゅうじょう。
休学	きゅうがく。
休息	きゅうそく。
休日	きゅうじつ。
休校	きゅうこう。
休業	きゅうぎょう。
休業日	きゅうぎょうび。
休養	きゅうよう。
会合	かいごう。
会員	かいいん。
会員制	かいいんせい。
会員権	かいいんけん。
会場	かいじょう。
会社	かいしゃ。
会社員	かいしゃいん。
会見	かいけん。
会計	かいけい。
会話	かいわ。
会談	かいだん。
会議	かいぎ。
伝承	でんしょう。
伝授	でんじゅ。
伝来	でんらい。
伝染	でんせん。
伝染病	でんせんびょう。
伝票	でんぴょう。
伝統	でんとう。
伝統工芸	でんとうこうげい。
伝統芸能	でんとうげいのう。
伝統行事	でんとうぎょうじ。
伝言	でんごん。
伝言板	でんごんばん。
伝説	でんせつ。
似顔絵	にがおえ。
位置	いち。
位置情報	いちじょうほう。
低下	ていか。
低価格	ていかかく。
低価格商品	ていかかくしょうひん。
低品質	ていひんしつ。
低姿勢	ていしせい。
低所得層	ていしょとくそう。
低気圧	ていきあつ。
低温	ていおん。
低燃費	ていねんぴ。
低燃費車	ていねんぴしゃ。
低空	ていくう。
低空飛行	ていくうひこう。
低血圧	ていけつあつ。
低迷	ていめい。
低音	ていおん。
住人	じゅうにん。
住宅	じゅうたく。
住宅地	じゅうたくち。
住宅市場	じゅうたくしじょう。
住居	じゅうきょ。
住所	じゅうしょ。
住民	じゅうみん。
住民基本台帳	じゅうみんきほんだいちょう。
住民票	じゅうみんひょう。
住職	じゅうしょく。
佐賀県	さがけん。
体内	たいない。
体内時計	たいないとけい。
体力	たいりょく。
体力測定	たいりょくそくてい。
体型	たいけい。
体操	たいそう。
体操選手	たいそうせんしゅ。
体格	たいかく。
体温	たいおん。
体温計	たいおんけい。
体積	たいせき。
体罰	たいばつ。
体育	たいいく。
体育館	たいいくかん。
体調	たいちょう。
体調不良	たいちょうふりょう。
体調管理	たいちょうかんり。
体質	たいしつ。
体重	たいじゅう。
体重計	たいじゅうけい。
体長	たいちょう。
体験	たいけん。
体験記	たいけんき。
体験談	たいけんだん。
余分	よぶん。
余命	よめい。
余命宣告	よめいせんこく。
余地	よち。
余熱	よねつ。
余生	よせい。
余白	よはく。
余計	よけい。
余談	よだん。
作品	さくひん。
作家	さっか。
作成	さくせい。
作戦	さくせん。
作文	さくぶん。
作曲	さっきょく。
作曲家	さっきょくか。
作曲者	さっきょくしゃ。
作業	さぎょう。
作業着	さぎょうぎ。
作法	さほう。
作物	さくもつ。
作用	さよう。
作用点	さようてん。
作者	さくしゃ。
作詞	さくし。
作詞家	さくしか。
作話	さくわ。
使命	しめい。
使命感	しめいかん。
使用	しよう。
使用例	しようれい。
使用料	しようりょう。
使用禁止	しようきんし。
使者	ししゃ。
例外	れいがい。
例年	れいねん。
例文	れいぶん。
例話	たとえばなし。
例題	れいだい。
供物	くもつ。
供給	きょうきゅう。
供給先	きょうきゅうさき。
供給過剰	きょうきゅうかじょう。
供述	きょうじゅつ。
依存	いぞん。
依存症	いぞんしょう。
依頼	いらい。
価値	かち。
価値観	かちかん。
価格	かかく。
価格低迷	かかくていめい。
価格競争	かかくきょうそう。
価格競争力	かかくきょうそうりょく。
価格表示	かかくひょうじ。
侵入者	しんにゅうしゃ。
侵害	しんがい。
侵略	しんりゃく。
侵略戦争	しんりゃくせんそう。
侵略者	しんりゃくしゃ。
便乗	びんじょう。
便利	べんり。
便所	べんじょ。
係員	かかりいん。
俗語	ぞくご。
俗説	ぞくせつ。
保健	ほけん。
保健体育	ほけんたいいく。
保健室	ほけんしつ。
保健所	ほけんじょ。
保存	ほぞん。
保存方法	ほぞんほうほう。
保守	ほしゅ。
保守的	ほしゅてき。
保持	ほじ。
保有株式	ほゆうかぶしき。
保母	ほぼ。
保温	ほおん。
保湿効果	ほしつこうか。
保留	ほりゅう。
保管	ほかん。
保管物	ほかんぶつ。
保育	ほいく。
保育園	ほいくえん。
保育士	ほいくし。
保育所	ほいくしょ。
保育施設	ほいくしせつ。
保証	ほしょう。
保証人	ほしょうにん。
保証書	ほしょうしょ。
保護	ほご。
保護主義	ほごしゅぎ。
保護者	ほごしゃ。
保険	ほけん。
保険会社	ほけんがいしゃ。
保険制度	ほけんせいど。
保険料	ほけんりょう。
保険料収入	ほけんりょうしゅうにゅう。
保険証	ほけんしょう。
保険適用	ほけんてきよう。
保険金	ほけんきん。
保障	ほしょう。
信号	しんごう。
信号機	しんごうき。
信念	しんねん。
信用	しんよう。
信用情報	しんようじょうほう。
信用調査	しんようちょうさ。
信者	しんじゃ。
信賞必罰	しんしょうひつばつ
信頼	しんらい。
信頼回復	しんらいかいふく。
信頼関係	しんらいかんけい。
修学旅行	しゅうがくりょこう。
修復	しゅうふく。
修正	しゅうせい。
修理	しゅうり。
修理品	しゅうりひん。
修行	しゅぎょう。
俳人	はいじん。
俳優	はいゆう。
俳句	はいく。
倉庫	そうこ。
倉庫番	そうこばん。
個人	こじん。
個人主義	こじんしゅぎ。
個人事業主	こじんじぎょうぬし。
個人差	こじんさ。
個人情報	こじんじょうほう。
個人情報保護法	こじんじょうほうほごほう。
個人投資家	こじんとうしか。
個人旅行	こじんりょこう。
個人消費	こじんしょうひ。
個人経営	こじんけいえい。
個人資産	こじんしさん。
個室	こしつ。
個展	こてん。
個性	こせい。
個数	こすう。
倍増	ばいぞう。
倍数	ばいすう。
倍率	ばいりつ。
倍速	ばいそく。
倒産	とうさん。
倒立	とうりつ。
借主	かりぬし。
借地	しゃくち。
借家	しゃくや。
借用書	しゃくようしょ。
借金	しゃっきん。
借金問題	しゃっきんもんだい。
値千金	あたいせんきん。
値段	ねだん。
倹約	けんやく。
偉人	いじん。
偉大	いだい。
偉業	いぎょう。
停学処分	ていがくしょぶん。
停戦	ていせん。
停止	ていし。
停車	ていしゃ。
停電	ていでん。
健全	けんぜん。
健常者	けんじょうしゃ。
健康	けんこう。
健康保険	けんこうほけん。
健康保険証	けんこうほけんしょう。
健康問題	けんこうもんだい。
健康増進	けんこうぞうしん。
健康寿命	けんこうじゅみょう。
健康法	けんこうほう。
健康状態	けんこうじょうたい。
健康管理	けんこうかんり。
健康被害	けんこうひがい。
健康診断	けんこうしんだん。
健康食	けんこうしょく。
健康食品	けんこうしょくひん。
健闘	けんとう。
側近	そっきん。
側面	そくめん。
側面図	そくめんず。
偵察機	ていさつき。
偶数	ぐうすう。
偶然	ぐうぜん。
偽名	ぎめい。
偽善	ぎぜん。
偽善者	ぎぜんしゃ。
偽造	ぎぞう。
備品	びひん。
備長炭	びんちょうたん。
債権回収	さいけんかいしゅう。
傷口	きずぐち。
傷害事件	しょうがいじけん。
傷害致死罪	しょうがいちしざい。
傷心	しょうしん。
傾向	けいこう。
傾斜	けいしゃ。
億万長者	おくまんちょうじゃ。
優位	ゆうい。
優先	ゆうせん。
優先席	ゆうせんせき。
優先順位	ゆうせんじゅんい。
優勝	ゆうしょう。
優勝旗	ゆうしょうき。
優勢	ゆうせい。
優秀作品	ゆうしゅうさくひん。
優等生	ゆうとうせい。
優良	ゆうりょう。
優遇	ゆうぐう。
元値	もとね。
元凶	げんきょう。
元号	げんごう。
元年	がんねん。
元手	もとで。
元日	がんじつ。
元気	げんき。
元祖	がんそ。
元素	げんそ。
元素記号	げんそきごう。
元首	げんしゅ。
兄弟	きょうだい。
兄貴	あにき。
充実	じゅうじつ。
充実感	じゅうじつかん。
充満	じゅうまん。
充血	じゅうけつ。
充電	じゅうでん。
充電器	じゅうでんき。
充電式	じゅうでんしき。
兆候	ちょうこう。
先人	せんじん。
先入観	せんにゅうかん。
先制点	せんせいてん。
先取	せんしゅ。
先客	せんきゃく。
先手	せんて。
先方	せんぽう。
先日	せんじつ。
先月	せんげつ。
先物価格	さきものかかく。
先物取引	さきものとりひき。
先生	せんせい。
先着	せんちゃく。
先着順	せんちゃくじゅん。
先祖	せんぞ。
先端	せんたん。
先端技術	せんたんぎじゅつ。
先週	せんしゅう。
先進国	せんしんこく。
先頭	せんとう。
光化学	こうかがく。
光合成	こうごうせい。
光景	こうけい。
光栄	こうえい。
光源	こうげん。
光熱費	こうねつひ。
光線	こうせん。
免税対象	めんぜいたいしょう。
免税店	めんぜいてん。
免許	めんきょ。
免許証	めんきょしょう。
児童	じどう。
児童数	じどうすう。
児童文学	じどうぶんがく。
児童相談所	じどうそうだんしょ。
党首	とうしゅ。
入会	にゅうかい。
入団	にゅうだん。
入国	にゅうこく。
入場	にゅうじょう。
入場制限	にゅうじょうせいげん。
入場券	にゅうじょうけん。
入場料	にゅうじょうりょう。
入場無料	にゅうじょうむりょう。
入場者	にゅうじょうしゃ。
入場者数	にゅうじょうしゃすう。
入場行進	にゅうじょうこうしん。
入学	にゅうがく。
入学式	にゅうがくしき。
入学試験	にゅうがくしけん。
入学願書	にゅうがくがんしょ。
入居者	にゅうきょしゃ。
入手	にゅうしゅ。
入手困難	にゅうしゅこんなん。
入浴	にゅうよく。
入浴剤	にゅうよくざい。
入社	にゅうしゃ。
入社試験	にゅうしゃしけん。
入荷	にゅうか。
入試	にゅうし。
入試問題	にゅうしもんだい。
入試対策	にゅうしたいさく。
入賞	にゅうしょう。
入退院	にゅうたいいん。
入選	にゅうせん。
入金	にゅうきん。
入金確認	にゅうきんかくにん。
入門	にゅうもん。
入門書	にゅうもんしょ。
入院	にゅういん。
入院患者	にゅういんかんじゃ。
入院生活	にゅういんせいかつ。
入隊	にゅうたい。
全世界	ぜんせかい。
全体	ぜんたい。
全体主義	ぜんたいしゅぎ。
全力	ぜんりょく。
全力投球	ぜんりょくとうきゅう。
全勝	ぜんしょう。
全勝優勝	ぜんしょうゆうしょう。
全勝無敗	ぜんしょうむはい。
全員	ぜんいん。
全員帰国	ぜんいんきこく。
全員集合	ぜんいんしゅうごう。
全国	ぜんこく。
全国各地	ぜんこくかくち。
全国平均	ぜんこくへいきん。
全国消費者物価指数	ぜんこくしょうひしゃぶっかしすう。
全国高校選手権	ぜんこくこうこうせんしゅけん。
全快	ぜんかい。
全敗	ぜんぱい。
全日本選手権	ぜんにほんせんしゅけん。
全日本高校選手権	ぜんにほんこうこうせんしゅけん。
全治	ぜんち。
全然	ぜんぜん。
全焼	ぜんしょう。
全盛	ぜんせい。
全盛期	ぜんせいき。
全知全能	ぜんちぜんのう。
全自動	ぜんじどう。
全責任	ぜんせきにん。
全身	ぜんしん。
全速力	ぜんそくりょく。
全部	ぜんぶ。
全長	ぜんちょう。
全面禁止	ぜんめんきんし。
全額	ぜんがく。
全額負担	ぜんがくふたん。
八方美人	はっぽうびじん。
八日	ようか。
八月	はちがつ。
八百	はっぴゃく。
八百屋	やおや。
八百長	やおちょう。
八重	やえ。
八重桜	やえざくら。
八重歯	やえば。
公倍数	こうばいすう。
公共	こうきょう。
公共事業	こうきょうじぎょう。
公共交通機関	こうきょうこうつうきかん。
公共団体	こうきょうだんたい。
公共工事	こうきょうこうじ。
公共放送	こうきょうほうそう。
公共料金	こうきょうりょうきん。
公共施設	こうきょうしせつ。
公務員	こうむいん。
公務員試験	こうむいんしけん。
公園	こうえん。
公害	こうがい。
公害防止	こうがいぼうし。
公平	こうへい。
公式	こうしき。
公式練習	こうしきれんしゅう。
公文書	こうぶんしょ。
公明正大	こうめいせいだい。
公正	こうせい。
公民館	こうみんかん。
公演	こうえん。
公然	こうぜん。
公用車	こうようしゃ。
公的年金制度	こうてきねんきんせいど。
公的機関	こうてききかん。
公益社団法人	こうえきしゃだんほうじん。
公益通報者保護	こうえきつうほうしゃほご。
公私混同	こうしこんどう。
公立	こうりつ。
公約	こうやく。
公約数	こうやくすう。
公衆	こうしゅう。
公衆便所	こうしゅうべんじょ。
公表	こうひょう。
公言	こうげん。
公認会計士	こうにんかいけいし。
公転	こうてん。
公選法違反	こうせんほういはん。
公開	こうかい。
六十分	ろくじゅっぷん。
六十秒	ろくじゅうびょう。
六年生	ろくねんせい。
六年間	ろくねんかん。
六日	むいか。
六月	ろくがつ。
六角形	ろっかくけい。
共同	きょうどう。
共同体	きょうどうたい。
共同作業	きょうどうさぎょう。
共同出資	きょうどうしゅっし。
共同声明	きょうどうせいめい。
共同生活	きょうどうせいかつ。
共同研究者	きょうどうけんきゅうしゃ。
共同訓練	きょうどうくんれん。
共同運営	きょうどううんえい。
共同開発	きょうどうかいはつ。
共和国	きょうわこく。
共存	きょうぞん。
共学	きょうがく。
共感	きょうかん。
共有	きょうゆう。
共有財産	きょうゆうざいさん。
共犯	きょうはん。
共産主義	きょうさんしゅぎ。
共通	きょうつう。
共通化	きょうつうか。
共通点	きょうつうてん。
共通語	きょうつうご。
兵力	へいりょく。
兵器	へいき。
兵士	へいし。
兵庫県	ひょうごけん。
兵役	へいえき。
兵隊	へいたい。
具体的	ぐたいてき。
具体策	ぐたいさく。
具合	ぐあい。
典型的	てんけいてき。
兼任	けんにん。
兼務	けんむ。
兼業	けんぎょう。
兼用	けんよう。
内出血	ないしゅっけつ。
内定者	ないていしゃ。
内定辞退	ないていじたい。
内容	ないよう。
内容量	ないようりょう。
内密	ないみつ。
内幕	うちまく。
内心	ないしん。
内政干渉	ないせいかんしょう。
内服薬	ないふくやく。
内気	うちき。
内申書	ないしんしょ。
内科	ないか。
内職	ないしょく。
内臓	ないぞう。
内臓破裂	ないぞうはれつ。
内蔵	ないぞう。
内訳	うちわけ。
内部	ないぶ。
内部告発	ないぶこくはつ。
内部告発者	ないぶこくはつしゃ。
内部崩壊	ないぶほうかい。
内部文書	ないぶぶんしょ。
内部犯行	ないぶはんこう。
内閣	ないかく。
内閣不信任	ないかくふしんにん。
内閣府	ないかくふ。
内閣支持率	ないかくしじりつ。
内閣改造	ないかくかいぞう。
内閣発足	ないかくほっそく。
内閣総理大臣	ないかくそうりだいじん。
円卓	えんたく。
円周	えんしゅう。
円周率	えんしゅうりつ。
円安	えんやす。
円形	えんけい。
円柱	えんちゅう。
円満	えんまん。
円滑	えんかつ。
円相場	えんそうば。
円筒形	えんとうけい。
円運動	えんうんどう。
円高	えんだか。
冊子	さっし。
再交付	さいこうふ。
再会	さいかい。
再入力	さいにゅうりょく。
再契約	さいけいやく。
再度	さいど。
再建	さいけん。
再挑戦	さいちょうせん。
再来	さいらい。
再来月	さらいげつ。
再燃	さいねん。
再現	さいげん。
再生	さいせい。
再生医療	さいせいいりょう。
再生可能	さいせいかのう。
再生紙	さいせいし。
再発	さいはつ。
再発見	さいはっけん。
再発防止	さいはつぼうし。
再発防止策	さいはつぼうしさく。
再稼動	さいかどう。
再考	さいこう。
再起不能	さいきふのう。
再選	さいせん。
再開	さいかい。
再開発	さいかいはつ。
冒険	ぼうけん。
冒険家	ぼうけんか。
写実	しゃじつ。
写生	しゃせい。
写真	しゃしん。
写真代	しゃしんだい。
写真機	しゃしんき。
冬場	ふゆば。
冬季	とうき。
冬将軍	ふゆしょうぐん。
冬眠	とうみん。
冬至	とうじ。
冷凍	れいとう。
冷凍保管	れいとうほかん。
冷凍室	れいとうしつ。
冷凍庫	れいとうこ。
冷凍食品	れいとうしょくひん。
冷却	れいきゃく。
冷害	れいがい。
冷戦	れいせん。
冷戦時代	れいせんじだい。
冷戦期	れいせんき。
冷房	れいぼう。
冷気	れいき。
冷水	れいすい。
冷蔵庫	れいぞうこ。
冷静	れいせい。
凍死	とうし。
処分	しょぶん。
処理	しょり。
処理速度	しょりそくど。
処置	しょち。
凶器	きょうき。
凶悪	きょうあく。
凶悪犯	きょうあくはん。
凶悪犯罪	きょうあくはんざい。
凶暴	きょうぼう。
出世	しゅっせ。
出世魚	しゅっせうお。
出入口	でいりぐち。
出刃包丁	でばぼうちょう。
出前	でまえ。
出力	しゅつりょく。。
出動	しゅつどう。
出勤	しゅっきん。
出口	でぐち。
出口調査	でぐちちょうさ。
出品	しゅっぴん。
出品者	しゅっぴんしゃ。
出国	しゅっこく。
出場	しゅつじょう。
出場停止	しゅつじょうていし。
出家	しゅっけ。
出席	しゅっせき。
出席者	しゅっせきしゃ。
出店	しゅってん。
出張	しゅっちょう。
出張中	しゅっちょうちゅう。
出張日	しゅっちょうび。
出所	でどころ。
出来事	できごと。
出来高	できだか。
出欠	しゅっけつ。
出没	しゅつぼつ。
出港	しゅっこう。
出演	しゅつえん。
出演者	しゅつえんしゃ。
出火	しゅっか。
出版	しゅっぱん。
出版業界	しゅっぱんぎょうかい。
出版物	しゅっぱんぶつ。
出版社	しゅっぱんしゃ。
出版禁止	しゅっぱんきんし。
出現	しゅつげん。
出生	しゅっせい。
出生届	しゅっせいとどけ。
出生率	しゅっせいりつ。
出産	しゅっさん。
出産報告	しゅっさんほうこく。
出産日	しゅっさんび。
出発	しゅっぱつ。
出発日	しゅっぱつび。
出荷	しゅっか。
出荷時期	しゅっかじき。
出血	しゅっけつ。
出血多量	しゅっけつたりょう。
出血熱	しゅっけつねつ。
出費	しゅっぴ。
出身	しゅっしん。
出身地	しゅっしんち。
出頭	しゅっとう。
出題	しゅつだい。
出題者	しゅつだいしゃ。
出馬	しゅつば。
刃物	はもの。
分別	ぶんべつ。
分割	ぶんかつ。
分子	ぶんし。
分子生物学	ぶんしせいぶつがく。
分布	ぶんぷ。
分度器	ぶんどき。
分担	ぶんたん。
分数	ぶんすう。
分業	ぶんぎょう。
分解	ぶんかい。
分身	ぶんしん。
分身術	ぶんしんじゅつ。
分野	ぶんや。
分量	ぶんりょう。
分銅	ふんどう。
分類	ぶんるい。
切実	せつじつ。
切手	きって。
切断	せつだん。
切腹	せっぷく。
切迫	せっぱく。
切開	せっかい。
切除	せつじょ。
刑事	けいじ。
刑事事件	けいじじけん。
刑事告訴	けいじこくそ。
刑事訴訟	けいじそしょう。
刑務所	けいむしょ。
刑法	けいほう。
刑罰	けいばつ。
列島	れっとう。
列挙	れっきょ。
初優勝	はつゆうしょう。
初回購入者	しょかいこうにゅうしゃ。
初回限定	しょかいげんてい。
初場所	はつばしょ。
初夏	しょか。
初夢	はつゆめ。
初対面	しょたいめん。
初心	しょしん。
初心者	しょしんしゃ。
初志	しょし。
初恋	はつこい。
初日	しょにち。
初期	しょき。
初期投資	しょきとうし。
初歩	しょほ。
初演	しょえん。
初版	しょはん。
初級	しょきゅう。
初耳	はつみみ。
初雪	はつゆき。
判定	はんてい。
判断	はんだん。
判断材料	はんだんざいりょう。
判明	はんめい。
判決	はんけつ。
判決内容	はんけつないよう。
判決文	はんけつぶん。
別人	べつじん。
別便	べつびん。
別居	べっきょ。
利便性	りべんせい。
利口	りこう。
利子	りし。
利害関係	りがいかんけい。
利害関係者	りがいかんけいしゃ。
利息	りそく。
利点	りてん。
利用	りよう。
利用価値	りようかち。
利用促進	りようそくしん。
利用可能	りようかのう。
利用者	りようしゃ。
利益	りえき。
到着	とうちゃく。
到着駅	とうちゃくえき。
到達	とうたつ。
到達点	とうたつてん。
制圧	せいあつ。
制定	せいてい。
制度	せいど。
制度化	せいどか。
制御	せいぎょ。
制服	せいふく。
制服組	せいふくぐみ。
制約	せいやく。
制裁	せいさい。
制裁金	せいさいきん。
制限	せいげん。
制限時間	せいげんじかん。
刺殺	しさつ。
刺身	さしみ。
刻印	こくいん。
削減	さくげん。
削減目標	さくげんもくひょう。
削除	さくじょ。
前世	ぜんせ。
前代未聞	ぜんだいみもん。
前例	ぜんれい。
前兆	ぜんちょう。
前兆現象	ぜんちょうげんしょう。
前半	ぜんはん。
前半戦	ぜんはんせん。
前回	ぜんかい。
前夜	ぜんや。
前年	ぜんねん。
前年度	ぜんねんど。
前後	ぜんご。
前後賞	ぜんごしょう。
前提	ぜんてい。
前提条件	ぜんていじょうけん。
前方	ぜんぽう。
前方確認	ぜんぽうかくにん。
前日	ぜんじつ。
前歯	まえば。
前略	ぜんりゃく。
前科	ぜんか。
前線	ぜんせん。
前編	ぜんぺん。
前足	まえあし。
前輪	ぜんりん。
前進	ぜんしん。
前頭葉	ぜんとうよう。
前髪	まえがみ。
剣道	けんどう。
副業	ふくぎょう。
副産物	ふくさんぶつ。
副題	ふくだい。
割合	わりあい。
割安	わりやす。
割安感	わりやすかん。
割引	わりびき。
割愛	かつあい。
割高	わりだか。
割高感	わりだかかん。
創作	そうさく。
創作活動	そうさくかつどう。
創作物	そうさくぶつ。
創刊	そうかん。
創刊号	そうかんごう。
創始者	そうししゃ。
創意工夫	そういくふう。
創立	そうりつ。
創立記念	そうりつきねん。
創造	そうぞう。
劇団	げきだん。
劇場	げきじょう。
劇痛	げきつう。
劇的	げきてき。
劇薬	げきやく。
力不足	ちからぶそく。
力仕事	ちからしごと。
力作	りきさく。
力投	りきとう。
力点	りきてん。
力説	りきせつ。
功労	こうろう。
功労者	こうろうしゃ。
功名	こうみょう。
功績	こうせき。
功罪	こうざい。
加入	かにゅう。
加入条件	かにゅうじょうけん。
加入者	かにゅしゃ。
加勢	かせい。
加害	かがい。
加害者	かがいしゃ。
加工	かこう。
加工乳	かこうにゅう。
加工貿易	かこうぼうえき。
加工食品	かこうしょくひん。
加減	かげん。
加湿器	かしつき。
加熱	かねつ。
加盟	かめい。
加盟国	かめいこく。
加盟店	かめいてん。
加速	かそく。
加速度	かそくど。
劣勢	れっせい。
助力	じょりょく。
助動詞	じょどうし。
助太刀	すけだち。
助手	じょしゅ。
助手席	じょしゅせき。
助言	じょげん。
努力	どりょく。
努力家	どりょくか。
努力義務	どりょくぎむ。
労使交渉	ろうしこうしょう。
労働	ろうどう。
労働三権	ろうどうさんけん。
労働保険	ろうどうほけん。
労働力	ろうどうりょく。
労働問題	ろうどうもんだい。
労働基準法	ろうどうきじゅんほう。
労働市場	ろうどうしじょう。
労働条件	ろうどうじょうけん。
労働災害	ろうどうさいがい。
労働環境	ろうどうかんきょう。
労働組合	ろうどうくみあい。
労働者	ろうどうしゃ。
労働者派遣法	ろうどうしゃはけんほう。
労働運動	ろうどううんどう。
労力	ろうりょく。
労災認定	ろうさいにんてい。
効力	こうりょく。
効果	こうか。
効果音	こうかおん。
効率	こうりつ。
効能	こうのう。
勇姿	ゆうし。
勇気	ゆうき。
勇者	ゆうしゃ。
勉強	べんきょう。
勉強不足	べんきょうぶそく。
勉強会	べんきょうかい。
勉強家	べんきょうか。
勉強机	べんきょうづくえ。
動作	どうさ。
動作環境	どうさかんきょう。
動力	どうりょく。
動向	どうこう。
動植物	どうしょくぶつ。
動機	どうき。
動物	どうぶつ。
動物園	どうぶつえん。
動画	どうが。
動脈	どうみゃく。
動脈硬化	どうみゃくこうか。
動詞	どうし。
動転	どうてん。
勝利	しょうり。
勝因	しょういん。
勝手	かって。
勝手口	かってぐち。
勝敗	しょうはい。
勝者	しょうしゃ。
勝負	しょうぶ。
勝負事	しょうぶごと。
募金	ぼきん。
募集	ぼしゅう。
勢力	せいりょく。
勤労	きんろう。
勤労感謝	きんろうかんしゃ。
勤勉	きんべん。
勤務	きんむ。
勤務時間	きんむじかん。
勤務経験	きんむけいけん。
包丁	ほうちょう。
包囲	ほうい。
包囲網	ほういもう。
包帯	ほうたい。
包装	ほうそう。
包装紙	ほうそうし。
化合物	かごうぶつ。
化学	かがく。
化学兵器	かがくへいき。
化学反応式	かがくはんのうしき。
化学変化	かがくへんか。
化学肥料	かがくひりょう。
化学薬品	かがくやくひん。
化学調味料	かがくちょうみりょう。
化石	かせき。
北上	ほくじょう。
北半球	きたはんきゅう。
北国	きたぐに。
北方領土	ほっぽうりょうど。
北朝鮮	きたちょうせん。
北極	ほっきょく。
北極星	ほっきょくせい。
北極海	ほっきょくかい。
北極点	ほっきょくてん。
北海道	ほっかいどう。
北海道地方	ほっかいどうちほう。
北米	ほくべい。
北部	ほくぶ。
北陸	ほくりく。
北陸地方	ほくりくちほう。
北風	きたかぜ。
区分線	くぶんせん。
区切	くぎり。
区別	くべつ。
区域	くいき。
区役所	くやくしょ。
区画	くかく。
区間	くかん。
医学	いがく。
医師	いし。
医師不足	いしぶそく。
医師団	いしだん。
医療情報	いりょうじょうほう。
医療技術	いりょうぎじゅつ。
医療機関	いりょうきかん。
医者	いしゃ。
医薬品	いやくひん。
医薬部外品	いやくぶがいひん。
医院	いいん。
十一月	じゅういちがつ。
十二支	じゅうにし。
十二月	じゅうにがつ。
十八番	おはこ。
十字路	じゅうじろ。
十日	とおか。
十月	じゅうがつ。
十進法	じっしんほう。
千円札	せんえんさつ。
千差万別	せんさばんべつ。
千葉県	ちばけん。
千載一遇	せんざいいちぐう。
千里眼	せんりがん。
午前	ごぜん。
午後	ごご。
半信半疑	はんしんはんぎ。
半値	はんね。
半分	はんぶん。
半導体	はんどうたい。
半導体技術	はんどうたいぎじゅつ。
半島	はんとう。
半径	はんけい。
半数	はんすう。
半減	はんげん。
半濁音	はんだくおん。
半熟	はんじゅく。
半熟卵	はんじゅくたまご。
半生	はんせい。
半紙	はんし。
半額	はんがく。
卒業	そつぎょう。
卒業予定	そつぎょうよてい。
卒業予定者	そつぎょうよていしゃ。
卒業写真	そつぎょうしゃしん。
卒業式	そつぎょうしき。
卒業生	そつぎょうせい。
卒業論文	そつぎょうろんぶん。
卒論	そつろん。
卓球	たっきゅう。
協力	きょうりょく。
協力者	きょうりょくしゃ。
協同	きょうどう。
協同組合	きょうどうくみあい。
協定	きょうてい。
協調	きょうちょう。
協調性	きょうちょうせい。
協議	きょうぎ。
南下	なんか。
南下政策	なんかせいさく。
南北	なんぼく。
南半球	みなみはんきゅう。
南国	なんごく。
南極	なんきょく。
南極大陸	なんきょくたいりく。
南極海	なんきょくかい。
南極点	なんきょくてん。
南極観測隊	なんきょくかんそくたい。
南部	なんぶ。
単位	たんい。
単価	たんか。
単元	たんげん。
単刀直入	たんとうちょくにゅう。
単独	たんどく。
単独犯	たんどくはん。
単純	たんじゅん。
単細胞	たんさいぼう。
単細胞生物	たんさいぼうせいぶつ。
単行本	たんこうぼん。
単語	たんご。
単身	たんしん。
博士	はかせ。
博士号	はくしごう。
博士論文	はくしろんぶん。
博学	はくがく。
博愛	はくあい。
博愛主義	はくあいしゅぎ。
博愛主義者	はくあいしゅぎしゃ。
博物館	はくぶつかん。
占領	せんりょう。
占領軍	せんりょうぐん。
印刷	いんさつ。
印刷会社	いんさつがいしゃ。
印刷機	いんさつき。
印刷物	いんさつぶつ。
印刷用紙	いんさつようし。
印刷速度	いんさつそくど。
印象	いんしょう。
印象派	いんしょうは。
印象的	いんしょうてき。
印鑑証明書	いんかんしょうめいしょ。
危害	きがい。
危機	きき。
危機一髪	ききいっぱつ。
危機感	ききかん。
危機管理	ききかんり。
危険	きけん。
危険人物	きけんじんぶつ。
危険物	きけんぶつ。
即位	そくい。
即席	そくせき。
即死	そくし。
即決	そっけつ。
即答	そくとう。
卵白	らんぱく。
卵黄	らんおう。
厚地	あつじ。
厚手	あつで。
厚生労働省	こうせいろうどうしょう。
厚生年金	こうせいねんきん。
厚着	あつぎ。
厚紙	あつがみ。
原付	げんつき。
原住民	げんじゅうみん。
原作	げんさく。
原作者	げんさくしゃ。
原価	げんか。
原則	げんそく。
原則禁止	げんそくきんし。
原動力	げんどうりょく。
原因	げんいん。
原因不明	げんいんふめい。
原因究明	げんいんきゅうめい。
原始人	げんしじん。
原始時代	げんしじだい。
原子	げんし。
原子力	げんしりょく。
原子力政策	げんしりょくせいさく。
原子力発電	げんしりょくはつでん。
原子力発電所	げんしりょくはつでんしょ。
原子力規制委員会	げんしりょくきせいいいんかい。
原子核	げんしかく。
原子番号	げんしばんごう。
原寸	げんすん。
原文	げんぶん。
原料	げんりょう。
原材料	げんざいりょう。
原材料価格	げんざいりょうかかく。
原材料費	げんざいりょうひ。
原油	げんゆ。
原油価格	げんゆかかく。
原油生産量	げんゆせいさんりょう。
原油相場	げんゆそうば。
原点	げんてん。
原理	げんり。
原理主義	げんりしゅぎ。
原発事故	げんぱつじこ。
原発再稼動	げんぱつさいかどう。
原発問題	げんぱつもんだい。
原発建設	げんぱつけんせつ。
原発推進	げんぱつすいしん。
原発推進派	げんぱつすいしんは。
原発政策	げんぱつせいさく。
原発論争	げんぱつろんそう。
原石	げんせき。
原稿	げんこう。
原稿料	げんこうりょう。
原稿用紙	げんこうようし。
原色	げんしょく。
厳守	げんしゅ。
厳密	げんみつ。
厳戒態勢	げんかいたいせい。
厳格	げんかく。
厳正	げんせい。
厳禁	げんきん。
厳選	げんせん。
厳重	げんじゅう。
厳重管理	げんじゅうかんり。
去年	きょねん。
参上	さんじょう。
参列	さんれつ。
参加	さんか。
参加国	さんかこく。
参加無料	さんかむりょう。
参加者	さんかしゃ。
参加資格	さんかしかく。
参勤交代	さんきんこうたい。
参拝	さんぱい。
参政権	さんせいけん。
参画	さんかく。
参考	さんこう。
参考人	さんこうにん。
参考書	さんこうしょ。
参観	さんかん。
参観日	さんかんび。
参議院	さんぎいん。
参院議員	さんいんぎいん。
参院選	さんいんせん。
友人	ゆうじん。
友好	ゆうこう。
友好国	ゆうこうこく。
友好都市	ゆうこうとし。
友情	ゆうじょう。
友愛	ゆうあい。
友達	ともだち。
双眼鏡	そうがんきょう。
反乱	はんらん。
反乱軍	はんらんぐん。
反則	はんそく。
反動	はんどう。
反対	はんたい。
反対意見	はんたいいけん。
反対方向	はんたいほうこう。
反対派	はんたいは。
反対者	はんたいしゃ。
反対語	はんたいご。
反対運動	はんたいうんどう。
反射	はんしゃ。
反射板	はんしゃばん。
反射率	はんしゃりつ。
反射神経	はんしゃしんけい。
反射鏡	はんしゃきょう。
反復	はんぷく。
反応	はんのう。
反応速度	はんのうそくど。
反感	はんかん。
反戦	はんせん。
反戦運動	はんせんうんどう。
反政府勢力	はんせいふせいりょく。
反政府武装勢力	はんせいふぶそうせいりょく。
反比例	はんぴれい。
反発	はんぱつ。
反省	はんせい。
反論	はんろん。
反逆	はんぎゃく。
反逆者	はんぎゃくしゃ。
収入	しゅうにゅう。
収入印紙	しゅうにゅういんし。
収容	しゅうよう。
収容人数	しゅうようにんずう。
収容所	しゅうようじょ。
収拾	しゅうしゅう。
収支報告書	しゅうしほうこくしょ。
収益	しゅうえき。
収益力	しゅうえきりょく。
収益源	しゅうえきげん。
収益金	しゅうえききん。
収納	しゅうのう。
収縮	しゅうしゅく。
収録	しゅうろく。
収録時間	しゅうろくじかん。
収録曲	しゅうろくきょく。
収集	しゅうしゅう。
収集品	しゅうしゅうひん。
収集家	しゅうしゅうか。
取引	とりひき。
取引価格	とりひきかかく。
取引先	とりひきさき。
取引開始	とりひきかいし。
取得	しゅうとく。
取捨選択	しゅしゃせんたく。
取材	しゅざい。
取材陣	しゅざいじん。
取締役	とりしまりやく。
取締役社長	とりしまりやくしゃちょう。
受付	うけつけ。
受付時間	うけつけじかん。
受信	じゅしん。
受信料	じゅしんりょう。
受信機	じゅしんき。
受取	うけとり。
受取人	うけとりにん。
受注	じゅちゅう。
受理	じゅり。
受精卵	じゅせいらん。
受話器	じゅわき。
受講料	じゅこうりょう。
受賞	じゅしょう。
受賞者	じゅしょうしゃ。
受難	じゅなん。
受験	じゅけん。
受験勉強	じゅけんべんきょう。
受験生	じゅけんせい。
受験票	じゅけんひょう。
口下手	くちべた。
口元	くちもと。
口先	くちさき。
口実	こうじつ。
口座	こうざ。
口数	くちかず。
口笛	くちぶえ。
口紅	くちべに。
口語	こうご。
口調	くちょう。
口論	こうろん。
口車	くちぐるま。
古事記	こじき。
古今和歌集	こきんわかしゅう。
古今東西	ここんとうざい。
古代	こだい。
古代文明	こだいぶんめい。
古傷	ふるきず。
古典	こてん。
古典落語	こてんらくご。
古文書	こもんじょ。
古本	ふるほん。
古着	ふるぎ。
古風	こふう。
句点	くてん。
句読点	くとうてん。
可否	かひ。
可決	かけつ。
可能	かのう。
可能性	かのうせい。
台帳	だいちょう。
台形	だいけい。
台所	だいどころ。
台所事情	だいどころじじょう。
台所洗剤	だいどころせんざい。
台所用品	だいどころようひん。
台本	だいほん。
台湾	たいわん。
台湾人	たいわんじん。
台風	たいふう。
台風一過	たいふういっか。
台風被害	たいふうひがい。
史上	しじょう。
史上初	しじょうはつ。
史上最強	しじょうさいきょう。
右側	みぎがわ。
右往左往	うおうさおう。
右手	みぎて。
右折	うせつ。
右足	みぎあし。
号令	ごうれい。
号外	ごうがい。
号泣	ごうきゅう。
司令官	しれいかん。
司会	しかい。
司会者	しかいしゃ。
司会進行	しかいしんこう。
司法	しほう。
司法判断	しほうはんだん。
司法書士	しほうしょし。
司法試験	しほうしけん。
各人	かくじん。
各国	かっこく。
各地	かくち。
各自	かくじ。
各階	かくかい。
合体	がったい。
合同	ごうどう。
合唱	がっしょう。
合唱曲	がっしょうきょく。
合図	あいず。
合奏	がっそう。
合奏団	がっそうだん。
合奏曲	がっそうきょく。
合宿	がっしゅく。
合意	ごうい。
合意形成	ごういけいせい。
合意文書	ごういぶんしょ。
合憲	ごうけん。
合成	ごうせい。
合戦	かっせん。
合格	ごうかく。
合格祈願	ごうかくきがん。
合格者発表	ごうかくしゃはっぴょう。
合法	ごうほう。
合点	がってん。
合理化	ごうりか。
合衆国	がっしゅうこく。
合言葉	あいことば。
合計	ごうけい。
合金	ごうきん。
合間	あいま。
同一	どういつ。
同乗者	どうじょうしゃ。
同好会	どうこうかい。
同封	どうふう。
同居	どうきょ。
同居人	どうきょにん。
同情	どうじょう。
同意	どうい。
同感	どうかん。
同時	どうじ。
同時多発	どうじたはつ。
同業者	どうぎょうしゃ。
同様	どうよう。
同盟	どうめい。
同盟国	どうめいこく。
同盟強化	どうめいきょうか。
同盟関係	どうめいかんけい。
同窓会	どうそうかい。
同等	どうとう。
同級生	どうきゅうせい。
同義語	どうぎご。
名人	めいじん。
名作	めいさく。
名作映画	めいさくえいが。
名刀	めいとう。
名刺	めいし。
名前	なまえ。
名医	めいい。
名古屋場所	なごやばしょ。
名句	めいく。
名器	めいき。
名声	めいせい。
名実	めいじつ。
名所	めいしょ。
名手	めいしゅ。
名曲	めいきょく。
名札	なふだ。
名案	めいあん。
名物	めいぶつ。
名画	めいが。
名監督	めいかんとく。
名称	めいしょう。
名簿	めいぼ。
名義	めいぎ。
名義人	めいぎにん。
名著	めいちょ。
名詞	めいし。
名選手	めいせんしゅ。
名門	めいもん。
向上	こうじょう。
向上心	こうじょうしん。
君主	くんしゅ。
君臨	くんりん。
否定	ひてい。
否定形	ひていけい。
否定文	ひていぶん。
否決	ひけつ。
否認	ひにん。
吸入	きゅうにゅう。
吸収	きゅうしゅう。
吸血鬼	きゅうけつき。
吹奏楽	すいそうがく。
吹雪	ふぶき。
告発	こくはつ。
告発者	こくはつしゃ。
告白	こくはく。
周囲	しゅうい。
周期	しゅうき。
周波数	しゅうはすう。
周知	しゅうち。
周辺	しゅうへん。
周辺事態	しゅうへんじたい。
周辺地域	しゅうへんちいき。
味方	みかた。
味見	あじみ。
味覚	みかく。
味覚障害	みかくしょうがい。
呼吸	こきゅう。
呼吸器	こきゅうき。
呼吸困難	こきゅうこんなん。
命中	めいちゅう。
命令	めいれい。
命令文	めいれいぶん。
命名	めいめい。
命日	めいじつ。
命綱	いのちづな。
和室	わしつ。
和平	わへい。
和平協議	わへいきょうぎ。
和平工作	わへいこうさく。
和式	わしき。
和服	わふく。
和歌	わか。
和歌山県	わかやまけん。
和牛	わぎゅう。
和紙	わし。
和英辞書	わえいじしょ。
和菓子	わがし。
和解	わかい。
和解内容	わかいないよう。
和訳	わやく。
和音	わおん。
和風	わふう。
品格	ひんかく。
品物	しなもの。
品種	ひんしゅ。
品種改良	ひんしゅかいりょう。
品詞	ひんし。
品質	ひんしつ。
品質保証	ひんしつほしょう。
品質管理	ひんしつかんり。
商人	あきんど。
商品	しょうひん。
商品到着	しょうひんとうちゃく。
商品券	しょうひんけん。
商品化	しょうひんか。
商品名	しょうひんめい。
商品未開封	しょうひんみかいふう。
商品番号	しょうひんばんごう。
商品開封	しょうひんかいふう。
商品開発	しょうひんかいはつ。
商売	しょうばい。
商売人	しょうばいにん。
商売敵	しょうばいがたき。
商工会議所	しょうこうかいぎしょ。
商店	しょうてん。
商店街	しょうてんがい。
商業	しょうぎょう。
商業地	しょうぎょうち。
商業施設	しょうぎょうしせつ。
商業高校	しょうぎょうこうこう。
商標	しょうひょう。
商標権	しょうひょうけん。
商談	しょうだん。
問屋	とんや。
問答	もんどう。
問題	もんだい。
問題文	もんだいぶん。
問題点	もんだいてん。
問題用紙	もんだいようし。
問題視	もんだいし。
問題解決	もんだいかいけつ。
問題集	もんだいしゅう。
善人	ぜんにん。
善悪	ぜんあく。
善意	ぜんい。
喜劇	きげき。
喜怒哀楽	きどあいらく。
営利	えいり。
営利目的	えいりもくてき。
営業	えいぎょう。
営業中	えいぎょうちゅう。
営業利益	えいぎょうりえき。
営業成績	えいぎょうせいせき。
営業日	えいぎょうび。
営業職	えいぎょうしょく。
営業部門	えいぎょうぶもん。
営業開始	えいぎょうかいし。
器具	きぐ。
器官	きかん。
器用	きよう。
四国	しこく。
四国地方	しこくちほう。
四字熟語	よじじゅくご。
四季	しき。
四年生	よねんせい。
四択問題	よんたくもんだい。
四捨五入	ししゃごにゅう。
四方八方	しほうはっぽう。
四日	よっか。
四月	しがつ。
四苦八苦	しくはっく。
四角	しかく。
四角形	しかくけい。
回収	かいしゅう。
回復	かいふく。
回想	かいそう。
回数	かいすう。
回数券	かいすうけん。
回答	かいとう。
回答率	かいとうりつ。
回覧	かいらん。
回覧板	かいらんばん。
回路	かいろ。
回転	かいてん。
回転寿司	かいてんずし。
回転数	かいてんすう。
回転運動	かいてんうんどう。
因果	いんが。
因果関係	いんがかんけい。
団体	だんたい。
団体交渉権	だんたいこうしょうけん。
団体競技	だんたいきょうぎ。
団地	だんち。
団子	だんご。
団結	だんけつ。
団長	だんちょう。
困惑	こんわく。
困難	こんなん。
図工	ずこう。
図形	ずけい。
図星	ずぼし。
図書	としょ。
図書券	としょけん。
図書室	としょしつ。
図書館	としょかん。
図案	ずあん。
図画	ずが。
図画工作	ずがこうさく。
図表	ずひょう。
図解	ずかい。
図鑑	ずかん。
図面	ずめん。
固体	こたい。
固定	こてい。
固定観念	こていかんねん。
固定資産税	こていしさんぜい。
固定電話	こていでんわ。
固形	こけい。
固形燃料	こけいねんりょう。
固形物	こけいぶつ。
固有	こゆう。
固有名詞	こゆうめいし。
国交	こっこう。
国交正常化	こっこうせいじょうか。
国交正常化交渉	こっこうせいじょうかこうしょう。
国会図書館	こっかいとしょかん。
国会議事堂	こっかいぎじどう。
国会議員	こっかいぎいん。
国会運営	こっかいうんえい。
国債依存度	こくさいいぞんど。
国債発行残高	こくさいはっこうざんだか。
国債発行額	こくさいはっこうがく。
国内	こくない。
国内工場	こくないこうじょう。
国内市場	こくないしじょう。
国内生産	こくないせいさん。
国内産業	こくないさんぎょう。
国内需要	こくないじゅよう。
国勢調査	こくせいちょうさ。
国土	こくど。
国土交通省	こくどこうつうしょう。
国土地理院	こくどちりいん。
国境	こっきょう。
国境線	こっきょうせん。
国外	こくがい。
国宝	こくほう。
国家	こっか。
国家主席	こっかしゅせき。
国家公務員	こっかこうむいん。
国家公務員宿舎	こっかこうむいんしゅくしゃ。
国家公務員法	こっかこうむいんほう。
国家安全保障会議	こっかあんぜんほしょうかいぎ。
国家安全保障戦略	こっかあんぜんほしょうせんりゃく。
国家戦略特区	こっかせんりゃくとっく。
国家犯罪	こっかはんざい。
国技	こくぎ。
国政運営	こくせいうんえい。
国政選挙	こくせいせんきょ。
国旗	こっき。
国有	こくゆう。
国有企業	こくゆうきぎょう。
国有化	こくゆうか。
国歌	こっか。
国民	こくみん。
国民主権	こくみんしゅけん。
国民健康保険	こくみんけんこうほけん。
国民健康保険税	こくみんけんこうほけんぜい。
国民審査	こくみんしんさ。
国民年金	こくみんねんきん。
国民生活	こくみんせいかつ。
国民総生産	こくみんそうせいさん。
国民負担	こくみんふたん。
国王	こくおう。
国産	こくさん。
国産丸太	こくさんまるた。
国産和牛	こくさんわぎゅう。
国産小麦	こくさんこむぎ。
国益	こくえき。
国益重視	こくえきじゅうし。
国税庁	こくぜいちょう。
国立公園	こくりつこうえん。
国立劇場	こくりつげきじょう。
国立病院	こくりつびょういん。
国立競技場	こくりつきょうぎじょう。
国語	こくご。
国語辞典	こくごじてん。
国連	こくれん。
国連児童基金	こくれんじどうききん。
国連安全保障理事会	こくれんあんぜんほしょうりじかい。
国連憲章	こくれんけんしょう。
国連教育科学文化機関	こくれんきょういくかがくぶんかきかん。
国道	こくどう。
国際	こくさい。
国際交流	こくさいこうりゅう。
国際会議	こくさいかいぎ
国際価格	こくさいかかく。
国際刑事裁判所	こくさいけいじさいばんしょ。
国際化	こくさいか。
国際協調主義	こくさいきょうちょうしゅぎ。
国際原子力機関	こくさいげんしりょくきかん。
国際問題	こくさいもんだい。
国際大会	こくさいたいかい。
国際情勢	こくさいじょうせい。
国際手配	こくさいてはい。
国際条約	こくさいじょうやく。
国際機関	こくさいきかん。
国際法	こくさいほう。
国際犯罪	こくさいはんざい。
国際社会	こくさいしゃかい。
国際空港	こくさいくうこう。
国際競争	こくさいきょうそう。
国際紛争	こくさいふんそう。
国際結婚	こくさいけっこん。
国際線	こくないせん。
国際連合	こくさいれんごう。
国際都市	こくさいとし。
園児	えんじ。
園芸	えんげい。
園芸家	えんげいか。
園長	えんちょう。
土下座	どげざ。
土俵	どひょう。
土器	どき。
土地	とち。
土地代	とちだい。
土地価格	とちかかく。
土地柄	とちがら。
土手	どて。
土日	どにち。
土星	どせい。
土曜	どよう。
土曜日	どようび。
土木	どぼく。
土木工事	どぼくこうじ。
土産	みやげ。
土産話	みやげばなし。
土砂	どしゃ。
土砂災害	どしゃさいがい。
土管	どかん。
土足	どそく。
土足厳禁	どそくげんきん。
圧倒	あっとう。
圧倒的多数	あっとうてきたすう。
圧力	あつりょく。
圧力団体	あつりょくだんたい。
圧力計	あつりょくけい。
圧勝	あっしょう。
圧政	あっせい。
圧縮	あっしゅく。
圧縮機	あっしゅくき。
圧縮空気	あっしゅくくうき。
圧迫	あっぱく。
圧迫感	あっぱくかん。
在学	ざいがく。
在学証明書	ざいがくしょうめいしょ。
在宅	ざいたく。
在宅介護	ざいたくかいご。
在宅勤務	ざいたくきんむ。
在宅起訴	ざいたくきそ。
在庫	ざいこ。
在庫管理	ざいこかんり。
在校生	ざいこうせい。
地上	ちじょう。
地下	ちか。
地下室	ちかしつ。
地下水	ちかすい。
地下街	ちかがい。
地下資源	ちかしげん。
地下鉄	ちかてつ。
地中海	ちちゅうかい。
地位	ちい。
地位向上	ちいこうじょう。
地元	じもと。
地元企業	じもときぎょう。
地動説	ちどうせつ。
地名	ちめい。
地味	じみ。
地図	ちず。
地図記号	ちずきごう。
地域	ちいき。
地域再生	ちいきさいせい。
地域安定	ちいきあんてい。
地域密着型	ちいきみっちゃくがた。
地域振興	ちいきしんこう。
地域格差	ちいきかくさ。
地域活性化	ちいきかっせいか。
地域社会	ちいきしゃかい。
地域経済	ちいきけいざい。
地場産業	じばさんぎょう。
地声	じごえ。
地層	ちそう。
地帯	ちたい。
地平線	ちへいせん。
地底	ちてい。
地形	ちけい。
地方	ちほう
地方交付税	ちほうこうふきん。
地方交付税交付金	ちほうこうふぜいこうふきん。
地方公務員	ちほうこうむいん。
地方創生	ちほうそうせい。
地方気象台	ちほうきしょうだい。
地方税	ちほうぜい。
地方紙	ちほうし。
地方自治体	ちほうじちたい。
地方都市	ちほうとし。
地熱	ちねつ。
地熱発電	ちねつはつでん。
地球	ちきゅう。
地球儀	ちきゅうぎ。
地球温暖化	ちきゅうおんだんか。
地球温暖化対策	ちきゅうおんだんかたいさく。
地球環境	ちきゅうかんきょう。
地球規模	ちきゅうきぼ。
地理	ちり。
地産地消	ちさんちしょう。
地蔵	じぞう。
地表	ちひょう。
地裁	ちさい。
地道	じみち。
地雷	じらい。
地震	じしん。
地震計	じしんけい。
地面	じめん。
坂道	さかみち。
均一	きんいつ。
均整	きんせい。
均等	きんとう。
垂直	すいちょく。
垂線	すいせん。
型紙	かたがみ。
城下町	じょうかまち。
基地	きち。
基地問題	きちもんだい。
基幹産業	きかんさんぎょう。
基本	きほん。
基本問題	きほんもんだい。
基本料金	きほんりょうきん。
基本方針	きほんほうしん。
基本構造	きほんこうぞう。
基本機能	きほんきのう。
基本法	きほんほう。
基本的人権	きほんてきじんけん。
基準	きじゅん。
埼玉県	さいたまけん。
報告	ほうこく。
報告書	ほうこくしょ。
報告義務	ほうこくぎむ。
報復	ほうふく。
報道	ほうどう。
報道機関	ほうどうきかん。
報道関係者	ほうどうかんけいしゃ。
報道陣	ほうどうじん。
場内	じょうない。
場合	ばあい。
場外	じょうがい。
場所	ばしょ。
場数	ばかず。
場面	ばめん。
塩分	えんぶん。
塩加減	しおかげん。
塩気	しおけ。
塩水	しおみず。
塩田	えんでん。
塩素	えんそ。
塩酸	えんさん。
境内	けいだい。
境地	きょうち。
境界	きょうかい。
境界線	きょうかいせん。
境目	さかいめ。
墓前	ぼぜん。
墓地	ぼち。
墓場	はかば。
墓石	はかいし。
墓穴	ぼけつ。
増刊	ぞうかん。
増刊号	ぞうかんごう。
増加	ぞうか。
増加傾向	ぞうかけいこう。
増大	ぞうだい。
増水	ぞうすい。
増減	ぞうげん。
増産	ぞうさん。
増益効果	ぞうえきこうか。
増税	ぞうぜい。
増築	ぞうちく。
増進	ぞうしん。
増額	ぞうがく。
士気	しき。
声優	せいゆう。
声帯	せいたい。
声援	せいえん。
声明	せいめい。
声色	こわいろ。
声高	こわだか。
売上	うりあげ。
売上高	うりあげだか。
売値	うりね。
売切御免	うりきれごめん。
売名行為	ばいめいこうい。
売場	うりば。
売店	ばいてん。
売手	うりて。
売買	ばいばい。
売買価格	ばいばいかかく。
売買契約	ばいばいけいやく。
変人	へんじん。
変化	へんか。
変化球	へんかきゅう。
変圧器	へんあつき。
変形	へんけい。
変形性関節症	へんけいせいかんせつしょう。
変態	へんたい。
変換	へんかん。
変更	へんこう。
変更届	へんこうとどけ。
変死体	へんしたい。
変温動物	へんおんどうぶつ。
変色	へんしょく。
変装	へんそう。
変身	へんしん。
夏季	かき。
夏至	げし。
夕刊	ゆうかん。
夕方	ゆうがた。
夕日	ゆうひ。
夕食	ゆうしょく。
夕飯	ゆうめし。
外交	がいこう。
外交使節団	がいこうしせつだん。
外交官	がいこうかん。
外交政策	がいこうせいさく。
外側	そとがわ。
外出	がいしゅつ。
外務省	がいむしょう。
外国	がいこく。
外国人	がいこくじん。
外国人労働者	がいこくじんろうどうしゃ。
外国人投資家	がいこくじんとうしか。
外国人株主	がいこくじんかぶぬし。
外国人観光客	がいこくじんかんこうきゃく。
外国人選手	がいこくじんせんしゅ。
外国旅行	がいこくりょこう。
外国為替	がいこくかわせ。
外国為替取引	がいこくかわせとりひき。
外国為替市場	がいこくかわせしじょう。
外国語	がいこくご。
外来	がいらい。
外来患者	がいらいかんじゃ。
外来語	がいらいご。
外的要因	がいてきよういん。
外科	げか。
外見	がいけん。
外資系	がいしけい。
外資系企業	がいしけいきぎょう。
外部	がいぶ。
外部業者	がいぶぎょうしゃ。
外部評価委員会	がいぶひょうかいいんかい。
外食産業	がいしょくさんぎょう。
多事多難	たじたなん。
多分	たぶん。
多国籍企業	たこくせききぎょう。
多少	たしょう。
多才	たさい。
多数	たすう。
多数決	たすうけつ。
多様化	たようか。
多様性	たようせい。
多発	たはつ。
多角形	たかっけい。
多重人格	たじゅうじんかく。
多量	たりょう。
多額	たがく。
夜中	よなか。
夜景	やけい。
夜空	よぞら。
夜間	やかん。
夜間営業	やかんえいぎょう。
夢中	むちゅう。
大丈夫	だいじょうぶ。
大事	おおごと。
大人	おとな。
大人気	だいにんき。
大仏	だいぶつ。
大企業	だいきぎょう。
大会	たいかい。
大会記録	たいかいきろく。
大体	だいたい。
大作	たいさく。
大使	たいし。
大使館	たいしかん。
大便	だいべん。
大分県	おおいたけん。
大切	たいせつ。
大動脈	だいどうみゃく。
大勢	おおぜい。
大半	たいはん。
大卒	だいそつ。
大同小異	だいどうしょうい。
大名	だいみょう。
大名行列	だいみょうぎょうれつ。
大和絵	やまとえ。
大和言葉	やまとことば。
大器晩成	たいきばんせい。
大国	たいこく。
大地	だいち。
大型施設	おおがたしせつ。
大型自動車	おおがたじどうしゃ。
大声	おおごえ。
大変	たいへん。
大多数	だいたすう。
大失敗	だいしっぱい。
大学	だいがく。
大学入試	だいがくにゅうし。
大学卒業	だいがくそつぎょう。
大学教育	だいがくきょういく。
大学生	だいがくせい。
大学祭	だいがくさい。
大学進学	だいがくしんがく。
大学院	だいがくいん。
大学院生	だいがくいんせい。
大将	たいしょう。
大小	だいしょう。
大工	だいく。
大工道具	だいくどうぐ。
大差	たいさ。
大役	たいやく。
大往生	だいおうじょう。
大志	たいし。
大成功	だいせいこう。
大打撃	だいだげき。
大文字	おおもじ。
大日本帝国	だいにっぽんていこく。
大星雲	だいせいうん。
大木	たいぼく。
大東亜戦争	だいとうあせんそう。
大根	だいこん。
大正	たいしょう。
大気	たいき。
大気中	たいきちゅう。
大河小説	だいがしょうせつ。
大波	おおなみ。
大流行	だいりゅうこう。
大浴場	だいよくじょう。
大漁	たいりょう。
大物	おおもの。
大理石	だいりせき。
大男	おおおとこ。
大発見	だいはっけん。
大目	おおめ。
大目玉	おおめだま。
大筋	おおすじ。
大筋合意	おおすじごうい。
大統領	だいとうりょう。
大群	たいぐん。
大義名分	たいぎめいぶん。
大胆	だいたん。
大胆不敵	だいたんふてき。
大脳	だいのう。
大腸	だいちょう。
大臣	だいじん。
大自然	だいしぜん。
大英帝国	だいえいていこく。
大西洋	たいせいよう。
大規模	だいきぼ。
大豆	だいず。
大豆油	だいずあぶら。
大道具	おおどおぐ。
大部分	だいぶぶん。
大都会	だいとかい。
大酒	おおざけ。
大量消費	たいりょうしょうひ。
大量生産	たいりょうせいさん。
大量絶滅	たいりょうぜつめつ。
大関	おおぜき。
大阪	おおさか。
大阪府	おおさかふ。
大陸	たいりく。
大陸移動説	たいりくいどうせつ。
大雨	おおあめ。
大雪	おおゆき。
大韓民国	だいかんみんこく。
大黒柱	だいこくばしら。
天下	てんか。
天下統一	てんかとういつ。
天丼	てんどん。
天井	てんじょう。
天体	てんたい。
天体望遠鏡	てんたいぼうえんきょう。
天体観測	てんたいかんそく。
天使	てんし。
天候	てんこう。
天候不順	てんこうふじゅん。
天動説	てんどうせつ。
天命	てんめい。
天国	てんごく。
天変地異	てんぺんちい。
天女	てんにょ。
天守閣	てんしゅかく。
天安門事件	てんあんもんじけん。
天才	てんさい。
天敵	てんてき。
天文台	てんもんだい。
天気	てんき。
天気予報	てんきよほう。
天気図	てんきず。
天災	てんさい。
天然	てんねん。
天然成分	てんねんせいぶん。
天然記念物	てんねんきねんぶつ。
天然資源	てんねんしげん。
天王星	てんのうせい。
天皇	てんのう。
天皇制	てんのうせい。
天皇杯	てんのうはい。
天皇誕生日	てんのうたんじょうび。
天皇賞	てんのうしょう。
天皇陛下	てんのうへいか。
天罰	てんばつ。
太刀	たち。
太平洋	たいへいよう。
太平洋戦争	たいへいようせんそう。
太腹	ふとっぱら。
太陽	たいよう。
太陽光	たいようこう。
太陽光発電	たいようこうはつでん。
太陽暦	たいようれき。
太陽系	たいようけい。
太陽電池	たいようでんち。
夫人	ふじん。
夫妻	ふさい。
夫婦	ふうふ。
夫婦仲	ふうふなか。
夫婦円満	ふうふえんまん。
夫婦愛	ふうふあい。
失敗	しっぱい。
失敗作	しっぱいさく。
失明	しつめい。
失望	しつぼう。
失格	しっかく。
失業	しつぎょう。
失業保険	しつぎょうほけん。
失業手当	ざんぎょうてあて。
失業率	しつぎょうりつ。
失業者	しつぎょうしゃ。
失礼	しつれい。
失神	しっしん。
失言	しつげん。
奇想天外	きそうてんがい。
奇数	きすう。
奇跡	きせき。
奈良	なら。
奈良時代	ならじだい。
奈良県	ならけん。
契約	けいやく。
契約書	けいやくしょ。
契約期間	けいやくきかん。
契約社員	けいやくしゃいん。
契約農家	けいやくのうか。
奥様	おくさま。
奥歯	おくば。
女優	じょゆう。
女児	じょじ。
女医	じょい。
女子	じょし。
女子会	じょしかい。
女子大生	じょしだいせい。
女子生徒	じょしせいと。
女子高生	じょしこうせい。
女性	じょせい。
女性作家	じょせいさっか。
女性店員	じょせいてんいん。
女性歌手	じょせいかしゅ。
女性比率	じょせいひりつ。
女性登用	じょせいとうよう。
女性社員	じょせいしゃいん。
女性管理職	じょせいかんりしょく
女性芸能人	じょせいげいのうじん。
女王	じょおう。
女神	めがみ。
女風呂	おんなぶろ。
好奇心	こうきしん。
好意	こうい。
好感度	こうかんど。
好条件	こうじょうけん。
好機	こうき。
好物	こうぶつ。
好評	こうひょう。
好評発売中	こうひょうはつばいちゅう。
好調	こうちょう。
好都合	こうつごう。
妨害	ぼうがい。
妻子	さいし。
姉妹	しまい。
姉妹品	しまいひん。
始末	しまつ。
始末書	しまつしょ。
始業式	しぎょうしき。
始球式	しきゅうしき。
始発	しはつ。
始発電車	しはつでんしゃ。
始発駅	しはつえき。
始終	しじゅう。
委任状	いにんじょう。
委員	いいん。
委員会	いいんかい。
委員長	いいんちょう。
姿勢	しせい。
威力	いりょく。
威力業務妨害	いりょくぎょうむぼうがい。
威圧感	いあつかん。
威圧的	いあつてき。
婚約	こんやく。
婚約指輪	こんやくゆびわ。
婚約破棄	こんやくはき。
婚約者	こんやくしゃ。
婦人	ふじん。
婦人服	ふじんふく。
婦人用	ふじんよう。
婦女暴行	ふじょぼうこう。
子会社	こがいしゃ。
子供	こども。
子分	こぶん。
子午線	しごせん。
子孫	しそん。
子宝	こだから。
子犬	こいぬ。
子音	しいん。
字幕	じまく。
存亡	そんぼう。
存分	ぞんぶん。
存在	そんざい。
存在価値	そんざいかち。
存在意義	そんざいいぎ。
存在感	そんざいかん。
存在理由	そんざいりゆう。
存続	そんぞく。
孝行	こうこう。
季節	きせつ。
季節感	きせつかん。
季節風	きせつふう。
季語	きご。
孤児	こじ。
孤島	ことう。
孤独	こどく。
孤立	こりつ。
孤立無援	こりつむえん。
孤立状態	こりつじょうたい。
学会	がっかい。
学力	がくりょく。
学問	がくもん。
学園	がくえん。
学園祭	がくえんさい。
学年	がくねん。
学期	がっき。
学期末	がっきまつ。
学校	がっこう。
学校卒業	がっこうそつぎょう。
学校教育法	がっこうきょういくほう。
学校生活	がっこうせいかつ。
学校給食	がっこうきゅうしょく。
学業	がくぎょう。
学歴	がくれき。
学生	がくせい。
学生団体	がくせいだんたい。
学生気分	がくせいきぶん。
学生食堂	がくせいしょくどう。
学科	がっか。
学級会	がっきゅうかい。
学級委員	がっきゅういいん。
学級新聞	がっきゅうしんぶん。
学習	がくしゅう。
学習帳	がくしゅうちょう。
学習意欲	がくしゅういよく。
学習指導要領	がくしゅうしどうようりょう。
学習時間	がくしゅうじかん。
学者	がくしゃ。
学芸会	がくげいかい。
学術	がくじゅつ。
学説	がくせつ。
学識	がくしき。
学費	がくひ。
学部	がくぶ。
宅配便	たくはいびん。
宅配業者	たくはいぎょうしゃ。
宇宙	うちゅう。
宇宙旅行	うちゅうりょこう。
宇宙服	うちゅうふく。
宇宙空間	うちゅうくうかん。
宇宙船	うちゅうせん。
宇宙開発	うちゅうかいはつ。
宇宙飛行士	うちゅうひこうし。
宇宙食	うちゅうしょく。
守備	しゅび。
守秘義務	しゅひぎむ。
安住	あんじゅう。
安価	あんか。
安保理	あんぽり。
安値	やすね。
安全	あんぜん。
安全保障	あんぜんほしょう。
安全地帯	あんぜんちたい。
安全確保	あんぜんかくほ。
安全確認	あんぜんかくにん。
安全第一	あんぜんだいいち。
安全策	あんぜんさく。
安全管理	あんぜんかんり。
安全管理体制	あんぜんかんりたいせい。
安全装置	あんぜんそうち。
安全資産	あんぜんしさん。
安全通貨	あんぜんつうか。
安否	あんぴ。
安否不明	あんぴふめい。
安否情報	あんぴじょうほう。
安否確認	あんぴかくにん。
安定	あんてい。
安定供給	あんていきょうきゅう。
安定感	あんていかん。
安定財源	あんていざいげん。
安心	あんしん。
安心感	あんしんかん。
安打	あんだ。
安易	あんい。
安月給	やすげっきゅう。
安楽死	あんらくし。
安物	やすもの。
安産	あんざん。
安眠	あんみん。
安静	あんせい。
完了	かんりょう。
完備	かんび。
完全	かんぜん。
完全個室	かんぜんこしつ。
完全子会社	かんぜんこがいしゃ。
完全民営化	かんぜんみんえいか。
完全犯罪	かんぜんはんざい。
完全試合	かんぜんしあい。
完成	かんせい。
完成予定図	かんせいよていず。
完成予想図	かんせいよそうず。
完成品	かんせいひん。
完成度	かんせいど。
完敗	かんぱい。
完結	かんけつ。
完結編	かんけつへん。
完走	かんそう。
宗教	しゅうきょう。
宗教家	しゅうきょうか。
宗教改革	しゅうきょうかいかく。
宗教法人	しゅうきょうほうじん。
宗教画	しゅうきょうが。
宗教警察	しゅうきょうけいさつ。
宗教音楽	しゅうきょうおんがく。
官公庁	かんこうちょう。
定休日	ていきゅうび。
定住	ていじゅう。
定例会見	ていれいかいけん。
定価	ていか。
定刻	ていこく。
定員	ていいん。
定年	ていねん。
定年退職	ていねんたいしょく。
定数	ていすう。
定数削減	ていすうさくげん。
定期	ていき。
定期便	ていきびん。
定期券	ていきけん。
定期報告	ていきほうこく。
定期検診	ていきけんしん。
定期点検	ていきてんけん。
定期預金	ていきよきん。
定番	ていばん。
定番商品	ていばんしょうひん。
定着	ていちゃく。
定義	ていぎ。
定規	じょうぎ。
定評	ていひょう。
宝島	たからじま。
宝庫	ほうこ。
宝物	たからもの。
宝石	ほうせき。
宝船	たからぶね。
実体	じったい。
実体経済	じったいけいざい。
実体験	じったいけん。
実力	じつりょく。
実力者	じつりょくしゃ。
実力行使	じつりょくこうし。
実名	じつめい。
実在	じつざい。
実家	じっか。
実感	じっかん。
実態	じったい。
実態調査	じったいちょうさ。
実戦	じっせん。
実業家	じつぎょうか。
実権	じっけん。
実況	じっきょう。
実演	じつえん。
実物	じつぶつ。
実物大	じつぶつだい。
実現	じつげん。
実現可能	じつげんかのう。
実用	じつよう。
実用化	じつようか。
実用化試験	じつようかしけん。
実用新案	じつようしんあん。
実用的	じつようてき。
実線	じっせん。
実績	じっせき。
実習	じっしゅう。
実行	じっこう。
実行力	じっこうりょく。
実行委員会	じっこういいんかい。
実証	じっしょう。
実話	じつわ。
実費	じっぴ。
実質	じっしつ。
実質成長率	じっしつせいちょうりつ。
実質賃金	じっしつちんぎん。
実際	じっさい。
実験	じっけん。
実験台	じっけんだい
実験材料	じっけんざいりょう。
客室	きゃくしつ。
客席	きゃくせき。
客観的	きゃっかんてき。
客観的事実	きゃっかんてきじじつ。
客足	きゃくあし。
客間	きゃくま。
宣伝	せんでん。
宣伝効果	せんでんこうか。
宣告	せんこく。
宣戦布告	せんせんふこく。
宣教師	せんきょうし。
宣言	せんげん。
室内	しつない。
室内競技	しつないきょうぎ。
室町幕府	むろまちばくふ。
室町時代	むろまちじだい。
宮内庁	くないちょう。
宮城県	みやぎけん。
宮崎牛	みやざきぎゅう。
宮崎県	みやざきけん。
宮殿	きゅうでん。
害悪	がいあく。
害虫	がいちゅう。
害虫駆除	がいちゅうくじょ。
家事	かじ。
家具	かぐ。
家内	かない。
家出	いえで。
家宝	かほう。
家庭	かてい。
家庭内暴力	かていないぼうりょく。
家庭内離婚	かていないりこん。
家庭教師	かていきょうし。
家庭料理	かていりょうり。
家庭科	かていか。
家庭菜園	かていさいえん。
家庭裁判所	かていさいばんしょ。
家庭訪問	かていほうもん。
家政婦	かせいふ。
家族	かぞく。
家族会議	かぞくかいぎ。
家族全員	かぞくぜんいん。
家族旅行	かぞくりょこう。
家族計画	かぞくけいかく。
家族関係	かぞくかんけい。
家来	けらい。
家系図	かけいず。
家計	かけい。
家計簿	かけいぼ。
家訓	かくん。
家財道具	かざいどうぐ。
家賃	やちん。
家電	かでん。
家電量販店	かでんりょうはんてん。
容体	ようたい。
容器	ようき。
容姿	ようし。
容易	ようい。
容疑	ようぎ。
容疑者	ようぎしゃ。
容積	ようせき。
宿命	しゅくめい。
宿敵	しゅくてき。
宿泊客	しゅくはくきゃく。
宿題	しゅくだい。
寄付	きふ。
寄付金	きふきん。
寄港	きこう。
寄生	きせい。
密入国	みつにゅうこく。
密告	みっこく。
密告者	みっきょくしゃ。
密室	みっしつ。
密度	みつど。
密接	みっせつ。
密林	みつりん。
密漁	みつりょう。
密漁船	みつりょうせん。
密約	みつやく。
密輸	みつゆ。
密閉	みっぺい。
密閉容器	みっぺいようき。
密集	みっしゅう。
富国強兵	ふこくきょうへい。
富士山	ふじさん。
富山県	とやまけん。
寒冷前線	かんれいぜんせん。
寒天	かんてん。
寒暖	かんだん。
寒気	さむけ。
寒波	かんぱ。
寒流	かんりゅう。
寒空	さむぞら。
察知	さち。
審判員	しんぱんいん。
寸分	すんぶん。
寸前	すんぜん。
寸法	すんぽう。
寺子屋	てらこや。
寺院	じいん。
対処	たいしょ。
対処方法	たいしょほうほう。
対処法	たいしょほう。
対向車線	たいこうしゃせん。
対局	たいきょく。
対岸	たいがん。
対応	たいおう。
対応機種	たいおうきしゅ。
対戦	たいせん。
対戦成績	たいせんせいせき。
対戦相手	たいせんあいて。
対抗手段	たいこうしゅだん。
対日感情	たいにちかんじょう。
対比	たいひ。
対決	たいけつ。
対流	たいりゅう。
対照	たいしょう。
対称	たいしょう。
対立	たいりつ。
対等	たいとう。
対策	たいさく。
対策会議	たいさくかいぎ。
対角線	たいかくせん。
対話	たいわ。
対話集会	たいわしゅうかい。
対談	たいだん。
対象	たいしょう。
対象商品	たいしょうしょうひん。
対象者	たいしょうしゃ。
対象車種	たいしょうしゃしゅ。
対面	たいめん。
寿司	すし。
寿命	じゅみょう。
封建制度	ほうけんせいど。
封建社会	ほうけんしゃかい。
封筒	ふうとう。
専念	せんねん。
専用	せんよう。
専用回線	せんようかいせん。
専用機	せんようき。
専門	せんもん。
専門分野	せんもんぶんや。
専門医	せんもんい。
専門学校	せんもんがっこう。
専門家	せんもんか。
専門書	せんもんしょ。
専門用語	せんもんようご。
射撃	しゃげき。
射殺	しゃさつ。
将来	しょうらい。
将来像	しょうらいぞう。
将来性	しょうらいせい。
将軍	しょうぐん。
尊厳	そんげん。
尊敬	そんけい。
尊敬語	そんけいご。
尊重	そんちょう。
導体	どうたい。
導入	どうにゅう。
導火線	どうかせん。
小中一貫教育	しょうちゅういっかんきょういく。
小人	こびと。
小便	しょうべん。
小児科	しょうにか。
小児科医	しょうにかい。
小刀	こがたな。
小切手	こぎって。
小判	こばん。
小包	こづつみ。
小型	こがた。
小型化	こがたか。
小型自動車	こがたじどうしゃ。
小型車	こがたしゃ。
小型飛行機	こがたひこうき。
小声	こごえ。
小売価格	こうりかかく。
小売店	こうりてん。
小学校	しょうがっこう。
小学校低学年	しょうがっこうていがくねん。
小学校高学年	しょうがっこうこうがくねん。
小学生	しょうがくせい。
小屋	こや。
小川	おがわ。
小惑星	しょうわくせい。
小指	こゆび。
小数点	しょうすうてん。
小文字	こもじ。
小枝	こえだ。
小柄	こがら。
小皿	こざら。
小脳	しょうのう。
小腸	しょうちょう。
小規模	しょうきぼ。
小言	こごと。
小説	しょうせつ。
小説家	しょうせつか。
小豆	あずき。
小走	こばしり。
小道具	こどうぐ。
小選挙区	しょうせんきょく。
小銭	こぜに。
小雨	こさめ。
小額投資非課税制度	しょうがくとうしひかぜいせいど。
小骨	こぼね。
小鳥	ことり。
小麦	こむぎ。
小麦粉	こむぎこ。
小麦色	こむぎいろ。
少女	しょうじょ。
少子化	しょうしか。
少子化対策	しょうしかたいさく。
少子高齢化	しょうしこうれいか。
少年	しょうねん。
少年時代	しょうねんじだい。
少年法	しょうねんほう。
少年犯罪	しょうねんはんざい。
少年野球	しょうねんやきゅう。
少年院	しょうねんいん。
少数	しょうすう。
少数意見	しょうすういけん。
少数民族	しょうすうみんぞく。
少数派	しょうすうは。
少量	しょうりょう。
少量生産	しょうりょうせいさん。
少額	しょうがく。
少食	しょうしょく。
就任	しゅうにん。
就活	しゅうかつ。
就活生	しゅうかつせい。
就職	しゅうしょく。
就職内定率	しゅうしょくないていりつ。
就職志願者	しゅうしょくしがんしゃ。
就職氷河期	しゅうしょくひょうがき。
就職活動	しゅうしょくかつどう。
就職率	しゅうしょくりつ。
就職試験	しゅうしょくしけん。
就職説明会	しゅうしょくせつめいかい。
尺八	しゃくはち。
尺度	しゃくど。
局員	きょくいん。
局部	きょくぶ。
局長	きょくちょう。
局面	きょくめん。
居候	いそうろう。
居場所	いばしょ。
居心地	いごこち。
居所	いどころ。
居留守	いるす。
居酒屋	いざかや。
居間	いま。
屈折	くっせつ。
屈折率	くっせつりつ。
届出	とどけで。
屋上	おくじょう。
屋内	おくない。
屋台	やたい。
屋台骨	やたいぼね。
屋外	おくがい。
屋根	やね。
屋根裏	やねうら。
屋根裏部屋	やねうらべや。
展望	てんぼう。
展望台	てんぼうだい。
展示	てんじ。
展示会	てんじかい。
展示品	てんじひん。
展示場	てんじじょう。
展覧会	てんらんかい。
展開	てんかい。
展開図	てんかいず。
属国	ぞっこく。
属性	ぞくせい。
山中	さんちゅう。
山口県	やまぐちけん。
山場	やまば。
山小屋	やまごや。
山形県	やまがたけん。
山林	さんりん。
山梨県	やまなしけん。
山河	さんが。
山火事	やまかじ。
山積	さんせき。
山脈	さんみゃく。
山菜	さんさい。
山車	だし。
山道	やまみち。
山里	やまざと。
山頂	さんちょう。
岐阜県	ぎふけん。
岡山県	おかやまけん。
岩場	いわば。
岩塩	がんえん。
岩山	いわやま。
岩手県	いわてけん。
岩石	がんせき。
岩穴	いわあな。
岸辺	きしべ。
島国	しまぐに。
島根県	しまねけん。
崩壊	ほうかい。
崩御	ほうぎょ。
川下	かわしも。
川原	かわら。
川岸	かわぎし。
川底	かわぞこ。
巣箱	すばこ。
工事	こうじ。
工作	こうさく。
工作員	こうさくいん。
工作機械	こうさくきかい。
工具	こうぐ。
工場	こうじょう。
工場排水	こうじょうはいすい。
工場見学	こうじょうけんがく。
工夫	くふう。
工期短縮	こうきたんしゅく。
工業	こうぎょう。
工業団地	こうぎょうだんち。
工業地帯	こうぎょうちたい。
工程	こうてい。
工面	くめん。
左右	さゆう。
左右対称	さゆうたいしょう。
左手	ひだりて。
左折	させつ。
左足	ひだりあし。
巨人	きょじん。
巨体	きょたい。
巨大	きょだい。
巨大地震	きょだいじしん。
巨大市場	きょだいしじょう。
巨額	きょがく。
差別	さべつ。
差別意識	さべついしき。
差額	さがく。
巻尺	まきじゃく。
巻物	まきもの。
巻貝	まきがい。
市場	しじょう。
市場万能主義	しじょうばんのうしゅぎ。
市場予想	しじょうよそう。
市場価格	しじょうかかく。
市場原理	しじょうげんり。
市場安定	しじょうあんてい。
市場競争	しじょうきょうそう。
市場規模	しじょうきぼ。
市場調査	しじょうちょうさ。
市場関係者	しじょうかんけいしゃ。
市外局番	しがいきょくばん。
市役所	しやくしょ。
市民	しみん。
市民参加	しみんさんか。
市民団体	しみんだんたい。
市民団体代表	しみんだんたいだいひょう。
市民権	しみんけん。
市民病院	しみんびょういん。
市民社会	しみんしゃかい。
市民運動	しみんうんどう。
市民階級	しみんかいきゅう。
市町村	しちょうそん。
市立	しりつ。
市街地	しがいち。
市販	しはん。
市販品	しはんひん。
市長	しちょう。
布団	ふとん。
布地	ぬのじ。
布教活動	ふきょうかつどう。
希少	きしょう。
希少価値	きしょうかち。
希望	きぼう。
希望小売価格	きぼうこうりかかく。
希望校	きぼうこう。
希望的観測	きぼうてきかんそく
希望者	きぼうしゃ。
希望退職	きぼうたいしょく。
帝国	ていこく。
師弟	してい。
師弟関係	していかんけい。
席順	せきじゅん。
帯分数	たいぶんすう。
帯状	たいじょう。
帯電	たいでん。
帰国	きこく。
帰宅	きたく。
帰省	きせい。
常夏	とこなつ。
常時	じょうじ。
常温	じょうおん。
常用漢字	じょうようかんじ。
常緑樹	じょうりょくじゅ。
常識	じょうしき。
常連	じょうれん。
常連客	じょうれんきゃく。
幕府	ばくふ。
干害	かんがい。
干渉	かんしょう。
干物	ひもの。
平仮名	ひらがな。
平原	へいげん。
平和	へいわ。
平和主義	へいわしゅぎ。
平和主義者	へいわしゅぎしゃ。
平和国家	へいわこっか。
平和憲法	へいわけんぽう。
平和賞	へいわしょう。
平地	へいち。
平均	へいきん。
平均価格	へいきんかかく。
平均値	へいきんち。
平均台	へいきんだい。
平均寿命	へいきんじゅみょう。
平均年齢	へいきんねんれい。
平均所得	へいきんしょとく。
平均株価	へいきんかぶか。
平均点	へいきんてん。
平均賃金	へいきんちんぎん。
平安	へいあん。
平安京	へいあんきょう。
平安時代	へいあんじだい。
平屋	ひらや。
平常心	へいじょうしん。
平年	へいねん。
平成	へいせい。
平方根	へいほうこん。
平日	へいじつ。
平時	へいじ。
平氏	へいし。
平気	へいき。
平然	へいぜん。
平熱	へいねつ。
平等	びょうどう。
平行四辺形	へいこうしへんけい。
平行棒	へいこうぼう。
平野	へいや。
平面	へいめん。
平面図	へいめんず。
年上	としうえ。
年上女性	としうえじょせい。
年上男性	としうえだんせい。
年下	としした。
年下女性	とししたじょせい。
年下男性	とししただんせい。
年中	ねんじゅう。
年功序列	ねんこうじょれつ。
年収	ねんしゅう。
年号	ねんごう。
年始	ねんし。
年度	ねんど。
年月	ねんげつ。
年月日	ねんがっぴ。
年末	ねんまつ。
年末年始	ねんまつねんし。
年表	ねんぴょう。
年賀状	ねんがじょう。
年賀葉書	ねんがはがき。
年輪	ねんりん。
年金	ねんきん。
年金制度	ねんきんせいど。
年間	ねんかん。
年間売上高	ねんかんうりあげだか。
年間指導計画	ねんかんしどうけいかく。
年間消費量	ねんかんしょうひりょう。
年齢	ねんれい。
年齢制限	ねんれいせいげん。
幸福	こうふく。
幸運	こううん。
幹事	かんじ。
幹事長	かんじちょう。
幹線	かんせん。
幹線道路	かんせんどうろ。
幻影	げんえい。
幻想	げんそう。
幻覚	げんかく。
幼児	ようじ。
幼児教育	ようじきょういく。
幼児期	ようじき。
幼児語	ようじご。
幼少期	ようしょうき。
幼心	おさなごころ。
幼虫	ようちゅう。
広告	こうこく。
広告主	こうこくぬし。
広告媒体	こうこくばいたい。
広告掲載	こうこくけいさい。
広場	ひろば。
広大	こうだい。
広島弁	ひろしまべん。
広島県	ひろしまけん。
広範囲	こうはんい。
広葉樹	こうようじゅ。
広野	へいや。
広間	ひろま。
床面積	ゆかめんせき。
序列	じょれつ。
底力	そこぢから。
底辺	ていへん。
底面	ていめん。
店員	てんいん。
店番	みせばん。
店頭	てんとう。
店頭価格	てんとうかかく。
府知事	ふちじ。
度外視	どがいし。
度胸	どきょう。
座右	ざゆう。
座布団	ざぶとん。
座席	ざせき。
座席番号	ざせきばんごう。
座席表	ざせきひょう。
座視	ざし。
座談会	ざだんかい。
庭園	ていえん。
庭石	にわいし。
廃品回収	はいひんかいしゅう。
延期	えんき。
延焼	えんしょう。
延長	えんちょう。
延長戦	えんちょうせん。
建前	たてまえ。
建国	けんこく。
建国記念	けんこくきねん。
建物	たてもの。
建物面積	たてものめんせき。
建築	けんちく。
建築家	けんちくか。
建築工事	けんちくこうじ。
建築業	けんちくぎょう。
建築物	けんちくぶつ。
建設	けんせつ。
建設予定地	けんせつよていち。
建設会社	けんせつがいしゃ。
建設工事	けんせつこうじ。
建設業	けんせつぎょう。
建設機械	けんせつきかい。
建設的議論	けんせつてきぎろん。
建設計画	けんせつけいかく。
建設費用	けんせつひよう。
建造物	けんぞうぶつ。
弁当	べんとう。
弁当屋	べんとうや。
弁当箱	べんとうばこ。
弁明	べんめい。
弁解	べんかい。
弁護	べんご。
弁護士	べんごし。
式場	しきじょう。
式辞	しきじ。
弓形	ゆみがた。
弓矢	ゆみや。
弓道	きゅうどう。
弓道部	きゅうどうぶ。
引力	いんりょく。
引火	いんか。
引用	いんよう。
引退	いんたい。
弟子	でし。
弱体化	じゃくたいか。
弱気	よわき。
弱点	じゃくてん。
弱者	じゃくしゃ。
弱肉強食	じゃくにくきょうしょく。
弱虫	よわむし。
弱音	よわね。
張本人	ちょうほんにん。
強制	きょうせい。
強制労働	きょうせいろうどう。
強制収容所	きょうせいしゅうようじょ。
強制排除	きょうせいはいじょ。
強力	きょうりょく。
強化	きょうか。
強固	きょうこ。
強大	きょうだい。
強度	きょうど。
強引	ごういん。
強弱	きょうじゃく。
強情	ごうじょう。
強敵	きょうてき。
強気	つよき。
強盗	ごうとう。
強盗事件	ごうとうじけん。
強盗殺人事件	ごうとうさつじんじけん。
強行	きょうこう。
当事者	とうじしゃ。
当分	とうぶん。
当日	とうじつ。
当時	とうじ。
当然	とうぜん。
当番	とうばん。
当選	とうせん。
当選番号	とうせんばんごう。
当選発表	とうせんはっぴょう。
形勢	けいせい。
形容詞	けいようし。
形式的	けいしきてき。
形状	けいじょう。
形状記憶合金	けいじょうきおくごうきん。
形見	かたみ。
影武者	かげむしゃ。
影絵	かげえ。
役不足	やくぶそく。
役人	やくにん。
役割	やくわり。
役割分担	やくわりぶんたん。
役所	やくしょ。
役目	やくめ。
役者	やくしゃ。
往復	おうふく。
往復切符	おうふくきっぷ。
往生	おうじょう。
往生際	おうじょうぎわ。
征服	せいふく。
待合室	まちあいしつ。
待望	たいぼう。
待機	たいき。
待機児童	たいきじどう。
後世	こうせい。
後光	ごこう。
後半	こうはん。
後半戦	こうはんせん。
後味	あとあじ。
後始末	あとしまつ。
後姿	うしろすがた。
後方	こうほう。
後方確認	こうほうかくにん。
後日	ごじつ。
後期高齢者	こうきこうれいしゃ。
後継者	こうけいしゃ。
後足	うしろあし。
後退	こうたい。
後進国	こうしんこく。
後遺症	こういしょう。
後頭部	こうとうぶ。
徒歩	とほ。
徒競走	ときょうそう。
従事	じゅうじ。
従来	じゅうらい。
従来方式	じゅうらいほうしき。
従業員	じゅうぎょういん。
従順	じゅうじゅん。
得体	えたい。
得意	とくい。
得意先	とくいさき。
得意技	とくいわざ。
得点	とくてん。
御中	おんちゅう。
御利益	ごりやく。
御役所仕事	おやくしょしごと。
御用学者	ごようがくしゃ。
御都合主義	ごつごうしゅぎ。
御飯	ごはん。
復元	ふくげん。
復刻版	ふっこくばん。
復旧	ふっきゅう。
復活	ふっかつ。
復習	ふくしゅう。
復興	ふっこう。
徳島県	とくしまけん。
徳用	とくよう。
徳用品	とくようひん。
心不全	しんふぜん。
心中	しんじゅう。
心労	しんろう。
心地	ここち。
心境	しんきょう。
心外	しんがい。
心得	こころえ。
心情	しんじょう。
心機一転	しんきいってん。
心理	しんり。
心理学	しんりがく。
心肺停止	しんぱいていし。
心臓	しんぞう。
心臓病	しんぞうびょう。
心臓発作	しんぞうほっさ。
心身	しんしん。
心配	しんぱい。
心配事	しんぱいごと。
心電図	しんでんず。
必修科目	ひっしゅうかもく。
必勝	ひっしょう。
必勝法	ひっしょうほう。
必死	ひっし。
必然	ひつぜん。
必然的	ひつぜんてき。
必着	ひっちゃく。
必至	ひっし。
必要	ひつよう。
必要不可欠	ひつようふかけつ。
必要事項	ひつようじこう。
必要性	ひつようせい。
必要条件	ひつようじょうけん。
必読	ひつどく。
必読書	ひつどくしょ。
必需品	ひつじゅひん。
志望	しぼう。
志願	しがん。
志願者	しがんしゃ。
忘却	ぼうきゃく。
忘年会	ぼうねんかい。
応募	おうぼ。
応募作品	おうぼさくひん。
応募資格	おうぼしかく。
応対	おうたい。
応戦	おうせん。
応接室	おうせつしつ。
応接間	おうせつま。
応援	おうえん。
応援団	おうえんだん。
応用	おうよう。
応用問題	おうようもんだい。
応用科学	おうようかがく。
応答	おうとう。
忠告	ちゅうこく。
忠実	ちゅうじつ。
忠誠	ちゅうせい。
快感	かいかん。
快挙	かいきょ。
快方	かいほう。
快晴	かいせい。
快楽	かいらく。
快調	かいちょう。
快速	かいそく。
快適	かいてき。
念仏	ねんぶつ。
念頭	ねんとう。
念願	ねんがん。
思想	しそう。
思想家	しそうか。
思想統制	しそうとうせい。
思案	しあん。
思考	しこう。
思考停止	しこうていし。
急停車	きゅうていしゃ。
急務	きゅうむ。
急増	きゅうぞう。
急所	きゅうしょ。
急死	きゅうし。
急流	きゅうりゅう。
急激	きゅうげき。
急病	きゅうびょう。
急速	きゅうそく。
急降下	きゅうこうか。
性別	せいべつ。
性同一性障害	せいどういつせいしょうがい。
性格	せいかく。
性格診断	せいかくしんだん。
性犯罪	せいはんざい。
性能	せいのう。
性質	せいしつ。
怪我	けが。
怪我人	けがにん。
怪談	かいだん。
恋人	こいびと。
恋愛	れんあい。
恋愛小説	れんあいしょうせつ。
恋愛映画	れんあいえいが。
恩人	おんじん。
恩師	おんし。
息子	むすこ。
息子夫婦	むすこふうふ。
患者	かんじゃ。
悪事	あくじ。
悪人	あくにん。
悪党	あくとう。
悪化	あっか。
悪口	わるぐち。
悪夢	あくむ。
悪天候	あくてんこう。
悪徳	あくとく。
悪意	あくい。
悪戦苦闘	あくせんくとう。
悪材料	あくざいりょう。
悪気	わるぎ。
悪玉	あくだま。
悪用	あくよう。
悪知恵	わるぢえ。
悪者	わるもの。
悪質	あくしつ。
悪運	あくうん。
悲劇	ひげき。
悲報	ひほう。
悲観	ひかん。
悲観的	ひかんてき。
悲運	ひうん。
悲願	ひがん。
悲鳴	ひめい。
情勢	じょうせい。
情報	じょうほう。
情報不足	じょうほうぶそく。
情報交換	じょうほうこうかん。
情報公開	じょうほうこうかい。
情報公開請求	じょうほうこうかいせいきゅう。
情報共有	じょうほうきょうゆう。
情報処理	じょうほうしょり。
情報化社会	じょうほうかしゃかい。
情報収集	じょうほうしゅうしゅう。
情報技術	じょうほうぎじゅつ。ＩＴ。
情報提供	じょうほうていきょう。
情報機器	じょうほうきき。
情報機関	じょうほうきかん。
情報流出	じょうほうりゅうしゅつ。
情報源	じょうほうげん。
情報発信	じょうほうはっしん。
情報管理	じょうほうかんり。
情報管理体制	じょうほうかんりたいせい。
情報通信技術	じょうほうつうしんぎじゅつ。
情報連絡室	じょうほうれんらくしつ。
情報開示	じょうほうかいじ。
情景	じょうけい。
情熱	じょうねつ。
情緒	じょうちょ。
情緒不安定	じょうちょふあんてい。
惑星	わくせい。
想像	そうぞう。
想像力	そうぞうりょく。
想定	そうてい。
想定内	そうていない。
想定外	そうていがい。
意向	いこう。
意味	いみ。
意味深長	いみしんちょう。
意図	いと。
意地	いじ。
意地悪	いじわる。
意外	いがい。
意志	いし。
意思決定	いしけってい。
意思表示	いしひょうじ。
意欲	いよく。
意気地	いくじ。
意義	いぎ。
意表	いひょう。
意見	いけん。
意見交換	いけんこうかん。
意見書	いけんしょ。
意見集約	いけんしゅうやく。
意識	いしき。
意識改革	いしきかいかく。
意識調査	いしきちょうさ。
愛国心	あいこくしん。
愛好	あいこう。
愛好家	あいこうか。
愛媛県	えひめけん。
愛情	あいじょう。
愛想	あいそ。
愛煙者	あいえんか。
愛犬	あいけん。
愛用	あいよう。
愛用者	あいようしゃ。
愛着	あいちゃく。
愛知県	あいちけん。
愛称	あいしょう。
愛読	あいどく。
愛読書	あいどくしょ。
感動	かんどう。
感度	かんど。
感心	かんしん。
感情	かんじょう。
感情移入	かんじょういにゅう。
感想	かんそう。
感想文	かんそうぶん。
感染	かんせん。
感染拡大	かんせんかくだい。
感染源	かんせんげん。
感染確認	かんせんかくにん。
感染経路	かんせんけいろ。
感激	かんげき。
感覚	かんかく。
感触	かんしょく。
感謝	かんしゃ。
感謝状	かんしゃじょう。
感電	かんでん。
感電死	かんでんし。
態度	たいど。
慣例	かんれい。
慣用句	かんようく。
憲法	けんぽう。
憲法改正	けんぽうかいせい。
憲法解釈	けんぽうかいしゃく。
憲法解釈変更	けんぽうかいしゃくへんこう。
憲法記念日	けんぽうきねんび。
憲法違反	けんぽういはん。
成人	せいじん。
成人式	せいじんしき。
成仏	じょうぶつ。
成分	せいぶん。
成功	せいこう。
成功体験	せいこうたいけん。
成功例	せいこうれい。
成果	せいか。
成果主義	せいかしゅぎ。
成立	せいりつ。
成績	せいせき。
成績優秀	せいせきゆうしゅう。
成績表	せいせきひょう。
成虫	せいちゅう。
成金	なりきん。
成長	せいちょう。
成長分野	せいちょうぶんや。
成長戦略	せいちょうせんりゃく。
成長物語	せいちょうものがたり。
成長率目標	せいちょうりつもくひょう。
成長産業	せいちょうさんぎょう。
我慢	がまん。
我流	がりゅう。
我田引水	がでんいんすい。
戦乱	せんらん。
戦争	せんそう。
戦争犯罪	せんそうはんざい。
戦力	せんりょく。
戦国時代	せんごくじだい。
戦場	せんじょう。
戦後	せんご。
戦後民主主義	せんごみんしゅしゅぎ。
戦時	せんじ。
戦死者	せんししゃ。
戦略家	せんりゃくか。
戦術	せんじゅつ。
戦車	せんしゃ。
戸別訪問	こべつほうもん。
戸籍	こせき。
所在	しょざい。
所在地	しょざいち。
所属	しょぞく。
所帯	しょたい。
所得	しょとく。
所得制限	しょとくせいげん。
所得格差	しょとくかくさ。
所得税	しょとくぜい。
所持	しょじ。
所持品	しょじひん。
所持金	しょじきん。
所有権	しょゆうけん。
所有物	しょゆうぶつ。
所有者	しょゆうしゃ。
所長	しょちょう。
扇風機	せんぷうき。
手下	てした。
手作業	てさぎょう。
手元	てもと。
手先	てさき。
手加減	てかげん。
手動	しゅどう。
手口	てぐち。
手品	てじな。
手土産	てみやげ。
手帳	てちょう。
手形	てがた。
手数	てすう。
手数料	てすうりょう。
手料理	てりょうり。
手旗信号	てばたしんごう。
手本	てほん。
手段	しゅだん。
手相	てそう。
手短	てみじか。
手紙	てがみ。
手羽先	てばさき。
手芸	しゅげい。
手荷物	てにもつ。
手術	しゅじゅつ。
手術台	しゅじゅつだい。
手術室	しゅじゅつしつ。
手製	てせい。
手足	てあし。
手軽	てがる。
手配	てはい。
手鏡	てかがみ。
手間	てま。
手際	てぎわ。
手順	てじゅん。
手首	てくび。
才能	さいのう。
才色兼備	さいしょくけんび。
打撃	だげき。
打楽器	だがっき
打球	だきゅう。
打破	だは。
打者	だしゃ。
打開	だかい。
打開策	だかいさく。
打順	だじゅん。
批判	ひはん。
批評	ひひょう。
批評家	ひひょうか。
承知	しょうち。
承認	しょうにん。
技能	ぎのう。
技術	ぎじゅつ。
技術情報	ぎじゅつじょうほう。
技術者	ぎじゅつしゃ。
技術開発	ぎじゅつかいはつ。
技術面	ぎじゅつめん。
技術革新	ぎじゅつかくしん。
抑止力	よくしりょく。
抑止力維持	よくしりょくいじ。
投下	とうか。
投入	とうにゅう。
投手	とうしゅ。
投球	とうきゅう。
投票	とうひょう。
投票所	とうひょうじょ。
投票日	とうひょうび。
投票権	とうひょうけん。
投票率	とうひょうりつ。
投票用紙	とうひょうようし。
投票箱	とうひょうばこ。
投稿	とうこう。
投資	とうし。
投資家	とうしか。
投資家心理	とうしかしんり。
投資資金	とうししきん。
投身自殺	とうしんじさつ。
抗生物質	こうせいぶっしつ。
抗議	こうぎ。
抵抗勢力	ていこうせいりょく。
担任	たんにん。
担保	たんぽ。
担当	たんとう。
担当者	たんとうしゃ。
拍手	はくしゅ。
拒否	きょひ。
拒否権	きょひけん。
招待	しょうたい。
招待券	しょうたいけん。
招待客	しょうたいきゃく。
招待状	しょうたいじょう。
拝借	はいしゃく。
拝見	はいけん。
拡声器	かくせいき。
拡大	かくだい。
拡大鏡	かくだいきょう。
拡張	かくちょう。
拾得物	しゅうとくぶつ。
持久力	じきゅうりょく。
持久戦	じきゅうせん。
持参	じさん。
持参金	じさんきん。
持病	じびょう。
持続	じぞく。
指人形	ゆびにんぎょう。
指令	しれい。
指先	ゆびさき。
指名	しめい。
指名手配	しめいてはい。
指名競争入札	しめいきょうそうにゅうさつ。
指図	さしず。
指圧	しあつ。
指定	してい。
指定席	していせき。
指定廃棄物	していはいきぶつ。
指導	しどう。
指導者	しどうしゃ。
指導要領	しどうようりょう。
指揮	しき。
指揮官	しきかん。
指揮棒	しきぼう。
指揮者	しきしゃ。
指示	しじ。
指輪	ゆびわ。
挑戦者	ちょうせんしゃ。
挙動不審	きょどうふしん。
挙式	きょしき。
挙手	きゅしゅ。
振動	しんどう。
振替休日	ふりかえきゅうじつ。
振込手数料	ふりこみてすうりょう。
授乳	じゅにゅう。
授乳期	じゅにゅうき。
授業	じゅぎょう。
授業中	じゅぎょうちゅう。
授業料	じゅぎょうりょう。
授業日数	じゅぎょうにっすう。
授業時間	じゅぎょうじかん。
授賞	じゅしょう。
授賞式	じゅしょうしき。
排他的経済水域	はいたてきけいざいすいいき。
排出量	はいしゅつりょう。
排気	はいき。
排除	はいじょ。
採取	さいしゅ。
採決	さいけつ。
採点	さいてん。
採用	さいよう。
採用基準	さいようきじゅん。
採用者数	さいようしゃすう。
採用試験	さいようしけん。
採用通知書	さいようつうちしょ。
採算	さいさん。
採血	さいけつ。
採集	さいしゅう。
探偵	たんてい。
探検	たんけん。
探検家	たんけんか。
探検隊	たんけんたい。
接待	せったい。
接点	せってん。
接着	せっちゃく。
接着剤	せっちゃくざい。
接着力	せっちゃくりょく。
接続	せつぞく。
接続詞	せつぞくし。
接触	せっしょく。
接近	せっきん。
接骨医	せっこつい。
推定	すいてい。
推察	すいさつ。
推測	すいそく。
推理	すいり。
推理小説	すいりしょうせつ。
推移	すいい。
推論	すいろん。
推進	すいしん。
推進力	すいしんりょく。
掲示板	けいじばん。
掲載	けいさい。
提供	ていきょう。
提供者	ていきょうしゃ。
提出	ていしゅつ。
提出日	ていしゅつび。
提出物	ていしゅつぶつ。
提唱	ていしょう。
提案	ていあん。
提案者	ていあんしゃ。
提示	ていじ。
提言	ていげん。
換気	かんき。
換気扇	かんきせん。
換算	かんざん。
揮発	きはつ。
揮発性	きはつせい。
援助	えんじょ。
援助交際	えんじょこうさい。
損傷	そんしょう。
損失	そんしつ。
損害	そんがい。
損得	そんとく。
損益	そんえき。
携帯	けいたい。
携帯電話	けいたいでんわ。
撃退	げきたい。
撮影	さつえい。
操作	そうさ。
操縦	そうじゅう。
操縦士	そうじゅうし。
操縦席	そうじゅうせき。
支出	ししゅつ。
支出額	ししゅつがく。
支店	してん。
支度	したく。
支持	じじ。
支持団体	しじだんたい。
支持層	しじそう。
支持拡大	しじかくだい。
支持政党	しじせいとう。
支持率	しじりつ。
支持者	しじしゃ。
支援	しえん。
支援事業	しえんじぎょう。
支援制度	しえんせいど。
支柱	しちゅう。
支点	してん。
支給	しきゅう。
支配	しはい。
支配人	しはいにん。
支配者	しはいしゃ。
支障	ししょう。
支離滅裂	しりめつれつ。
改修	かいしゅう。
改修工事	かいしゅうこうじ。
改名	かいめい。
改善	かいぜん。
改善命令	かいぜんめいれい。
改心	かいしん。
改悪	かいあく。
改憲	かいけん。
改札	かいさつ。
改札機	かいさつき。
改正	かいせい。
改正案	かいせいあん。
改築	かいちく。
改良	かいりょう。
改良点	かいりょうてん。
改行	かいぎょう。
改装	かいそう。
改造	かいぞう。
改造車	かいぞうしゃ。
改革	かいかく。
改革断行	かいかくだんこう。
改革開放	かいかくかいほう。
攻撃	こうげき。
攻撃対象	こうげきたいしょう。
攻防	こうぼう。
攻防戦	こうぼうせん。
放出	ほうしゅつ。
放射冷却	ほうしゃれいきゃく。
放射性廃棄物	ほうしゃせいはいきぶつ。
放射性物質	ほうしゃせいぶっしつ。
放射線	ほうしゃせん。
放射線測定	ほうしゃせんそくてい。
放射能	ほうしゃのう。
放水	ほうすい。
放水管	ほうすいかん。
放水車	ほうすいしゃ。
放流	ほうりゅう。
放火	ほうか。
放火罪	ほうかざい。
放牧	ほうぼく。
放物線	ほうぶつせん。
放置	ほうち。
放置自転車	ほうちじてんしゃ。
放課後	ほうかご。
放送	ほうそう。
放送中	ほうそうちゅう。
放送事故	ほうそうじこ。
放送室	ほうそうしつ。
放送局	ほうそうきょく。
放送技術	ほうそうぎじゅつ。
放送時間	ほうそうじかん。
放送番組	ほうそうばんぐみ。
放送禁止	ほうそうきんし。
放電	ほうでん。
政党	せいとう。
政党交付金	せいとうこうふきん。
政党支持率	せいとうしじりつ。
政務活動費	せいむかつどうひ。
政局	せいきょく。
政府	せいふ。
政府主導	せいふしゅどう。
政府専用機	せいふせんようき。
政府系企業	せいふけいきぎょう。
政府軍	せいふぐん。
政府関係者	せいふかんけいしゃ。
政権	せいけん。
政権交代	せいけんこうたい。
政権公約	せいけんこうやく。
政権合意	せいけんごうい。
政権批判	せいけんひはん。
政権支持率	せいけんしじりつ。
政権運営	せいけんうんえい。
政治	せいじ。
政治不信	せいじふしん。
政治力学	せいじりきがく。
政治圧力	せいじあつりょく。
政治姿勢	せいじしせい。
政治学者	せいじがくしゃ。
政治家	せいじか。
政治情勢	せいじじょうせい。
政治決着	せいじけっちゃく。
政治活動	せいじかつどう。
政治的中立性	せいじてきちゅうりつせい。
政治的要求	せいじてきようきゅう。
政治経済	せいじけいざい。
政治結社	せいじけっしゃ。
政治資金収支報告書	せいじしきんしゅうしほうこくしょ。
政治資金規正法	せいじしきんきせいほう。
政界再編	せいかいさいへん。
政界引退	せいかいいんたい。
政策	せいさく。
政策課題	せいさくかだい。
政策転換	せいさくてんかん。
故人	こじん。
故意	こい。
故郷	こきょう。
故障	こしょう。
故障中	こしょうちゅう。
救世主	きゅうせいしゅ。
救出	きゅうしゅつ。
救出作業	きゅうしゅつさぎょう。
救助	きゅうじょ。
救助犬	きゅうじょけん。
救助隊	きゅうじょたい。
救命具	きゅうめいぐ。
救命救急士	きゅうめいきゅうきゅうし。
救命胴衣	きゅうめいどうい。
救急	きゅうきゅう。
救急医療	きゅうきゅういりょう。
救急車	きゅうきゅうしゃ。
救援活動	きゅうえんかつどう。
救援物資	きゅうえんぶっし。
救済	きゅうさい。
敗北	はいぼく。
敗北感	はいぼくかん。
敗因	はいいん。
敗戦	はいせん。
敗者	はいしゃ。
敗者復活戦	はいしゃふっかつせん。
教会	きょうかい。
教員免許	きょういんめんきょ。
教室	きょうしつ。
教師	きょうし。
教授	きょうじゅ。
教材	きょうざい。
教科書	きょうかしょ。
教科書検定	きょうかしょけんてい。
教育	きょういく。
教育上	きょういくじょう。
教育制度	きょういくせいど。
教育問題	きょういくもんだい。
教育委員会	きょういくいいんかい。
教育機関	きょういくきかん。
教育現場	きょういくげんば。
教育評論家	きょういくひょうろんか。
教訓	きょうくん。
教養	きょうよう。
散乱	さんらん。
散布	さんぷ。
散歩	さんぽ。
散歩道	さんぽどう。
散財	さんざい。
散髪	さんぱつ。
敬具	けいぐ。
敬意	けいい。
敬愛	けいあい。
敬礼	けいれい。
敬称	けいしょう。
敬語	けいご。
数値	すうち。
数値目標	すうちもくひょう。
数字	すうじ。
数字選択式	すうじせんたくしき。
数学	すうがく。
数式	すうしき。
数量	すうりょう。
整備	せいび。
整備工場	せいびこうじょう。
整列	せいれつ。
整数	せいすう。
整然	せいぜん。
整理	せいり。
整理券	せいりけん。
敵地	てきち。
敵対	ていたい。
敵意	てきい。
敵視	てきし。
敵軍	てきぐん。
文例	ぶんれい。
文化	ぶんか。
文化大革命	ぶんかだいかくめい。
文化祭	ぶんかさい。
文化財	ぶんかざい。
文化財保護法	ぶんかざいほごほう。
文化遺産	ぶんかいさん。
文句	もんく。
文字	もじ。
文学	ぶんがく。
文学賞	ぶんがくしょう。
文房具	ぶんぼうぐ。
文明	ぶんめい。
文明開化	ぶんめいかいか。
文末	ぶんまつ。
文法	ぶんぽう。
文章	ぶんしょう。
文節	ぶんせつ。
文脈	ぶんみゃく。
文通	ぶんつう。
文部科学大臣	もんぶかがくだいじん。
文部科学省	もんぶかがくしょう。
文集	ぶんしゅう。
料理	りょうり。
料理人	りょうりにん。
料理屋	りょうりや。
料理教室	りょうりきょうしつ。
料理研究家	りょうりけんきゅうか。
料理長	りょうりちょう。
料金	りょうきん。
料金箱	りょうきんばこ。
料金表	りょうきんひょう。
料金設定	りょうきんせってい。
斜線	しゃせん。
斜面	しゃめん。
断固反対	だんこはんたい。
断定	だんてい。
断念	だんねん。
断水	だんすい。
断然	だんぜん。
断熱性	だんねつせい。
断片	だんぺん。
断行	だんこう。
断言	だんげん。
断面	だんめん。
断食	だんじき。
新世界	しんせかい。
新人	しんじん。
新人王	しんじんおう。
新企画	しんきかく。
新体制	しんたいせい。
新作	しんさく。
新入生	しんにゅうせい。
新入社員	しんゆうしゃいん。
新制度	しんせいど。
新卒採用	しんそつさいよう。
新品	しんぴん。
新商品	しんしょうひん。
新型	しんがた。
新型車	しんがたしゃ。
新大陸	しんたいりく。
新天地	しんてんち。
新婚	しんこん。
新婚旅行	しんこんりょこう。
新学期	しんがっき。
新学習指導要領	しんがくしゅうしどうようりょう。
新年	しんねん。
新幹線	しんかんせん。
新感覚	しんかんかく。
新手	あらて。
新技術	しんぎじゅつ。
新春	しんしゅん。
新曲	しんきょく。
新月	しんげつ。
新潟県	にいがたけん。
新番組	しんばんぐみ。
新発売	しんはつばい。
新登場	しんとうじょう。
新種	しんしゅ。
新築	しんちく。
新米	しんまい。
新約聖書	しんやくせいしょ。
新素材	しんそざい。
新緑	しんりょく。
新聞	しんぶん。
新聞広告	しんぶんこうこく。
新聞折込広告	しんぶんおりこみこうこく。
新聞社	しんぶんしゃ。
新聞記事	しんぶんきじ。
新聞記者	しんぶんきしゃ。
新聞購読	しんぶんこうどく。
新興国	しんこうこく。
新芽	しんめ。
新規事業	しんきじぎょう。
新規出店	しんきしゅってん。
新規参入	しんきさんにゅう。
新規株式公開	しんきかぶしきこうかい。
新規登録	しんきとうろく。
新記録	しんきろく。
新設	しんせつ。
新調	しんちょう。
新車販売	しんしゃはんばい。
新郎	しんろう。
新顔	しんがお。
新鮮	しんせん。
方位磁石	ほういじしゃく。
方位磁針	ほういじしん。
方便	ほうべん。
方向	ほうこう。
方向指示器	ほうこうしじき。
方向転換	ほうこうてんかん。
方法	ほうほう。
方法論	ほうほうろん。
方眼紙	ほうがんし。
方程式	ほうていしき。
方言	ほうげん。
方針	ほうしん。
施政方針演説	しせいほうしんえんぜつ。
旅人	たびびと。
旅先	たびさき。
旅券	りょけん。
旅客機	りょかくき。
旅支度	たびじたく。
旅行	りょこう。
旅行先	りょこうさき。
旅行者	りょこうしゃ。
旅費	りょひ。
旅路	たびじ。
旅館	りょかん。
旗印	はたじるし。
既得権益	きとくけんえき。
日中	にっちゅう。
日中友好	にっちゅうゆうこう。
日中戦争	にっちゅうせんそう。
日中関係	にっちゅうかんけい。
日中首脳会談	にっちゅうしゅのうかいだん。
日付	ひづけ。
日光	にっこう。
日光浴	にっこうよく。
日光消毒	にっこうしょうどく。
日刊紙	にっかんし。
日和	ひより。
日和見主義	ひよりみしゅぎ。
日夜	にちや。
日常	にちじょう。
日常生活	にちじょうせいかつ。
日常英会話	にちじょうえいかいわ。
日常茶飯事	にちじょうさはんじ。
日数	にっすう。
日時	にちじ。
日時計	ひどけい。
日暮	ひぐれ。
日曜	にちよう。
日曜参観日	にちようさんかんび。
日曜大工	にちようだいく。
日曜日	にちようび。
日本	にほん。
日本一	にほんいち。
日本人	にほんじん。
日本代表	にほんだいひょう。
日本代表団	にほんだいひょうだん。
日本企業	にほんきぎょう。
日本全国	にほんぜんこく。
日本再生	にほんさいせい。
日本刀	にほんとう。
日本列島	にほんれっとう。
日本労働組合総連合会	れんごう。
日本史	にほんし。
日本商工会議所	にほんしょうこうかいぎしょ。
日本国	にほんこく。
日本国憲法	にほんこくけんぽう。
日本地図	にほんちず。
日本大使館	にほんたいしかん。
日本工業規格	にほんこうぎょうきかく。
日本放送協会	にほんほうそうきょうかい。
日本政府	にほんせいふ。
日本文学	にほんぶんがく。
日本料理	にほんりょうり。
日本新記録	にほんしんきろく。
日本旅行	にほんりょこう。
日本旅行業協会	にほんりょこうぎょうきょうかい。
日本時間	にほんじかん。
日本書紀	にほんしょき。
日本最大級	にほんさいだいきゅう。
日本株	にほんかぶ。
日本標準時	にほんひょうじゅんじ。
日本法人	にほんほうじん。
日本海	にほんかい。
日本漢字能力検定協会	にほんかんじのうりょくけんていきょうかい。
日本画	にほんが。
日本神話	にほんしんわ。
日本経済	にほんけいざい。
日本製	にほんせい。
日本製品	にほんせいひん。
日本語	にほんご。
日本語字幕	にほんごじまく。
日本語教師	にほんごきょうし。
日本語能力	にほんごのうりょく。
日本語訳	にほんごやく。
日本赤十字社	にほんせきじゅうじしゃ。
日本農林規格	にほんのうりんきかく。
日本酒	にほんしゅ。
日本銀行	にっぽんぎんこう。
日本高等学校野球連盟	にほんこうとうがっこうやきゅうれんめい。
日清戦争	にっしんせんそう。
日用品	にちようひん。
日直	にっちょく。
日程	にってい。
日章旗	にっしょうき。
日米両政府	にちべいりょうせいふ。
日米友好	にちべいゆうこう。
日米同盟	にちべいどうめい。
日米地位協定	にちべいちいきょうてい。
日系	にっけい。
日系企業	にっけいきぎょう。
日経平均株価	にっけいへいきんかぶか。
日記	にっき。
日誌	にっし。
日課	にっか。
日進月歩	にっしんげっぽ。
日銀	にちぎん。
日銀総裁	にちぎんそうさい。
日陰	ひかげ。
日露戦争	にちろせんそう。
日露関係	にちろかんけい。
日韓友好	にっかんゆうこう。
日韓国交正常化	にっかんこっこうせいじょうか。
日韓関係	にっかんかんけい。
日食	にっしょく。
旧式	きゅうしき。
旧暦	きゅうれき。
旧石器時代	きゅうせっきじだい。
早口	はやくち。
早口言葉	はやくちことば。
早合点	はやがてん。
早急	そうきゅう。
早朝	そうちょう。
早期成立	そうきせいりつ。
早期発見	そうきはっけん。
早足	はやあし。
早退	そうたい。
早速	さっそく。
昆布	こんぶ。
昆虫	こんちゅう。
昆虫採集	こんちゅうさいしゅう。
昇給	しょうきゅう。
昇進	しょうしん。
明快	めいかい。
明日	あした。
明暗	めいあん。
明治	めいじ。
明治時代	めいじじだい。
明治維新	めいじいしん。
明白	めいはく。
明確	めいかく。
明示	めいじ。
明細	めいさい。
明細書	めいさいしょ。
明言	めいげん。
明記	めいき。
昔話	むかしばなし。
星座	せいざ。
星形	ほしがた。
星条旗	せいじょうき。
星空	ほしぞら。
星雲	せいうん。
映像	えいぞう。
映写機	えいしゃき。
映画	えいが。
映画会社	えいががいしゃ。
映画化	えいがか。
映画産業	えいがさんぎょう。
映画配給	えいがはいきゅう。
映画館	えいがかん。
春一番	はるいちばん。
春分	しゅんぶん。
春夏秋冬	しゅんかしゅうとう。
春雨	はるさめ。
昨今	さっこん。
昨夜	さくや。
昨年	さくねん。
昨日	きのう。
昨晩	さくばん。
昭和	しょうわ。
昭和基地	しょうわきち。
昼夜	ちゅうや。
昼間	ひるま。
昼食	ちゅうしょく。
昼飯	ひるめし。
時世	じせい。
時事	じじ。
時事問題	じじもんだい。
時代	じだい。
時代劇	じだいげき。
時価	じか。
時価総額	じかそうがく。
時刻	じこく。
時刻表	じこくひょう。
時効	じこう。
時差	じさ。
時折	ときおり。
時期	じき。
時機	じき。
時計	とけい。
時速	じそく。
時間	じかん。
時間差攻撃	じかんさこうげき。
時間帯	じかんたい。
晩年	ばんねん。
晩御飯	ばんごはん。
晩秋	ばんしゅう。
普通選挙	ふつうせんきょ。
普通預金	ふつうよきん。
景品	けいひん。
景品表示法	けいひんひょうじほう。
景気	けいき。
景気動向指数	けいきどうこうしすう。
景気回復	けいきかいふく。
景気対策	けいきたいさく。
景気減速	けいきげんそく。
景色	けしき。
景観	けいかん。
晴天	せいてん。
暖冬	だんとう。
暖房	だんぼう。
暖流	だんりゅう。
暗号	あんごう。
暗号名	あんごうめい。
暗号文	あんごうぶん。
暗号解読	あんごうかいどく。
暗殺	あんさつ。
暗殺者	あんさつしゃ。
暗殺計画	あんさつけいかく。
暗算	あんざん。
暗記	あんき。
暗雲	あんうん。
暗黒	あんこく。
暴力	ぼうりょく
暴力団	ぼうりょくだん。
暴力団排除	ぼうりょくだんはいじょ。
暴動	ぼうどう。
暴落	ぼうらく。
暴行	ぼうこう。
暴言	ぼうげん。
暴走	ぼうそう。
暴走族	ぼうそうぞく。
暴露	ばくろ。
暴風	ぼうふう。
暴風雨	ぼうふうう。
暴飲暴食	ぼういんぼうしょく。
曜日	ようび。
曲目	きょくもく。
曲線	きょくせん。
曲芸	きょくげい。
更年期障害	こうねんきしょうがい。
更新	こうしん。
更衣室	こういしつ。
書店	しょてん。
書庫	しょこ。
書物	しょもつ。
書留	かきとめ。
書記	しょき。
書道	しょどう。
書類	しょるい。
書類送検	しょるいそうけん。
書類選考	しょるいせんこう。
最中	さいちゅう。
最低	さいてい。
最低気温	さいていきおん。
最先端技術	さいせんたんぎじゅつ。
最初	さいしょ。
最前線	さいぜんせん。
最古	さいこ。
最善	さいぜん。
最大	さいだい。
最大値	さいだいち。
最大公約数	さいだいこうやくすう。
最大瞬間風速	さいだいしゅんかんふうそく。
最大限	さいだいげん。
最小	さいしょう。
最小値	さいしょうち。
最小公倍数	さいしょうこうばいすう。
最小単位	さいしょうたんい。
最小限	さいしょうげん。
最年長	さいねんちょう。
最強	さいきょう。
最後	さいご。
最悪	さいあく。
最愛	さいあい。
最新	さいしん。
最新技術	さいしんぎじゅつ。
最期	さいご。
最短距離	さいたんきょり。
最終	さいしゅう。
最終報告	さいしゅうほうこく。
最終段階	さいしゅうだんかい。
最終調整	さいしゅうちょうせい。
最終電車	さいしゅうでんしゃ。
最良	さいりょう。
最近	さいきん。
最高	さいこう。
最高司令官	さいこうしれいかん。
最高指導者	さいこうしどうしゃ。
最高気温	さいこうきおん。
最高経営責任者	さいこうけいえいせきにんしゃ。
最高裁	さいこうさい。
最高裁判所	さいこうさいばんしょ。
最高責任者	さいこうせきにんしゃ。
最高速度	さいこうそくど。
月例報告	げつれいほうこく。
月例経済報告	げつれいけいざいほうこく。
月光	げっこう。
月刊誌	げっかんし。
月収	げっしゅう。
月夜	つきよ。
月日	つきひ。
月曜	げつよう。
月曜日	げつようび。
月末	げつまつ。
月給	げっきゅう。
月見団子	つきみだんご。
月額基本料	げつがくきほんりょう。
月食	げっしょく。
有利	ゆうり。
有刺鉄線	ゆうしてっせん。
有力	ゆうりょく。
有力者	ゆうりょくしゃ。
有効	ゆうこう。
有効成分	ゆうこうせいぶん。
有効期間	ゆうこうきかん。
有効期限	ゆうこうきげん。
有効求人倍率	ゆうこうきゅうじんばいりつ。
有名	ゆうめい。
有名人	ゆうめいじん。
有名無実	ゆうめいむじつ。
有害	ゆうがい。
有害物質	ゆうがいぶっしつ。
有志	ゆうし。
有志連合	ゆうしれんごう。
有意義	ゆういぎ。
有数	ゆうすう。
有料	ゆうりょう。
有料会員	ゆうりょうかいいん。
有望	ゆうぼう。
有権者	ゆうけんしゃ。
有機物	ゆうきぶつ。
有毒	ゆうどく。
有無	うむ。
有益	ゆうえき。
有線放送	ゆうせんほうそう。
有罪	ゆうざい。
有罪判決	ゆうざいはんけつ。
有能	ゆうのう。
有色人種	ゆうしょくじんしゅ。
有識者	ゆうしきしゃ。
有識者会議	ゆうしきしゃかいぎ。
有限会社	ゆうげんがいしゃ。
有限責任	ゆうげんせきにん。
有頂天	うちょうてん。
服役	ふくえき。
服従	ふくじゅう。
服用	ふくよう。
服装	ふくそう。
朗報	ろうほう。
朗読	ろうどく。
望遠鏡	ぼうえんきょう。
朝刊	ちょうかん。
朝市	あさいち。
朝方	あさがた。
朝日	あさひ。
朝晩	あさばん。
朝礼	ちょうれい。
朝顔	あさがお。
朝食	ちょうしょく。
朝飯	あさめし。
朝飯前	あさめしまえ。
朝鮮	ちょうせん。
朝鮮労働党	ちょうせんろうどうとう。
朝鮮半島	ちょうせんはんとう。
朝鮮民主主義人民共和国	ちょうせんみんしゅしゅぎじんみんきょうわこく。
朝鮮総連	ちょうせんそうれん。
期待	きたい。
期日前投票	きじつまえとうひょう。
期末	きまつ。
期末試験	きまつしけん。
期間	きかん。
期間限定	きかんげんてい。
期限	きげん。
木刀	ぼくとう。
木星	もくせい。
木曜	もくよう。
木曜日	もくようび。
木材	もくざい。
木材加工品	もくざいかこうひん。
木材工場	もくざいこうじょう。
木炭	もくたん。
木片	もくへん。
木目	もくめ。
木立	こだち。
木管楽器	もっかんがっき。
木箱	きばこ。
木綿	もめん。
木製	もくせい。
木製品	もくせいひん。
木造	もくぞう。
木造住宅	もくぞうじゅうたく。
木造建築	もくぞうけんちく。
木馬	もくば。
木魚	もくぎょ。
未完成	みかんせい。
未定	みてい。
未成年	みせいねん。
未承認薬	みしょうにんやく。
未明	みめい。
未来	みらい。
未来志向	みらいしこう。
未満	みまん。
未熟	みじゅく。
未知	みち。
未知数	みちすう。
未確認飛行物体	みかくにんひこうぶったい。
未納	みのう。
未経験	みけいけん。
未経験者	みけいけんしゃ。
未練	みれん。
未解決	みかいけつ。
未開	みかい。
末代	まつだい。
末子	すえっこ。
末期	まっき。
末路	まつろ。
本人確認	ほんにんかくにん。
本人確認書類	ほんにんかくにんしょるい。
本会議	ほんかいぎ。
本体	ほんたい。
本名	ほんみょう。
本命	ほんめい。
本堂	ほんどう。
本場	ほんば。
本家	ほんけ。
本屋	ほんや。
本州	ほんしゅう。
本店	ほんてん。
本当	ほんとう。
本心	ほんしん。
本性	ほんしょう。
本文	ほんぶん。
本日	ほんじつ。
本末転倒	ほんまつてんとう。
本来	ほんらい。
本格的	ほんかくてき。
本気	ほんき。
本物	ほんもの
本番	ほんばん。
本社	ほんしゃ。
本社機能	ほんしゃきのう。
本職	ほんしょく。
本能	ほんのう。
本質	ほんしつ。
本音	ほんね。
本領発揮	ほんりょうはっき。
札束	さつたば。
机上	きじょう。
材料	ざいりょう。
材料費	ざいりょうひ。
材木	ざいもく。
材質	ざいしつ。
村八分	むらはちぶ。
村民	そんみん。
村落	そんらく。
村長	そんちょう。
条件	じょうけん。
条件反射	じょうけんはんしゃ。
条例	じょうれい。
条文	じょうぶん。
条約	じょうやく。
来場者	らいじょうしゃ。
来場者数	らいじょうしゃすう。
来客	らいきゃく。
来年度	らいねんど。
来日	らいじつ。
来訪者	らいほうしゃ。
来週	らいしゅう。
東京	とうきょう。
東京一極集中	とうきょういっきょくしゅうちゅう。
東京五輪	とうきょうごりん。
東京地方裁判所	とうきょうちほうさいばんしょ。
東京地裁	とうきょうちさい。
東京大学	とうきょうだいがく。
東京証券取引所	とうきょうしょうけんとりひきじょ。
東京都	とうきょうと。
東京電力	とうきょうでんりょく。
東京駅	とうきょうえき。
東北	とうほく。
東北地方	とうほくちほう。
東大	とうだい。
東大卒	とうだいそつ。
東方見聞録	とうほうけんぶんろく。
東日本	ひがしにほん。
東日本大震災	ひがしにほんだいしんさい。
東洋	とうよう。
東洋人	とうようじん。
東海道新幹線	とうかいどうしんかんせん。
東西	とうざい。
東西南北	とうざいなんぼく。
東証株価指数	とうしょうかぶかしすう。
東部	とうぶ。
松阪牛	まつさかうし。
板前	いたまえ。
林業	りんぎょう。
枚数	まいすう。
果報	かほう。
果実	かじつ。
果樹	かじゅ。
果樹園	かじゅえん。
果物	くだもの。
枝肉	えだにく。
枝葉	えだは。
枝豆	えだまめ。
架空	かくう。
架空人物	かくうじんぶつ。
架空請求	かくうせいきゅう。
染料	せんりょう。
染物	そめもの。
査定	さてい。
栃木県	とちぎけん。
栄光	えいこう。
栄養	えいよう。
栄養不足	えいようぶそく。
栄養価	えいようか。
栄養分	えいようぶん。
栄養士	えいようし。
栄養学	えいようがく。
栄養素	えいようそ。
栄養補給	えいようほきゅう。
栄養豊富	えいようほうふ。
栄養食	えいようしょく。
校内	こうない。
校内暴力	こうないぼうりょく。
校則	こうそく。
校庭	こうてい。
校旗	こうき。
校歌	こうか。
校正	こうせい。
校舎	こうしゃ。
校長	こうちょう。
校長先生	こうちょうせんせい。
校門	こうもん。
株主	かぶぬし。
株主優待	かぶぬしゆうたい。
株主優待券	かぶぬしゆうたいけん。
株価	かぶか。
株価上昇	かぶかじょうしょう。
株取引	かぶとりひき。
株安傾向	かぶやすけいこう。
株式	かぶしき。
株式上場	かぶしきじょうじょう。
株式会社	かぶしきがいしゃ。
株式保有	かぶしきほゆう。
株式市場	かぶしきしじょう。
株式投資	かぶしきとうし。
核不拡散条約	かくふかくさんじょうやく。
核保有国	かくほゆうこく。
核兵器	かくへいき。
核兵器禁止条約	かくへいききんしじょうやく。
核実験	かくじっけん。
核家族化	かくかぞくか。
核武装	かくぶそう。
核燃料	かくねんりょう。
核開発	かくかいはつ。
核開発問題	かくかいはつもんだい。
根元	ねもと。
根底	こんてい。
根性	こんじょう。
根拠	こんきょ。
根本	こんぽん。
根比	こんくらべ。
根気	こんき。
根源	こんげん。
根絶	こんぜつ。
格好	かっこう。
格安	かくやす。
格安航空会社	かくやくこうくうがいしゃ。
格差	かくさ。
格差是正	かくさぜせい。
格差社会	かくさしゃかい。
格段	かくだん。
格納庫	かくのうこ。
格言	かくげん。
格調	かくちょう。
格闘家	かくとうか。
案内	あんない。
案内人	あんないにん。
案内図	あんないず。
案内所	あんないじょ。
案内状	あんないじょう。
案外	あんがい。
梅酒	うめしゅ。
梅雨	ばいう。
梅雨前線	ばいうぜんせん。
森林	しんりん。
森林浴	しんりんよく。
森林火災	しんりんかさい。
森林破壊	しんりんはかい。
森林管理	しんりんかんり。
植木	うえき。
植林	しょくりん。
植樹	しょくじゅ。
植民地	しょくみんち。
植物	しょくぶつ。
植物人間	しょくぶつにんげん。
植物工場	しょくぶつこうじょう。
植物性	しょくぶつせい。
植物油	しょくぶつあぶら。
植物由来成分	しょくぶつゆらいせいぶん。
検出	けんしゅつ。
検問所	けんもんじょ。
検定	けんてい。
検定試験	けんていしけん。
検察官	けんさつかん。
検挙	けんきょ。
検査	けんさ。
検査機器	けんさきき。
検温	けんおん。
検算	けんざん。
検討	けんとう。
検討中	けんとうちゅう。
検証	けんしょう。
検証作業	けんしょうさぎょう。
検証実験	けんしょうじっけん。
業務	ぎょうむ。
業務上横領罪	ぎょうむじょうおうりょうざい。
業務上過失	ぎょうむじょうかしつ。
業務停止	ぎょうむていし。
業務妨害	ぎょうむぼうがい。
業務妨害罪	ぎょうむぼうがいざい。
業務拡大	ぎょうむかくだい。
業務改善命令	ぎょうむかいぜんめいれい。
業務連携	ぎょうむれんけい。
業界	ぎょうかい。
業界関係者	ぎょうかいかんけいしゃ。
業種	ぎょうしゅ。
業績	ぎょうせき。
業績不振	ぎょうせきふしん。
業績予想	ぎょうせきよそう。
業者	ぎょうしゃ。
極力	きょくりょく。
極寒	ごっかん。
極度	きょくど。
極悪	ごくあく。
極意	ごくい。
極楽	ごくらく。
極秘	ごくひ。
極端	きょくたん。
極限	きょくげん。
楽勝	らくしょう。
楽器	がっき。
楽器店	がっきてん。
楽団	がくだん。
楽園	らくえん。
楽天的	らくてんてき。
楽屋	がくや。
楽市楽座	らくいちらくざ。
楽曲	がっきょく。
楽章	がくしょう。
楽観的	らっかんてき。
構内	こうない。
構図	こうず。
構想	こうそう。
構成	こうせい。
構造	こうぞう。
構造改革	こうぞうかいかく。
様子	ようす。
様式	ようしき。
標本	ひょうほん。
標準	ひょうじゅん。
標準語	ひょうじゅんご。
標的	ひょうてき。
標高	ひょうこう。
模写	もしゃ。
模型	もけい。
模型飛行機	もけいひこうき。
模様	もよう。
模索	もさく。
権利	けんり。
権力	けんりょく。
権力闘争	けんりょくとうそう。
権威	けんい。
権威主義	けんいしゅぎ。
横文字	よこもじ。
横断	おうだん。
横断歩道	おうだんほどう。
横目	よこめ。
横着	おうちゃく。
横笛	よこぶえ。
横糸	よこいと。
横綱	よこづな。
横行	おうこう。
横転	おうてん。
横道	よこみち。
横領	おうりょう。
横領罪	おうりょうざい。
横顔	よこがお。
樹齢	じゅれい。
樹木	じゅもく。
樹氷	じゅひょう。
樹海	じゅかい。
樹液	じゅえき。
樹立	じゅりつ。
機会	きかい。
機密	きみつ。
機密情報	きみつじょうほう。
機密費	きみつひ。
機械	きかい。
機械化	きかいか。
機械油	きかいあぶら。
機織	はたおり。
機能	きのう。
機能性	きのうせい。
機長	きちょう。
機関投資家	きかんとうしか。
機関誌	きかんし。
機関車	きかんしゃ。
欠勤	けっきん。
欠場	けつじょう。
欠席	けっせき。
欠席届	けっせきとどけ。
欠点	けってん。
欠航	けっこう。
次世代	じせだい。
次元	じげん。
次回	じかい。
次女	じじょ。
次男	じなん。
次第	しだい。
欧州	おうしゅう。
欧州中央銀行	おうしゅうちゅうおうぎんこう。
欧州経済	おうしゅうけいざい。
欧州連合	おうしゅうれんごう。
欧米	おうべい。
欲望	よくぼう。
欲求	よっきゅう。
欲求不満	よっきゅうふまん。
歌声	うたごえ。
歌手	かしゅ。
歌詞	かし。
歓声	かんげい。
歓迎	かんげい。
歓迎会	かんげいかい。
止血	しけつ。
正七角形	せいななかっけい。
正三角形	せいさんかっけい。
正五角形	せいごかっけい。
正会員	せいかいいん。
正体	しょうたい。
正体不明	しょうたいふめい。
正六角形	せいろっかっけい。
正午	しょうご。
正反対	せいはんたい。
正夢	まさゆめ。
正常	せいじょう。
正座	せいざ。
正式	せいしき。
正式名称	せいしきめいしょう。
正式発表	せいしきはっぴょう。
正当	せいとう。
正当防衛	せいとうぼうえい。
正念場	しょうねんば。
正方形	せいほうけい。
正月	しょうがつ。
正月気分	しょうがつきぶん。
正気	しょうき。
正直	しょうじき。
正直者	しょうじきもの。
正確	せいかく。
正社員	せいしゃいん。
正統	せいとう。
正義	せいぎ。
正義感	せいぎかん。
正規	せいき。
正解	せいかい。
正解者	せいかいしゃ。
正誤表	せいごひょう。
正論	せいろん。
正面	せいめん。
正面図	しょうめんず。
武力	ぶりょく。
武力介入	ぶりょくかいにゅう。
武力行使	ぶりょくこうし。
武器	ぶき。
武器屋	ぶきや。
武器輸出三原則	ぶきゆしゅつさんげんそく。
武士	ぶし。
武家	ぶけ。
武者	むしゃ。
武術	ぶじゅつ。
武装	ぶそう。
武装勢力	ぶそうせいりょく。
武装強盗団	ぶそうごうとうだん。
武装集団	ぶそうしゅうだん。
歩兵	ほへい。
歩行	ほこう。
歩行困難	ほこうこんなん。
歩行者	ほこうしゃ。
歩行者天国	ほこうしゃてんごく。
歩行者専用	ほこうしゃせんよう。
歯医者	はいしゃ。
歯周病	ししゅうびょう。
歯形	はがた。
歯石	しせき。
歯科	しか。
歯科医	しかい。
歯車	はぐるま。
歴代	れきだい。
歴史	れきし。
歴史人物	れきしじんぶつ。
歴史問題	れきしもんだい。
歴史小説	れきししょうせつ。
歴史年表	れきしねんぴょう
歴史教科書	れきしきょうかしょ。
歴史認識	れきしにんしき。
死亡	しぼう。
死亡率	しぼうりつ。
死亡者	しぼうしゃ。
死亡記事	しぼうきじ。
死亡通知	しぼうつうち。
死人	しにん。
死体	したい。
死傷者	ししょうしゃ。
死刑	しけい。
死刑判決	しけいはんけつ。
死刑執行	しけいしっこう。
死刑宣告	しけいせんこく。
死去	しきょ。
死因	しいん。
死後	しご。
死活問題	しかつもんだい。
残念	ざんねん。
残暑	ざんしょ。
残業	ざんぎょう。
残業代	ざんぎょうだい。
残業手当	ざんぎょうてあて。
残額	ざんがく。
残飯	ざんぱん。
段落	だんらく。
段階	だんかい。
殺人	さつじん。
殺人事件	さつじんじけん。
殺人犯	さつじんはん。
殺人現場	さつじんげんば。
殺人罪	さつじんざい。
殺人鬼	さつじんき。
殺傷	さっしょう。
殺傷事件	さっしょうじけん。
殺傷能力	さっしょうのうりょく。
殺処分	さつしょぶん。
殺到	さっとう。
殺害	さつがい。
殺害予告	さつがいよこく。
殺意	さつい。
殺気	さっき。
殺菌	さっきん。
殺虫剤	さっちゅうざい。
殺風景	さっぷうけい。
殿様	とのさま。
母乳	ぼにゅう。
母体	ぼたい。
母国語	ぼこくご。
母子健康手帳	ぼしけんこうてちょう。
母子家庭	ぼしかてい。
母屋	おもや。
母性愛	ぼせいあい。
母校	ぼこう。
母親	ははおや。
母音	ぼいん。
毎回	まいかい。
毎年	まいねん。
毎度	まいど。
毎日	まいにち。
毎晩	まいばん。
毎月	まいつき。
毎朝	まいあさ。
毎秒	まいびょう。
毎週	まいしゅう。
毒味	どくみ。
毒殺	どくさつ。
毒素	どくそ。
毒舌	どくぜつ。
毒舌家	どくぜつか。
毒草	どくそう。
毒薬	どくやく。
毒針	どくばり。
比例	ひれい。
比例代表	ひれいだいひょう。
比例代表制	ひれいだいひょうせい。
比例区	ひれいく。
比例定数	ひれいていすう。
比重	ひじゅう。
毛布	もうふ。
毛皮	けがわ。
毛筆	もうひつ。
毛糸	けいと。
毛細血管	もうさいけっかん。
毛織物	けおりもの。
毛虫	けむし。
毛髪	もうはつ。
氏名	しめい。
民主主義	みんしゅしゅぎ。
民主主義国家	みんしゅしゅぎこっか
民主化	みんしゅか。
民主化運動	みんしゅかうんどう。
民主国家	みんしゅこっか。
民事事件	みんじじけん。
民事訴訟	みんじそしょう。
民家	みんか。
民意	みんい。
民族	みんぞく。
民族主義	みんぞくしゅぎ。
民族楽器	みんぞくがっき。
民族衣装	みんぞくいしょう。
民族音楽	みんぞくおんがく。
民業圧迫	みんぎょうあっぱく。
民衆	みんしゅう。
民話	みんわ。
民間	みんかん。
民間事業	みんかんじぎょう。
民間事業者	みんかんじぎょうしゃ。
民間企業	みんかんきぎょう。
民間利用	みんかんりよう。
民間団体	みんかんだんたい。
民間放送	みんかんほうそう。
民間軍事会社	みんかんぐんじがいしゃ。
民間部門	みんかんぶもん。
民間開放	みんかんかいほう。
気体	きたい。
気候	きこう。
気分	きぶん。
気分転換	きぶんてんかん。
気前	きまえ。
気力	きりょく。
気化	きか。
気化熱	きかねつ。
気味	きみ。
気品	きひん。
気圧	きあつ。
気圧配置	きあつはいち。
気楽	きらく。
気流	きりゅう。
気温	きおん。
気球	ききゅう。
気管	きかん。
気管支	きかんし。
気絶	きぜつ。
気苦労	きぐろう。
気象	きしょう。
気象台	きしょうだい。
気象庁	きしょうちょう。
気象条件	きしょうじょうけん。
気象衛星	きしょうえいせい。
気象観測	きしょうかんそく。
気軽	きがる。
気配	けはい。
気長	きなが。
水中	すいちゅう。
水中撮影	すいちゅうさつえい。
水中眼鏡	すいちゅうめがね。
水仕事	みずしごと。
水位	すいい。
水分	すいぶん。
水分補給	すいぶんほきゅう。
水力	すいりょく。
水力発電	すいりょくはつでん。
水力発電所	すいりょくはつでんしょ。
水圧	すいあつ。
水害	すいがい。
水平	すいへい。
水平方向	すいへいほうこう。
水平線	すいへいせん。
水彩画	すいさいが。
水戸黄門	みとこうもん。
水族館	すいぞくかん。
水星	すいせい。
水曜	すいよう。
水曜日	すいようび。
水死	すいし。
水死体	すいしたい。
水気	みずけ。
水没	すいぼつ。
水泳	すいえい。
水泳大会	すいえいたいかい。
水泳教室	すいえいきょうしつ。
水泳教育	すいえいきょういく。
水泳選手	すいえいせんしゅ。
水洗	すいせん。
水洗便所	すいせんべんじょ。
水流	すいりゅう。
水深	すいしん。
水温	すいおん。
水温計	すいおんけい。
水源	すいげん。
水源地	すいげんち。
水溶液	すいようえき。
水牛	すいぎゅう。
水玉模様	みずたまもよう。
水産加工業者	すいさんかこうぎょうしゃ。
水産業	すいさんぎょう。
水産物	すいさんぶつ。
水田	すいでん。
水着	みずぎ。
水筒	すいとう。
水素	すいそ。
水色	みずいろ。
水草	みずくさ。
水蒸気	すいじょうき。
水蒸気爆発	すいじょうきばくはつ。
水虫	みずむし。
水資源	みずしげん。
水質	すいしつ。
水質基準	すいしつきじゅん。
水質検査	すいしつけんさ。
水路	すいろ。
水車	すいしゃ。
水道	すいどう。
水道局	すいどうきょく。
水銀	すいぎん。
水銀温度計	すいぎんおんどけい。
水銀電池	すいぎんでんち。
水門	すいもん。
水面	すいめん。
氷山	ひょうざん。
氷水	こおりみず。
氷河	ひょうが。
氷河時代	ひょうがじだい。
氷点下	ひょうてんか。
永世中立国	えいせいちゅうりつこく。
永久	えいきゅう。
永久保存	えいきゅうほぞん。
永久凍土	えいきゅうとうど。
永久機関	えいきゅうきかん。
永久歯	えいきゅうし。
永久磁石	えいきゅうじしゃく。
永住	えいじゅう。
永住権	えいじゅうけん。
永眠	えいみん。
永遠	えいえん。
求人	きゅうじん。
求人件数	きゅうじんけんすう。
求人倍率	きゅうじんばいりつ。
求人広告	きゅうじんこうこく。
求刑	きゅうけい。
求愛	きゅうあい。
汚名	おめい。
汚染	おせん。
汚染水対策	おせんすいたいさく。
汚染物質	おせんぶっしつ。
汚水	おすい。
汚物	おぶつ。
汚職	おしょく。
汚職事件	おしょくじけん。
江戸	えど。
江戸城	えどじょう。
江戸幕府	えどばくふ。
江戸時代	えどじだい。
決別	けつべつ。
決勝	けっしょう。
決勝戦	けっしょうせん。
決壊	けっかい。
決定	けってい。
決心	けっしん。
決意	けつい。
決断	けつだん。
決着	けっちゃく。
決行	けっこう。
決裂	けつれつ。
決議	けつぎ。
沈没	ちんぼつ。
沈没船	ちんぼつせん。
沖縄	おきなわ。
沖縄地方	おきなわちほう。
沖縄県	おきなわけん。
河原	かわら。
河口	かこう。
河川	かせん。
河童	かっぱ。
油断	ゆだん。
油断大敵	ゆだんたいてき。
油田	ゆでん。
油紙	あぶらがみ。
油絵	あぶらえ。
治安	ちあん。
治安当局	ちあんとうきょく。
治安維持	ちあんいじ。
治安部隊	ちあんぶたい。
治水	ちすい。
治水工事	ちすいこうじ。
沿岸	えんがん。
沿線	えんせん。
沿道	えんどう。
法事	ほうじ。
法人税	ほうじんぜい。
法令	ほうれい。
法制度	ほうせいど。
法則	ほうそく。
法務省	ほうむしょう。
法外	ほうがい。
法定相続人	ほうていそうぞくにん。
法律	ほうりつ。
法律改正	ほうりつかいせい。
法改正	ほうかいせい。
法整備	ほうせいび。
法案	ほうあん。
法治主義	ほうちしゅぎ。
法治国家	ほうちこっか。
法科大学院	ほうかだいがくいん。
法規制	ほうきせい。
波乱	はらん。
波長	はちょう。
波間	なみま。
泥仕合	どろじあい。
注入	ちゅうにゅう。
注射	ちゅうしゃ。
注射器	ちゅうしゃき。
注意	ちゅうい。
注意事項	ちゅういじこう。
注意人物	ちゅういじんぶつ。
注意力	ちゅういりょく。
注意点	ちゅういてん。
注文	ちゅうもん。
注文住宅	ちゅうもんじゅうたく。
注文確認	ちゅうもんかくにん。
注水	ちゅうすい。
注目	ちゅうもく。
注目株	ちゅうもくかぶ。
注視	ちゅうし。
洋室	ようしつ。
洋式	ようしき。
洋服	ようふく。
洋楽	ようがく。
洋画	ようが。
洋菓子	ようがし。
洋酒	ようしゅ。
洋風	ようふう。
洋食	ようしょく。
洗剤	せんざい。
洗浄	せんじょう。
洗濯	せんたく。
洗濯機	せんたくき。
洗濯物	せんたくもの。
洗練	せんれん。
洗脳	せんのう。
洗面器	せんめんき。
洗面所	せんめんじょ。
洗顔	せんがん。
津波	つなみ。
津波対策	つなみたいさく。
津波注意報	つなみちゅういほう。
津軽三味線	つがるじゃみせん。
津軽弁	つがるべん。
活力	かつりょく。
活動	かつどう。
活動家	かつどうか。
活動方針	かつどうほうしん。
活動範囲	かつどうはんい。
活字	かつじ。
活性化	かっせいか。
活断層	かつだんそう。
活気	かっき。
活用	かつよう。
活発	かっぱつ。
活路	かつろ。
派手	はで。
派遣	はけん。
派遣労働者	はけんろうどうしゃ。
派遣社員	はけんしゃいん。
流出	りゅうしゅつ。
流出文書	りゅうしゅつぶんしょ。
流動食	りゅうどうしょく。
流域	りゅういき。
流星	りゅうせい。
流星群	りゅうせいぐん。
流水	りゅうすい。
流氷	りゅうひょう。
流産	りゅうざん。
流血	りゅうけつ。
流行	りゅうこう。
流行歌	りゅうこうか。
流行語	りゅうこうご。
流通	りゅうつう。
浄水場	じょうすいじょう。
浪人	ろうにん。
浪費	ろうひ。
浮世絵	うきよえ。
浮力	ふりょく。
浮動票	ふどうひょう。
浴場	よくじょう。
浴室	よくしつ。
浴衣	ゆかた。
海外	かいがい。
海外事業	かいがいじぎょう。
海外企業	かいがいきぎょう。
海外展開	かいがいてんかい。
海外投資家	かいがいとうしか。
海外旅行	かいがいりょこう。
海外移転	かいがいいてん。
海外資産	かいがいしさん。
海外進出	かいがいしんしゅつ。
海女	あま。
海岸	かいがん。
海岸線	かいがんせん。
海底	かいてい。
海底火山	かいていかざん。
海水	かいすい。
海水浴	かいすいよく。
海洋投棄	かいようとうき。
海洋深層水	かいようしんそうすい。
海流	かいりゅう。
海王星	かいおうせい。
海産物	かいさんぶつ。
海軍	かいぐん。
海辺	うみべ。
海里	かいり。
海難事故	かいなんじこ。
海面上昇	かいめんじょうしょう。
消化	しょうか。
消化不良	しょうかふりょう。
消化器官	しょうかきかん。
消化液	しょうかえき。
消印	けしいん。
消息	しょうそく。
消極的	しょうきょくてき。
消毒	しょうどく。
消毒作業	しょうどくさぎょう。
消毒液	しょうどくえき。
消火	しょうか。
消火器	しょうかき。
消灯	しょうとう。
消灯時間	しょうとうじかん。
消石灰	しょうせっかい。
消費	しょうひ。
消費低迷	しょうひていめい。
消費拡大	しょうひかくだい。
消費期限	しょうひきげん。
消費生活	しょうひせいかつ。
消費税	しょうひぜい。
消費税率	しょうひぜいりつ。
消費者	しょうひしゃ。
消費者団体	しょうひしゃだんたい。
消費者心理	しょうひしゃしんり。
消費者物価指数	しょうひしゃぶっかしすう。
消費者金融	しょうひしゃきんゆう。
消費電力	しょうひでんりょく。
消防	しょうぼう。
消防団員	しょうぼうだんいん。
消防士	しょうぼうし。
消防署	しょうぼうしょ。
消防車	しょうぼうしゃ。
消音	しょうおん。
消音材	しょうおんざい。
液体	えきたい。
液体燃料	えきたいねんりょう。
液状化	えきじょうか。
液状化現象	えきじょうかげんしょう。
淡水	たんすい。
淡水魚	たんすいぎょ。
深刻	しんこく。
深刻化	しんこくか。
深呼吸	しんこきゅう。
深夜	しんや。
深夜割引	しんやわりびき。
深夜営業	しんやえいぎょう。
深夜番組	しんやばんぐみ。
深手	ふかで。
深海	しんかい。
深海魚	しんかいぎょ。
混乱	こんらん。
混入	こんにゅう。
混合	こんごう。
混同	こんどう。
混戦	こんせん。
混線	こんせん。
混血	こんけつ。
混雑	こんざつ。
添付	てんぷ。
清書	せいしょ。
清水	せいすい。
清流	せいりゅう。
清涼飲料	せいりょういんりょう。
清涼飲料水	せいりょういんりょうすい。
清潔	せいけつ。
清酒	せいしゅ。
減少	げんしょう。
減少傾向	げんしょうけいこう。
減点	げんてん。
減税	げんぜい。
減速	げんそく。
減額	げんがく。
温和	おんわ。
温存	おんぞん。
温室	おんしつ。
温室効果	おんしつこうか。
温帯低気圧	おんたいていきあつ。
温帯気候	おんたいきこう。
温度	おんど。
温度上昇	おんどじょうしょう。
温度計	おんどけい。
温暖	おんだん。
温暖前線	おんだんぜんせん。
温暖化	おんだんか。
温暖化対策	おんだんかたいさく。
温水	おんすい。
温泉	おんせん。
温泉卵	おんせんたまご。
温泉施設	おんせんしせつ。
温泉街	おんせんがい。
温風	おんぷう。
測定	そくてい。
測定値	そくていち。
測定器	そくていき。
測定法	そくていほう。
測量	そくりょう。
測量士	そくりょうし。
港町	みなとまち。
湯気	ゆげ。
湯水	ゆみず。
湯船	ゆぶね。
湿地	しっち。
湿布	しっぷ。
湿度	しつど。
湿気	しっけ。
満員	まんいん。
満員電車	まんいんでんしゃ。
満場一致	まんじょういっち。
満月	まんげつ。
満潮	まんちょう。
満点	まんてん。
満腹	まんぷく。
満足	まんぞく。
満足度	まんぞくど。
満足感	まんぞくかん。
満開	まんかい。
源氏物語	げんじものがたり。
準備	じゅんび。
準備不足	じゅんびぶそく。
準決勝	じゅんけっしょう。
溶岩	ようがん。
溶接	ようせつ。
溶液	ようえき。
滅亡	めつぼう。
滋賀県	しがけん。
滑走路	かっそうろ。
滞在予定	たいざいよてい。
滞在期間	たいざいきかん。
滞納	たいのう。
滞納世帯	たいのうせたい。
漁師	りょうし。
漁村	ぎょそん。
漁業	ぎょぎょう。
漁港	ぎょこう。
漁船	ぎょせん。
漂流	ひょうりゅう。
漂白剤	ひょうはくざい。
演出	えんしゅつ。
演劇	えんげき。
演奏	えんそう。
演奏会	えんそうかい。
演技	えんぎ。
演習	えんしゅう。
演芸	えんげい。
演説	えんぜつ。
漢和辞典	かんわじてん。
漢字	かんじ。
漢字字典	かんじじてん。
漢字検定	かんじけんてい。
漢数字	かんすうじ。
漢文	かんぶん。
漢語	かんご。
漬物	つけもの。
漬物石	つけものいし。
潔白	けっぱく。
潮時	しおどき。
潮流	ちょうりゅう。
潮風	しおかぜ。
激化	げきか。
激増	げきぞう。
激戦	げきせん。
激流	げきりゅう。
激痛	げきつう。
濁点	だくてん。
濃淡	のうたん。
瀬戸際	せとぎわ。
瀬戸際外交	せとぎわがいこう。
火事	かじ。
火事場	かじば。
火事場泥棒	かじばどろぼう。
火元	ひもと。
火力	かりょく。
火力発電	かりょくはつでん。
火口	かこう。
火山	かざん。
火山地帯	かざんちたい。
火山岩	かざんがん。
火山性地震	かざんせいじしん。
火山活動	かざんかつどう。
火山観測	かざんかんそく。
火星	かせい。
火曜	かよう。
火曜日	かようび。
火柱	ひばしら。
火気厳禁	かきげんきん。
火災	かさい。
火災事故	かさいじこ。
火災保険	かさいほけん。
火災報知器	かさいほうちき。
火炎	かえん。
火種	ひだね。
火花	ひばな。
火薬	かやく。
灯台	とうだい。
灯油	とうゆ。
灯火	とうか。
灰皿	はいざら。
灰色	はいいろ。
災害	さいがい。
災害対策基本法	さいがいたいさくきほんほう。
災害復旧	さいがいふっきゅう。
災害情報	さいがいじょうほう。
災害救助犬	さいがいきゅうじょけん。
災難	さいなん。
炎上	えんじょう。
炎天下	えんてんか。
炎症	えんしょう。
炭化	たんか。
炭化水素	たんかすいそ。
炭水化物	たんすいかぶつ。
炭火	すみび。
炭素	たんそ。
炭酸	たんさん。
炭酸水	たんさんすい。
点呼	てんこ。
点在	てんざい。
点字	てんじ。
点数	てんすう。
点検	てんけん。
点検商法	てんけんしょうほう。
点滅	てんめつ。
点火	てんか。
点線	てんせん。
為替	かわせ。
為替変動	かわせへんどう。
無一文	むいちもん。
無事	ぶじ。
無人	むじん。
無人島	むじんとう。
無人機	むじんき。
無作法	ぶさほう。
無価値	むかち。
無傷	むしょう。
無党派層	むとうはそう。
無利息	むりし。
無制限	むせいげん。
無力	むりょく。
無効	むこう。
無口	むくち。
無名	むめい。
無味乾燥	むみかんそう。
無実	むじつ。
無害	むがい。
無差別	むさべつ。
無差別殺傷事件	むさべつさっしょうじけん。
無差別級	むさべつきゅう。
無形文化財	むけいぶんかざい。
無形文化遺産	むけいぶんかいさん。
無念	むねん。
無意味	むいみ。
無意識	むいしき。
無愛想	ぶあいそう。
無我夢中	むがむちゅう。
無数	むすう。
無敵	むてき。
無料	むりょう。
無料公開	むりょうこうかい。
無料引換券	むりょうひきかえけん。
無断	むだん。
無断欠勤	むだんけっきん。
無断欠席	むだんけっせき。
無期限	むきげん。
無機物	むきぶつ。
無欲	むよく。
無残	むざん。
無気力	むきりょく。
無添加	むてんか。
無理	むり。
無理心中	むりしんじゅう。
無用	むよう。
無病息災	むびょうそくさい。
無益	むえき。
無知	むち。
無礼	ぶれい。
無礼者	ぶれいもの。
無神経	むしんけい。
無線	むせん。
無線通信	むせんつうしん。
無罪	むざい。
無罪主張	むざいしゅちょう。
無罪判決	むざいはんけつ。
無職	むしょく。
無能	むのう。
無表情	むひょうじょう。
無視	むし。
無言	むごん。
無言電話	むごんでんわ。
無計画	むけいかく。
無記名投票	むきめいとうひょう。
無論	むろん。
無責任	むせきにん。
無農薬	むのうやく。
無農薬野菜	むのうやくやさい。
無邪気	むじゃき。
無重力	むじゅうりょく。
無関係	むかんけい。
無限	むげん。
無限大	むげんだい。
無限責任	むげんせきにん。
無難	ぶなん。
無駄	むだ。
焼失	しょうしつ。
焼死	しょうし。
焼死体	しょうしたい。
煙突	えんとつ。
照合	しょうごう。
照明	しょうめい。
照明係	しょうめいがかり。
照明器具	しょうめいきぐ。
煮物	にもの。
熊本県	くまもとけん。
熟成	じゅくせい。
熟睡	じゅくすい。
熟練	じゅくれん。
熟語	じゅくご。
熟読	じゅくどく。
熱中	ねっちゅう。
熱中症	ねっちゅうしょう。
熱帯	ねったい。
熱帯低気圧	ねったいていきあつ。
熱帯夜	ねったいや。
熱帯植物	ねったいしょくぶつ。
熱帯気候	ねったいきこう。
熱帯魚	ねったいぎょ。
熱心	ねっしん。
熱意	ねつい。
熱気	ねっき。
熱気球	ねつききゅう。
熱湯	ねっとう。
熱狂	ねっきょう。
熱量	ねつりょう。
燃料	ねんりょう。
燃料価格	ねんりょうかかく。
燃料油	ねんりょうあぶら。
燃料補給	ねんりょうほきゅう。
燃料調達	ねんりょうちょうたつ。
燃料費	ねんりょうひ。
燃料電池車	ねんりょうでんちしゃ。
燃焼	ねんしょう。
燃費向上	ねんぴこうじょう。
父母	ふぼ。
父親	ちちおや。
片仮名	かたかな。
片側	かたがわ。
片手	かたて。
片手間	かたてま。
片方	かたほう。
片時	かたとき。
片田舎	かたいなか。
片言	かたこと。
片足	かたあし。
片道	かたみち。
片道切符	かたみちきっぷ。
片道料金	かたみちりょうきん。
版画	はんが。
牛丼	ぎゅうどん。
牛乳	ぎゅうにゅう。
牛肉	ぎゅうにく。
牛舎	ぎゅうしゃ。
牛飲馬食	ぎゅういんばしょく
牧場	ぼくじょう。
牧師	ぼくし。
牧草	ぼくそう。
牧草地	ぼくそうち。
物事	ものごと。
物件	ぶっけん。
物体	ぶったい。
物価	ぶっか。
物価上昇	ぶっかじょうしょう。
物価上昇率	ぶっかじょうしょうりつ。
物価上昇目標	ぶっかじょうしょうもくひょう。
物価変動	ぶっかへんどう。
物価安定	ぶっかあんてい。
物価目標	ぶっかもくひょう。
物価高	ぶっかだか。
物品	ぶっぴん。
物心	ものごころ。
物流拠点	ぶつりゅうきょてん。
物理学	ぶつりがく。
物色	ぶっしょく。
物語	ものがたり。
物資	ぶっし。
物質	ぶっしつ。
物音	ものおと。
特価	とっか。
特典	とくてん。
特別	とくべつ。
特別交付税	とくべつこうふぜい。
特別企画	とくべつきかく。
特別価格	とくべつかかく。
特別国会	とくべつこっかい。
特別行政区	とくべつぎょうせいく。
特効薬	とっこうやく。
特売日	とくばいび。
特大	とくだい。
特定	とくてい。
特定保健用食品	とくていほけんようしょくひん。とくほ。
特定秘密保護法	とくていひみつほごほう。
特急	とっきゅう。
特技	とくぎ。
特攻隊	とっこうたい。
特攻隊員	とっこうたいいん。
特有	とくゆう。
特権	とっけん。
特殊部隊	とくしゅぶたい。
特産物	とくさんぶつ。
特筆	とくひつ。
特色	とくしょく。
特許	とっきょ。
特許庁	とっきょちょう。
特許権	とっきょけん。
特集	とくしゅう。
特集記事	とくしゅうきじ。
特需	とくじゅ。
犬死	いぬじに。
犯人	はんにん。
犯罪	はんざい。
犯罪歴	はんざいれき。
犯罪率	はんざいりつ。
犯罪者	はんざいしゃ。
犯罪行為	はんざいこうい。
犯罪被害者	はんざいひがいしゃ。
犯行	はんこう。
犯行現場	はんこうげんば。
状態	じょうたい。
状況	じょうきょう。
狂気	きょうき。
狂犬病	きょうけんびょう。
独奏	どくそう。
独学	どくがく。
独断専行	どくだんせんこう。
独特	どくとく。
独立	どくりつ。
独立国家	どくりつこっか。
独立宣言	どくりつせんげん。
独立戦争	どくりつせんそう。
独立独歩	どくりつどっぽ。
独立行政法人	どくりつぎょうせいほうじん。
独立記念日	どくりつきねんび。
独自技術	どくじぎじゅつ。
独裁	どくさい。
独裁国家	どくさいこっか。
独裁政治	どくさいせいじ。
独裁者	どくさいしゃ。
独身	どくしん。
独身貴族	どくしんきぞく。
猛吹雪	もうふぶき。
玄米	げんまい。
玄関	げんかん。
率先	そっせん。
率直	そっちょく。
玉手箱	たまてばこ。
玉石	たまいし。
玉虫	たまむし。
王位	おうい。
王位継承	おういけいしょう。
王国	おうこく。
王子	おうじ。
王室	おうしつ。
王宮	おうきゅう。
王座決定戦	おうざけっていせん。
王手	おうて。
王者	おうじゃ。
現人神	あらひとがみ。
現代	げんだい。
現代人	げんだいじん。
現代文	げんだいぶん。
現代社会	げんだいしゃかい。
現住所	げんじゅうしょ。
現像	げんぞう。
現在	げんざい。
現在地	げんざいち。
現在進行形	げんざいしんこうけい。
現地企業	げんちきぎょう。
現地協力者	げんちきょうりょくしゃ。
現地報道	げんちほうどう。
現地指導	げんちしどう。
現地法人	げんちほうじん。
現地調査	げんちちょうさ。
現地通貨	げんちつうか。
現場	げんば。
現場主義	げんばしゅぎ。
現場作業	げんばさぎょう。
現場検証	げんばけんしょう。
現場監督	げんばかんとく。
現実	げんじつ。
現役	げんえき。
現役世代	げんえきせだい。
現役引退	げんえきいんたい。
現役時代	げんえきじだい。
現段階	げんだんかい。
現物	げんぶつ。
現状	げんじょう。
現状維持	げんじょういじ。
現象	げんしょう。
現金	げんきん。
現金化	げんきんか。
現金書留	げんきんかきとめ。
球体	きゅうたい。
球団	きゅうだん。
球場	きゅうじょう。
球技	きゅうぎ。
球根	きゅうこん。
理不尽	りふじん。
理事長代行	りじちょうだいこう。
理化学研究所	りかがくけんきゅうじょ。
理性	りせい。
理想	りそう。
理想像	りそうぞう。
理由	りゆう。
理研	りけん。
理科	りか。
理解	りかい。
理解者	りかいしゃ。
理論	りろん。
理髪店	りはつてん。
琵琶湖	びわこ。
環境	かんきょう。
環境保全	かんきょほぜん。
環境問題	かんきょうもんだい。
環境変化	かんきょうへんか。
環境整備	かんきょうせいび。
環境汚染	かんきょうおせん。
環境省	かんきょうしょう。
環境破壊	かんきょうはかい。
環太平洋経済連携協定	かんたいへいようけいざいれんけいきょうてい。
環状線	かんじょうせん。
甘口	あまくち。
甘酒	あまざけ。
生中継	なまちゅうけい。
生体肝移植	せいたいかんいしょく。
生半可	なまはんか。
生卵	なまたまご。
生命	せいめい。
生命保険	せいめいほけん。
生命力	せいめいりょく。
生命科学	せいめいかがく。
生命維持装置	せいめいいじそうち。
生存	せいぞん。
生存競争	せいぞんきょうそう。
生存者	せいぞんしゃ。
生年月日	せいねんがっぴ。
生後	せいご。
生徒	せいと。
生徒会	せいとかい。
生徒会長	せいとかいちょう。
生息	せいそく。
生息地	せいそくち。
生意気	なまいき。
生態	せいたい。
生態系	せいたいけい。
生放送	なまほうそう。
生死	せいし。
生水	なまみず。
生活	せいかつ。
生活保護	せいかつほご。
生活家電	せいかつかでん。
生活習慣	せいかつしゅうかん。
生活習慣病	せいかつしゅうかんびょう。
生活費	せいかつひ。
生活資金	せいかつしきん。
生物	せいぶつ。
生物兵器	せいぶつへいき。
生物学	せいぶつがく。
生理食塩水	せいりしょくえんすい。
生産	せいさん。
生産効率	せいさんこうりつ。
生産地	せいさんち。
生産性	せいさんせい。
生産性向上	せいさんせいこうじょう。
生産現場	せいさんげんば。
生産管理	せいさんかんり。
生産者	せいさんしゃ。
生産能力	せいさんのうりょく。
生産設備	せいさんせつび。
生産過剰	せいさんかじょう。
生産量	せいさんりょう。
生糸	きいと。
生育	せいいく。
生長	せいちょう。
生鮮食品	せいせんしょくひん。
産出	さんしゅつ。
産卵	さんらん。
産地	さんち。
産声	うぶごえ。
産婦人科	さんふじんか。
産業	さんぎょう。
産業界	さんぎょうかい。
産業遺産	さんぎょういさん。
産業部門	さんぎょうぶもん。
産業都市	さんぎょうとし。
産業革命	さんぎょうかくめい。
産毛	うぶげ。
産油国	さんゆこく。
用事	ようじ。
用件	ようけん。
用地面積	ようちめんせき。
用心	ようじん。
用心棒	ようじんぼう。
用意	ようい。
用水路	ようすいろ。
用法	ようほう。
用紙	ようし。
用語	ようご。
用語集	ようごしゅう。
田園	でんえん。
田園風景	でんえんふうけい。
田畑	たはた。
田舎	いなか。
由来	ゆらい。
申込書	もうしこみしょ。
申込番号	もうしこみばんごう。
男優	だんゆう。
男前	おとこまえ。
男女	だんじょ。
男女共同参画	だんじょきょうどうさんかく。
男女平等	だんじょびょうどう。
男女関係	だんじょかんけい。
男女雇用均等法	だんじょこようきんとうほう。
男子	だんし。
男子生徒	だんしせいと。
男性	だんせい。
男風呂	おとこぶろ。
町工場	まちこうば。
町長	ちょうちょう。
画一的	かくいつてき。
画像	がぞう。
画家	がか。
画数	かくすう。
画期的	かっきてき。
画板	がばん。
画用紙	がようし。
画面	がめん。
畑仕事	はたけしごと。
畑作	はたさく。
留任	りゅうにん。
留学	りゅうがく。
留守	るす。
留守番	るすばん。
留守番電話	るすばんでんわ。
畜産農家	ちくさんのうか。
略図	りゃくず。
略字	りゃくじ。
略式起訴	りゃくしききそ。
略歴	りゃくれき。
略称	りゃくしょう。
略語	りゃくご。
番人	ばんにん。
番付	ばんつけ。
番号	ばんごう。
番地	ばんち。
番犬	ばんけん。
番組	ばんぐみ。
異例	いれい。
異口同音	いくどうおん。
異国	いこく。
異変	いへん。
異存	いぞん。
異常	いじょう。
異常事態	いじょうじたい。
異性	いせい。
異様	いよう。
異次元	いじげん。
異物	いぶつ。
異物混入	いぶつこんにゅう。
異色	いしょく。
異論	いろん。
異議	いぎ。
疑問	ぎもん。
疑問文	ぎもんぶん。
疑心暗鬼	ぎしんあんき。
疑惑	ぎわく。
病人	びょうにん。
病原菌	びょうげんきん。
病名	びょうめい。
病室	びょうしつ。
病弱	びょうじゃく。
病死	びょうし。
病気	びょうき。
病状	びょうじょう。
病院	びょういん。
症状	しょうじょう。
痛切	つうせつ。
痛感	つうかん。
痛手	いたで。
発作	ほっさ。
発信	はっしん。
発光	はっこう。
発光現象	はっこうげんしょう。
発声練習	はっせいれんしゅう。
発売	はつばい。
発売日	はつばいび。
発売禁止	はつばいきんし。
発売開始	はつばいかいし。
発射	はっしゃ。
発射台	はっしゃだい。
発展	はってん。
発展途上国	はってんとじょうこく。
発掘調査	はっくつちょうさ。
発揮	はっき。
発散	はっさん。
発明	はつめい。
発明家	はつめいか。
発泡酒	はっぽうしゅ。
発注	はっちゅう。
発火	はっか。
発火点	はっかてん。
発熱	はつねつ。
発狂	はっきょう。
発生	はっせい。
発病	はつびょう。
発着	はっちゃく。
発禁	はっきん。
発禁本	はっきんぼん。
発育	はついく。
発芽	はつが。
発行手数料	はっこうてすうりょう。
発表	はっぴょう。
発表会	はっぴょうかい。
発見	はっけん。
発覚	はっかく。
発言	はつげん。
発言者	はつげんしゃ。
発言機会	はつげんきかい。
発足	ほっそく。
発車	はっしゃ。
発車時刻	はっしゃじこく。
発送	はっそう。
発送電分離	はっそうでんぶんり。
発達	はったつ。
発達障害	はったつしょうがい。
発電	はつでん。
発電所	はつでんしょ。
発電機	はつでんき。
発電設備	はつでんせつび。
発電量	はつでんりょう。
発音	はつおん。
発音記号	はつおんきごう。
登場	とうじょう。
登場人物	とうじょうじんぶつ。
登山	とざん。
登山家	とざんか。
登山道	とざんどう。
登庁	とうちょう。
登校	とうこう。
登校拒否	とうこうきょひ。
登校日	とうこうび。
登録	とうろく。
登録商標	とうろくしょうひょう。
登録数	とうろくすう。
白人	はくじん。
白内障	はくないしょう。
白寿	はくじゅ。
白星	しろぼし。
白波	しらなみ。
白熱	はくねつ。
白熱電球	はくねつでんきゅう。
白物家電	しろものかでん。
白状	はくじょう。
白米	はくまい。
白紙	はくし。
白組	しろぐみ。
白色	はくしょく。
白色人種	はくしょくじんしゅ。
白菜	はくさい。
白血球	はっけっきゅう。
白血病	はっけつびょう。
白衣	はくい。
白身	しろみ。
白骨	はっこつ。
白骨化	はっこつか。
白髪	しらが。
白鳥	はくちょう。
白黒	ものくろ。
白黒写真	しろくろしゃしん。
百人一首	ひゃくにんいっしゅ。
百分率	ひゃくぶんりつ。
百点満点	ひゃくてんまんてん。
百発百中	ひゃっぱつひゃくちゅう。
百科事典	ひゃっかじてん。
百貨店	ひゃっかてん。
的中	てきちゅう。
的確	てきかく。
皇太子	こうたいし。
皇子	おうじ。
皇室	こうしつ。
皇居	こうきょ。
皇帝	こうてい。
皇族	こうぞく。
皮肉	ひにく。
益虫	えきちゅう。
盗撮防止	とうさつぼうし。
盗聴器	とうちょうき。
盗難	とうなん。
盗難保険	とうなんほけん。
盗難届	とうなんとどけ。
盗難車	とうなんしゃ。
盛大	せいだい。
監督	かんとく。
監禁	かんきん。
監視	かんし。
目上	めした。
目下	めうえ。
目分量	めぶんりょう。
目前	もくぜん。
目印	めじるし。
目安	めやす。
目安箱	めやすばこ。
目星	めぼし。
目標	もくひょう。
目標達成	もくひょうたっせい。
目標額	もくひょうがく。
目次	もくじ。
目測	もくそく。
目玉	めだま。
目玉焼	めだまやき。
目的	もくてき。
目的地	もくてきち。
目的外利用	もくてきがいりよう。
目的意識	もくてきいしき。
目頭	めがしら。
直下	ちょっか。
直下型地震	ちょっかがたじしん。
直列	ちょくれつ。
直前	ちょくぜん。
直売所	ちょくばいじょ。
直射日光	ちょくしゃにっこう。
直径	ちょっけい。
直後	ちょくご。
直感	ちょっかん。
直接	ちょくせつ。
直接対決	ちょくせつたいけつ。
直接民主制	ちょくせつみんしゅせい。
直方体	ちょくほうたい。
直流	ちょくりゅう。
直球	ちょっきゅう。
直立不動	ちょくりつふどう。
直結	ちょっけつ。
直線	ちょくせん。
直線距離	ちょくせんきょり。
直線道路	ちょくせんどうろ。
直行便	ちょっこうびん。
直視	ちょくし。
直角	ちょっかく。
直角三角形	ちょっかくさんかっけい。
直訳	ちょくやく。
直訴	じきそ。
直談判	じかだんぱん。
直進	ちょくしん。
直面	ちょくめん。
相互理解	そうごりかい。
相似	そうじ。
相場	そうば。
相対性理論	そうたいせいりろん。
相思相愛	そうしそうあい。
相性	あいしょう。
相手	あいて。
相手校	あいてこう。
相棒	あいぼう。
相続	そうぞく。
相続人	そうぞくにん。
相続権	そうぞくけん。
相続税	そうぞくぜい。
相談	そうだん。
相談内容	そうだんないよう。
相談室	そうだんしつ。
相談相手	そうだんあいて。
相談窓口	そうだんまどぐち。
省略	しょうりゃく。
看守	かんしゅ。
看板	かんばん。
看病	かんびょう。
看護師	かんごし。
県内移設	けんないいせつ。
県境	けんざかい。
県外移設	けんがいいせつ。
県庁	けんちょう。
県庁所在地	けんちょうしょざいち。
県知事	けんちじ。
県立	けんりつ。
県道	けんどう。
真価	しんか。
真冬	まふゆ。
真剣	しんけん。
真剣勝負	しんけんしょうぶ。
真夏	まなつ。
真夜中	まよなか。
真実	しんじつ。
真心	まごころ。
真意	しんい。
真昼	まひる。
真正面	ましょうめん。
真水	まみず。
真理	しんり。
真相	しんそう。
真空	しんくう。
真綿	まわた。
真面目	まじめ。
真顔	まがお。
真骨頂	しんこっちょう。
眼中	がんちゅう。
眼球	がんきゅう。
眼科	がんか。
眼科医	がんかい。
眼鏡	めがね。
眼鏡型端末	めがねがたたんまつ。
着実	ちゃくじつ。
着工	ちゃっこう。
着席	ちゃくせき。
着心地	きごこち。
着想	ちゃくそう。
着手	ちゃくしゅ。
着服	ちゃくふく。
着火	ちゃっか。
着物	きもの。
着眼	ちゃくがん。
着眼点	ちゃくがんてん。
着色	ちゃくしょく。
着色料	ちゃくしょくりょう。
着陸	ちゃくりく。
睡眠	すいみん。
睡眠時間	すいみんじかん。
瞬間	しゅんかん。
矢印	やじるし。
知事	ちじ。
知事選	ちじせん。
知人	ちじん。
知名度	ちめいど。
知名度不足	ちめいどぶそく。
知性	ちせい。
知恵	ちえ。
知恵袋	ちえぶくろ。
知的生命体	ちてきせいめいたい。
知的財産	ちてきざいさん。
知的財産権	ちてきざいさんけん。
知的障害	ちてきしょうがい。
知能	ちのう。
知能指数	ちのうしすう。
知識	ちしき。
知識人	ちしきじん。
短冊	たんざく。
短命	たんめい。
短大	たんだい。
短所	たんしょ。
短文	たんぶん。
短時間	たんじかん。
短時間労働	たんじかんろうどう。
短期	たんき。
短期大学	たんきだいがく。
短歌	たんか。
短気	たんき。
短波	たんぱ。
短編小説	たんぺんしょうせつ。
短縮	たんしゅく。
短調	たんちょう。
短距離	たんきょり。
石器	せっき。
石器時代	せっきじだい。
石川県	いしかわけん。
石材	せきざい。
石橋	いしばし。
石油	せきゆ。
石油会社	せきゆがいしゃ。
石油採取	せきゆさいしゅ。
石油製品	せきゆせいひん。
石油輸出国機構	せきゆゆしゅつこくきこう。
石灰	せっかい。
石灰水	せっかいすい。
石炭	せきたん。
石頭	いしあたま。
砂利	じゃり。
砂場	すなば。
砂時計	すなどけい。
砂糖	さとう。
砂糖水	さとうみず。
砂金	さきん。
砂鉄	さてつ。
研修	けんしゅう。
研修医	けんしゅうい。
研究	けんきゅう。
研究不正	けんきゅうふせい。
研究成果	けんきゅうせいか。
研究所	けんきゅうじょ。
研究機関	けんきゅうきかん。
研究結果	けんきゅうけっか。
研究者	けんきゅうしゃ。
研究開発	けんきゅうかいはつ。
破壊	はかい。
破局	はきょく。
破損	はそん。
破片	はへん。
破産	はさん。
破産手続	はさんてつづき。
破裂	はれつ。
硫化水素	りゅうかすいそ。
硫酸	りゅうさん。
硫黄	いおう。
硬貨	こうか。
確保	かくほ。
確信	かくしん。
確信犯	かくしんはん。
確固	かっこ。
確定	かくてい。
確定申告	かくていしんこく。
確実	かくじつ。
確率	かくりつ。
確立	かくてい。
確認	かくにん。
確認作業	かくにんさぎょう。
磁力	じりょく。
磁力線	じりょくせん。
磁気	じき。
磁石	じしゃく。
示談	じだん。
示談金	じだんきん。
礼儀	れいぎ。
礼儀作法	れいぎさほう。
礼拝	れいはい。
礼拝堂	れいはいどう。
社交	しゃこう。
社交性	しゃこうせい。
社会	しゃかい。
社会主義	しゃかいしゅぎ。
社会人	しゃかいじん。
社会人野球	しゃかいじんやきゅう。
社会保険	しゃかいほけん。
社会保険事務所	しゃかいほけんじむしょ。
社会保険料	しゃかいほけんりょう。
社会保障	しゃかいほしょう。
社会保障制度	しゃかいほしょうせいど。
社会保障費	しゃかいほしょうひ。
社会全体	しゃかいぜんたい。
社会制度	しゃかいせいど。
社会問題	しゃかいもんだい。
社会基盤	しゃかいきばん。
社会復帰	しゃかいふっき。
社会福祉士	しゃかいふくしし。
社会福祉法人	しゃかいふくしほうじん。
社会福祉活動	しゃかいふくしかつどう。
社会科	しゃかいか。
社会運動	しゃかいうんどう。
社員	しゃいん。
社員旅行	しゃいんりょこう。
社員研修	しゃいんけんしゅう。
社外取締役	しゃがいとりしまりやく。
社宅	しゃたく。
社説	しゃせつ。
社長	しゃちょう。
祖先	そせん。
祖国	そこく。
祖母	そぼ。
祖父	そふ。
祝日	しゅくじつ。
祝福	しゅくふく。
祝辞	しゅくじ。
神主	かんぬし。
神仏	しんぶつ。
神前結婚式	しんぜんけっこんしき。
神奈川県	かながわけん。
神戸牛	こうべぎゅう。
神業	かみわざ。
神楽	かぐら。
神様	かみさま。
神殿	しんでん。
神父	しんぷ。
神社	じんじゃ。
神秘	しんぴ。
神秘的	しんぴてき。
神経	しんけい。
神経衰弱	しんけいすいじゃく。
神経質	しんけいしつ。
神聖	しんせい。
神話	しんわ。
神通力	じんつうりき。
神道	しんとう。
祭典	さいてん。
祭日	さいじつ。
禁句	きんく。
禁欲	きんよく。
禁止	きんし。
禁漁	きんりょう。
禁煙	きんえん。
禁物	きんもつ。
福井県	ふくいけん。
福利厚生費	ふくりこうせいひ。
福岡県	ふくおかけん。
福島原発事故	ふくしまげんぱつじこ。
福島県	ふくしまけん。
福島第一原子力発電所	ふくしまだいいちげんしりょくはつでんしょ。
福島第一原発	ふくしまだいいちげんぱつ。
福引	ふくびき。
福引券	ふくびきけん。
福祉施設	ふくししせつ。
秀才	しゅうさい。
私利私欲	しりしよく。
私営鉄道	しえいてつどう。
私学	しがく。
私書箱	ししょばこ。
私有地	しゆうち。
私服	しふく。
私物	しぶつ。
私用	しよう。
私立	しりつ。
私立中学校	しりつちゅうがっこう。
私語	しご。
私財	しざい。
私鉄	してつ。
秋分	しゅうぶん。
秋田県	あきたけん。
秋風	あきかぜ。
科学	かがく。
科学技術	かがくぎじゅつ。
科学者	かがくしゃ。
科目	かもく。
秒速	びょうそく。
秒針	びょうしん。
秘伝	ひでん。
秘境	ひきょう。
秘密	ひみつ。
秘密厳守	ひみつげんしゅ。
秘密指定	ひみつしてい。
秘書	ひしょ。
秘蔵	ひぞう。
移住	いじゅう。
移動	いどう。
移動制限区域	いどうせいげんくいき。
移動手段	いどうしゅだん。
移植	いしょく。
移植手術	いしょくしゅじゅつ。
移民	いみん。
移転	いてん。
移転先	いてんさき。
程度	ていど。
税制改正	ぜいせいかいせい。
税制調査会	ぜいせいちょうさかい。
税務署	ぜいむしょ。
税込価格	ぜいこみかかく。
税金	ぜいきん。
税関	ぜいかん。
税額	ぜいがく。
種子	しゅし。
種子島	たねがしま。
種族	しゅぞく。
種目	しゅもく。
種類	しゅるい。
積乱雲	せきらんうん。
積極的	せっきょくてき。
積極的平和主義	せっきょくてきへいわしゅぎ。
積荷	つみに。
積雪	せきせつ。
空中	くうちゅう。
空中分解	くうちゅうぶんかい。
空席	くうせき。
空想	くうそう。
空手	からて。
空手道場	からてどうじょう。
空模様	そらもよう。
空母	くうぼ。
空気	くうき。
空気清浄器	くうきせいじょうき。
空海	くうかい。
空港	くうこう。
空白	くうはく。
空白期	くうはくき。
空耳	そらみみ。
空腹	くうふく。
空路	くうろ。
空軍	くうぐん。
空輸	くうゆ。
空間	くうかん。
突拍子	とっぴょうし。
突然	とつぜん。
突破	とっぱ。
突進	とっしん。
突風	とっぷう。
窓口	まどぐち。
窓辺	まどべ。
立体	りったい。
立体駐車場	りったいちゅうしゃじょう。
立候補	りっこうほ。
立冬	りっとう。
立地条件	りっちじょうけん。
立場	たちば。
立方体	りっぽうたい。
立春	りっしゅん。
立案	りつあん。
立派	りっぱ。
立秋	りっしゅう。
立腹	りっぷく。
童心	どうしん。
童話	どうわ。
童顔	どうがん。
端数	はすう。
端末	たんまつ。
競争	きょうそう。
競争入札	きょうそうにゅうさつ。
競争力	きょうそうりょく。
競争力強化	きょうそうりょくきょうか。
競争原理	きょうそうげんり。
競争激化	きょうそうげきか。
競争相手	きょうそうあいて。
競売	きょうばい。
競技	きょうぎ。
競技人口	きょうぎじんこう。
競技場	きょうぎじょう。
競泳	きょうえい。
競走	きょうそう。
競走馬	きょうそうば。
競輪	きょうりん。
競馬	けいば。
競馬場	けいばじょう。
竹刀	しない。
竹細工	たけざいく。
竹輪	ちくわ。
竹馬	たけうま。
笑顔	えがお。
第一印象	だいいちいんしょう。
第一次世界大戦	だいいちじせかいたいせん。
第一次産業	だいいちじさんぎょう
第三国	だいさんごく。
第三者	だいさんしゃ。
第二次世界大戦	だいにじせかいたいせん。
筆算	ひっさん。
筆者	ひっしゃ。
筆記	ひっき。
筆記試験	ひっきしけん。
筆跡	ひっせき。
筆跡鑑定	ひっせきかんてい。
等分	とうぶん。
等号	とうごう。
等身大	とうしんだい。
等高線	とうこうせん。
筋肉	きんにく。
筋肉痛	きんにくつう。
筋金	すじがね。
答弁	とうべん。
答案	とうあん。
答案用紙	とうあんようし。
策略	さくりゃく。
算出	さんしゅつ。
算数	さんすう。
算用数字	さんようすうじ。
管楽器	かんがっき。
管理	かんり。
管理体制	かんりたいせい。
管理栄養士	かんりえいようし。
管理者	かんりしゃ。
管理職	かんりしょく。
管理責任者	せきにんかんりしゃ。
管理部門	かんりぶもん。
節分	せつぶん。
節水	せっすい。
節穴	ふしあな。
節約	せつやく。
節電	せつでん。
範囲	はんい。
簡単	かんたん。
簡易	かんい。
簡易書留	かんいかきとめ。
簡易検査	かんいけんさ。
簡潔	かんけつ。
簡略	かんりゃく。
簿記	ぼき。
米俵	こめだわら。
米国	べいこく。
米国産	べいこくさん。
米国産牛肉	べいこくさんぎゅうにく。
米国経済	べいこくけいざい。
米寿	べいじゅ。
米所	こめどころ。
米軍基地	べいぐんきち。
粉末	ふんまつ。
粉薬	こなぐすり。
粉雪	こなゆき。
粘土	ねんど。
粘度	ねんど。
精力	せいりょく。
精密	せいみつ。
精密検査	せいみつけんさ。
精密機械	せいみつきかい。
精密機械部品	せいみつきかいぶひん。
精神	せいしん。
精神力	せいしんりょく。
精神安定剤	せいしんあんていざい。
精神年齢	せいしんねんれい。
精神状態	せいしんじょうたい。
精神病	せいしんびょう。
精神科	せいしんか。
精神科医	せいしんかい。
精神論	せいしんろん。
精算	せいさん。
精米	せいまい。
精米所	せいまいじょ。
精米機	せいまいき。
精肉店	せいにくてん。
精製	せいせい。
精通	せいつう。
精進	しょうじん。
糖分	とうぶん。
糸口	いとぐち。
糸電話	いとでんわ。
系列	けいれつ。
紀元	きげん。
紀元前	きげんぜん。
約分	やくぶん。
約数	やくすう。
約束	やくそく。
約束事	やくそくごと。
紅一点	こういってん。
紅白	こうはく。
紅白歌合戦	こうはくうたがっせん。
紅色	べにいろ。
紅茶	こうちゃ。
紅葉	もみじ。
納入	のうにゅう。
納入期限	のうにゅうきげん。
納品	のうひん。
納品書	のうひんしょ。
納得	なっとく。
納税	のうぜい。
納税者	のうぜいしゃ。
納豆	なっとう。
純利益	じゅんりえき。
純情	じゅんじょう。
純白	じゅんぱく。
純真	じゅんしん。
純金	じゅんきん。
純金積立	じゅんきんつみたて。
紙一重	かみひとえ。
紛争	ふんそう。
素人	しろうと。
素手	すで。
素材	そざい。
素直	すなお。
素行調査	そこうちょうさ。
素質	そしつ。
素足	すあし。
素顔	すがお。
紫外線	しがいせん。
紫式部	むらさきしきぶ。
紫色	むらさきいろ。
累積赤字	るいせきあかじ。
細工	さいく。
細心	さいしん。
細胞	さいぼう。
細菌	さいきん。
細道	ほそみち。
紹介	しょうかい。
紹介状	しょうかいじょう。
終始一貫	しゅうしいっかん。
終息	しゅうそく。
終戦	しゅうせん。
終戦記念日	しゅうせんきねんび。
終日	しゅうじつ。
終末期医療	しゅうまつきいりょう。
終業式	しゅうぎょうしき。
終止符	しゅうしふ。
終点	しゅうてん。
終着駅	しゅうちゃくえき。
終身刑	しゅうしんけい。
組体操	くみたいそう。
組織	そしき。
組織体質	そしきたいしつ。
組織力	そしきりょく。
組織図	そしきず。
組織的犯行	そしきてきはんこう。
経営	けいえい。
経営不振	けいえいふしん。
経営再建	けいえいさいけん。
経営学	けいえいがく。
経営統合	けいえいとうごう。
経営者	けいえいしゃ。
経営術	けいえいじゅつ。
経営計画	けいえいけいかく。
経営資源	けいえいしげん。
経歴	けいれき。
経済	けいざい。
経済不安	けいざいふあん。
経済再生	けいざいさいせい。
経済制裁	けいざいせいさい。
経済効果	けいざいこうか。
経済協力	けいざいきょうりょく。
経済協力開発機構	けいざいきょうりょくかいはつきこう。
経済危機	けいざいきき。
経済同友会	けいざいどうゆうかい。
経済団体	けいざいだんたい。
経済大国	けいざいたいこく。
経済学	けいざいがく。
経済学者	けいざいがくしゃ。
経済対策	けいざいたいさく。
経済悪化	けいざいあっか。
経済成長	けいざいせいちょう。
経済成長率	けいざいせいちょうりつ。
経済指標	けいざいしひょう。
経済援助	けいざいえんじょ。
経済政策	けいざいせいさく。
経済新聞	けいざいしんぶん。
経済最優先	けいざいさいゆうせん。
経済格差	けいざいかくさ。
経済活動	けいざいかつどう。
経済活性化	けいざいかっせいか。
経済活性化対策	けいざいかっせいかたいさく。
経済特区	けいざいとっく。
経済状況	けいざいじょうきょう。
経済産業省	けいざいさんぎょうしょう。
経済界	けいざいかい。
経済白書	けいざいはくしょ。
経済的	けいざいてき。
経由	けいゆ。
経費	けいひ。
経費削減	けいひさくげん。
経路	けいろ。
経路検索	けいろけんさく。
経過	けいか。
経験	けいけん。
経験則	けいけんそく。
経験者	けいけんしゃ。
経験豊富	けいけんほうふ。
結合	けつごう。
結婚	けっこん。
結婚式	けっこんしき。
結婚指輪	けっこんゆびわ。
結婚相手	けっこんあいて。
結婚記念日	けっこんきねんび。
結実	けつじつ。
結局	けっきょく。
結成	けっせい。
結末	けつまつ。
結束	けっそく。
結果	けっか。
結果発表	けっかはっぴょう。
結構	けっこう。
結論	けつろん。
給料	きゅうりょう。
給料日	きゅうりょうび。
給料明細	きゅうりょうめいさい。
給料袋	きゅうりょうぶくろ。
給料計算	きゅうりょうけいさん。
給水	きゅうすい。
給油	きゅうゆ。
給食	きゅうしょく。
給食当番	きゅうしょくとうばん。
給食費	きゅうしょくひ。
統一	とういつ。
統一地方選挙	とういつちほうせんきょ。
統治	とうち。
統率	とうそつ。
統計	とうけい。
統計学	とうけいがく。
絵巻物	えまきもの。
絵文字	えもじ。
絵日記	えにっき。
絵本	えほん。
絵画	かいが。
絵筆	えふで。
絵馬	えま。
絶交	ぜっこう。
絶体絶命	ぜったいぜつめい。
絶品	ぜっぴん。
絶大	ぜつだい。
絶好調	ぜっこうちょう。
絶対	ぜったい。
絶対値	ぜったいち。
絶対安静	ぜったいあんせい。
絶対服従	ぜったいふくじゅう。
絶対音感	ぜったいおんかん。
絶景	ぜっけい。
絶望	ぜつぼう。
絶滅	ぜつめつ。
絶滅動物	ぜつめつどうぶつ。
絶賛	ぜっさん。
絶賛発売中	ぜっさんはつばいちゅう。
絶頂	ぜっちょう。
絶頂期	ぜっちょうき。
絹糸	きぬいと。
絹織物	きぬおりもの。
継続	けいぞく。
継続勤務	けいぞくきんむ。
続出	ぞくしゅつ。
続行	ぞっこう。
維持	いじ。
維持管理	いじかんり。
維持費	いじひ。
綿密	めんみつ。
綿毛	わたげ。
綿織物	めんおりもの。
綿花	めんか。
綿雲	わたぐも。
緊張	きんちょう。
緊張感	きんちょうかん。
緊張状態	きんちょうじょうたい。
緊急	きんきゅう。
緊急地震速報	きんきゅうじしんそくほう。
緊急指令	きんきゅうしれい。
総事業費	そうじぎょうひ。
総会	そうかい。
総出	そうで。
総力	そうりょく。
総務省	そうむしょう。
総合	そうごう。
総合戦略	そうごうせんりゃく。
総合病院	そうごうびょういん。
総合職	そうごうしょく。
総工費	そうこうひ。
総意	そうい。
総書記	そうしょき。
総理	そうり。
総理大臣	そうりだいじん。
総称	そうしょう。
総選挙	そうせんきょ。
総重量	そうじゅうりょう。
総額	そうがく。
緑化	りょくか。
緑化運動	りょくかうんどう。
緑地	りょくち。
緑色	みどりいろ。
緑茶	りょくちゃ。
線対称	せんたいしょう。
線路	せんろ。
線香	せんこう。
線香花火	せんこうはなび。
編集	へんしゅう。
編集者	へんしゅうしゃ。
編集部	へんしゅうぶ。
練乳	れんにゅう。
練炭	れんたん。
練炭自殺	れんたんじさつ。
練習	れんしゅう。
練習問題	れんしゅうもんだい。
練習試合	れんしゅうじあい。
縁側	えんがわ。
縁談	えんだん。
縁談話	えんだんばなし。
縁起物	えんぎもの。
縄文式土器	じょうもんしきどき。
縦列駐車	じゅうれつちゅうしゃ。
縦横比	じゅうおうひ。
縦横無尽	じゅうおうむじん。
縦糸	たていと。
縮図	しゅくず。
縮小	しゅくしょう。
縮尺	しゅくしゃく。
織物	おりもの。
罪悪感	ざいあくかん。
罰則	ばっそく。
罰金	ばっきん。
署名	しょめい。
署長	しょちょう。
羊毛	ようもう。
美人	びじん。
美人局	つつもたせ。
美化運動	びかうんどう。
美味	びみ。
美声	びせい。
美女	びじょ。
美容	びよう。
美容室	びようしつ。
美容家電	びようかでん。
美容師	びようし。
美容成分	びようせいぶん。
美容法	びようほう。
美容院	びよういん。
美少女	びしょうじょ。
美徳	びとく。
美術	びじゅつ。
美術品	びじゅつひん。
美術展	びじゅつてん。
美術館	びじゅつかん。
美観	びかん。
美談	びだん。
群集心理	ぐんしゅうしんり。
群馬県	ぐんまけん。
義務	ぎむ。
義務化	ぎむか。
義務教育	ぎむきょういく。
義手	ぎしゅ。
義援金	ぎえんきん。
義母	ぎぼ。
義父	ぎふ。
義理	ぎり。
義理人情	ぎりにんじょう。
義足	ぎそく。
羽化	うか。
羽子板	はごいた。
羽毛	うもう。
羽織	はおり。
羽衣	はごろも。
羽音	はおと。
翌年	よくねん。
翌日	よくじつ。
翌月	よくげつ。
翌朝	よくあさ。
翌週	よくしゅう。
習字	しゅうじ。
習字教室	しゅうじきょうしつ。
習得	しゅうとく。
習性	しゅうせい。
習慣	しゅうかん。
老人	ろうじん。
老化	ろうか。
老化現象	ろうかげんしょう。
老化防止	ろうかぼうし。
老夫婦	ろうふうふ。
老女	ろうじょ。
老後	ろうご。
老後資金	ろうごしきん。
老木	ろうぼく。
老母	ろうぼ。
老眼	ろうがん。
老眼鏡	ろうがんきょう。
考古学	こうこがく。
考古学者	こうこがくしゃ。
考察	こうさつ。
考案	こうあん。
考案者	こうあんしゃ。
耐久力	たいきゅうりょく。
耐久性	たいきゅうせい。
耐震化	たいしんか。
耐震性	たいしんせい。
耐震補強	たいしんほきょう。
耕作	こうさく。
耕作地	こうさくち。
耕作放棄地	こうさくほうきち。
耕地	こうち。
耕地面積	こうちめんせき。
耳鼻科	じびか。
聖人	せいじん。
聖夜	せいや。
聖書	せいしょ。
聖母	せいぼ。
聖火	せいか。
聴覚	ちょうかく。
聴覚障害者	ちょうかくしょうがいしゃ。
職人	しょくにん。
職務	しょくむ。
職務経歴書	しょくむけいれきしょ。
職務質問	しょくむしつもん。
職員	しょくいん。
職員室	しょくいんしつ。
職場	しょくば。
職場体験	しょくばたいけん。
職場復帰	しょくばふっき。
職場恋愛	しょくばれんあい。
職業	しょくぎょう。
職業安定所	しょくぎょうあんていじょ。
職業病	しょくぎょうびょう。
職業能力	しょくぎょうのうりょく。
職業訓練	しょくぎょうくんれん。
職種	しょくしゅ。
肉体	にくたい。
肉体労働	にくたいろうどう。
肉体改造	にくたいかいぞう。
肉体美	にくたいび。
肉屋	にくや。
肉眼	にくがん。
肉筆	にくひつ。
肉親	にくしん。
肉食	にくしょく。
肉食動物	にくしょくどうぶつ。
肉食系男子	にくしょくけいだんし。
肝心	かんじん。
肝臓	かんぞう。
肥大	ひだい。
肥料	ひりょう。
肥満	ひまん。
肥満体	ひまんたい。
肥満度	ひまんど。
育児	いくじ。
育児休業	いくじきゅうぎょう。
育児休業制度	いくじきゅうぎょうせいど。
育児教室	いくじきょうしつ。
肺呼吸	はいこきゅう。
肺活量	はいかつりょう。
肺炎	はいえん。
胃液	いえき。
胃腸	いちょう。
胃腸薬	いちょうやく。
胃薬	いぐすり。
胃酸	いさん。
胆石	たんせき。
背中	せなか。
背信行為	はいしんこうい。
背広	せびろ。
背後	はいご。
背景	はいけい。
背番号	せばんごう。
背筋力	はいきんりょく。
背骨	せぼね。
胞子	ほうし。
胸中	きょうちゅう。
胸像	きょうぞう。
胸元	むなもと。
胸囲	きょうい。
胸板	むないた。
胸焼	むねやけ。
胸部	きょうぶ。
能力	のうりょく。
能力主義	のうりょくしゅぎ。
能天気	のうてんき。
能率	のうりつ。
脅威	きょうい。
脅迫	きょうはく。
脅迫罪	きょうはくざい。
脚本	きゃくほん。
脚本家	きゃくほんか。
脱会	だっかい。
脱出	だっしゅつ。
脱原発	だつげんぱつ。
脱原発派	だつげんぱつは。
脱水	だっすい。
脱皮	だっぴ。
脱税	だつぜい。
脱線	だっせん。
脱落	だつらく。
脱落者	だつらくしゃ。
脱衣室	だついしつ。
脱衣所	だついじょ。
脱走	だっそう。
脱退	だったい。
脳出血	のうしゅっけつ。
脳卒中	のうそっちゅう。
脳天気	のうてんき。
脳死判定	のうしはんてい。
脳科学	のうかがく。
脳裏	のうり。
腕前	うでまえ。
腕力	わんりょく。
腕時計	うでどけい。
腹八分	はらはちぶ。
腹痛	ふくつう。
腹黒	はらぐろ。
臓器	ぞうき。
臓器売買	ぞうきばいばい。
臓器提供	ぞうきていきょう。
臓器移植	ぞうきいしょく。
臨時	りんじ。
臨時国会	りんじこっかい。
臨機応変	りんきおうへん。
臨海学校	りんかいがっこう。
臨終	りんじゅう。
自主再建	じしゅさいけん。
自主回収	じしゅかいしゅう。
自伝	じでん。
自供	じきょう。
自信	じしん。
自信過剰	じしんかじょう。
自分	じぶん。
自分勝手	じぶんかって。
自分自身	じぶんじしん。
自力	じりょく。
自動	じどう。
自動制御	じどうせいぎょ。
自動的	じどうてき。
自動販売機	じどうはんばいき。
自動車	じどうしゃ。
自動車会社	じどうしゃがいしゃ。
自動車保険	じどうしゃほけん。
自動車修理工場	じどうしゃしゅうりこうじょう。
自動車取得税	じどうしゃしゅとくぜい。
自動車整備士	じどうしゃせいびし。
自動車株	じどうしゃかぶ。
自動車業界	じどうしゃぎょうかい。
自動車産業	じどうしゃさんぎょう。
自動車部品	じどうしゃぶひん。
自動車重量税	じどうしゃじゅうりょうぜい。
自動運転	じどううんてん。
自営業者	じえいぎょうしゃ。
自国	じこく。
自宅	じたく。
自家発電機	じかはつでんき。
自尊心	じそんしん。
自己	じこ。
自己中心的	じこちゅうしんてき。
自己主張	じこしゅちょう。
自己流	じこりゅう。
自己満足	じこまんぞく。
自己破産	じこはさん。
自己紹介	じこしょうかい。
自己負担	じこふたん。
自己負担額	じこふたんがく。
自己資本	じこしほん。
自己資本利益率	じこしほんりえきりつ。
自意識過剰	じいしきかじょう。
自慢	じまん。
自業自得	じごうじとく。
自殺	じさつ。
自殺者	じさつしゃ。
自治	じち。
自治体	じちたい。
自治政府	じちせいふ。
自治権	じちけん。
自然	しぜん。
自然体	しぜんたい。
自然保護	しぜんほご。
自然公園	しぜんこうえん。
自然数	しぜんすう。
自然災害	しぜんさいがい。
自然現象	しぜんげんしょう。
自然環境	しぜんかんきょう。
自然界	しぜんかい。
自然発火	しぜんはっか。
自然科学	しぜんかがく。
自由	じゆう。
自由化	じゆうか。
自由席	じゆうせき。
自由研究	じゆうけんきゅう。
自由自在	じゆうじざい。
自由貿易	じゆうぼうえき。
自画像	じがぞう。
自画自賛	じがじさん。
自発的	じはつてき。
自白	じはく。
自立	じりつ。
自筆	じひつ。
自給自足	じきゅうじそく。
自習	じしゅう。
自習室	じしゅうしつ。
自習時間	じしゅうじかん。
自衛	じえい。
自衛官	じえいかん。
自衛隊	じえいたい。
自覚	じかく。
自覚症状	じかくしょうじょう。
自負	くふ。
自販機	じはんき。
自責	じせき。
自費	じひ。
自費出版	じひしゅっぱん。
自身	じしん。
自転	じてん。
自転車	じてんしゃ。
自転車操業	じてんしゃそうぎょう。
自重	じちょう。
自閉症	じへいしょう。
自首	じしゅ。
至急	しきゅう。
至近距離	しきんきょり。
至難	しなん。
致命傷	ちめいしょう。
興味	きょうみ。
舞台	ぶたい。
舞台装置	ぶたいそうち。
舞台設定	ぶたいせってい。
航海	こうかい。
航海士	こうかいし。
航海日誌	こうかいにっき。
航海訓練所	こうかいくんれんじょ。
航空	こうくう。
航空便	こうくうびん。
航空券	こうくうけん。
航空業界	こうくうぎょうかい。
航空機	こうくうき。
航空自衛隊	こうくうじえいたい。
航路	こうろ。
船便	ふなびん。
船出	ふなで。
船底	ふなぞこ。
船旅	ふなたび。
船長	せんちょう。
良好	りょうこう。
良心	りょうしん。
良薬	りょうやく。
良識	りょうしき。
色彩	しきさい。
色白	いろじろ。
色眼鏡	いろめがね。
色紙	しきし。
色素	しきそ。
花吹雪	はなふぶき。
花園	はなぞの。
花形	はながた。
花束	はなたば。
花火	はなび。
花火大会	はなびたいかい。
花畑	はなばたけ。
花粉	かふん。
花見	はなみ。
花言葉	はなことば。
花輪	はなわ。
芸人	げいにん。
芸名	げいめい。
芸能事務所	げいのうじむしょ。
芸能人	げいのうじん。
芸能界	げいのうかい。
芸術	げいじゅつ。
芸術作品	げいじゅつさくひん。
芸術品	げいじゅつひん。
芸術家	げいじゅつか。
若人	わこうど。
若干	じゃっかん。
若年層	じゃくねんそう。
若手	わかて。
若手俳優	わかてはいゆう。
若者	わかもの。
若芽	わかめ。
若菜	わかな。
若葉	わかば。
苦労	くろう。
苦味	にがみ。
苦境	くきょう。
苦心	くしん。
苦情	くじょう。
苦情処理	くじょうしょり。
苦戦	くせん。
苦手	にがて。
苦痛	くつう。
苦笑	くしょう。
苦虫	にがむし。
苦言	くげん。
英会話	えいかいわ。
英単語	えいたんご。
英和辞書	えいわじてん。
英国	えいこく。
英才教育	えいさいきょういく。
英文	えいぶん。
英断	えいだん。
英訳	えいやく。
英語	えいご。
英語教育	えいごきょういく。
英語検定	えいごけんてい。
茨城県	いばらきけん。
茶会	ちゃかい。
茶化	ちゃか。
茶柱	ちゃばしら。
茶畑	ちゃばたけ。
茶色	ちゃいろ。
茶道	さどう。
草原	のはら。
草木	くさき。
草案	そうあん。
草笛	くさぶえ。
草花	くさばな。
草野球	くさやきゅう。
草食	そうしょく。
草食動物	そうしょくどうぶつ。
草食系	そうしょくけい。
草食系男子	そうしょくけいだんし。
荷札	にふだ。
荷物	にもつ。
荷車	にぐるま。
菌類	きんるい。
菜園	さいえん。
菜種	なたね。
菜種油	なたねあぶら。
落下	らっか。
落下物	らっかぶつ。
落城	らくじょう。
落札額	らくさつがく。
落第	らくだい。
落第点	らくだいてん。
落葉	らくよう。
落葉樹	らくようじゅ。
落語	らくご。
落選	らくせん。
落雷	らくらい。
落馬	らくば。
葉巻	はまき。
葉桜	はざくら。
葉緑素	ようりょくそ。
葉脈	ようみゃく。
著作	ちょさく。
著作権	ちょさくけん。
著作権侵害	ちょさくけんしんがい。
著作権法	ちょさくけんほう。
著名	ちょめい。
著書	ちょしょ。
著者	ちょしゃ。
蒸気	じょうき。
蒸気機関	じょうききかん。
蒸気機関車	じょうききかんしゃ。
蒸気船	じょうきせん。
蒸留	じょうりゅう。
蒸留水	じょうりゅうすい。
蒸留酒	じょうりゅうしゅ。
蒸発	じょうはつ。
蔵書	ぞうしょ。
薬剤師	やくざいし。
薬効	やっこう。
薬味	やくみ。
薬品	やくひん。
薬局	やっきょく。
薬指	くすりゆび。
薬物汚染	やくぶつおせん。
薬草	やくそう。
虫歯	むしば。
虫眼鏡	むしめがね。
血圧	けつあつ。
血圧計	けつあつけい。
血液	けつえき。
血液型	けつえきがた。
血液検査	けつえきけんさ。
血潮	ちしお。
血相	けっそう。
血眼	ちまなこ。
血筋	ちすじ。
血管	けっかん。
血糖値	けっとうち。
血統書	けっとうしょ。
血縁関係	けつえんかんけい。
血肉	けつにく。
血行	けっこう。
血行促進	けっこうそくしん。
衆参両院	しゅうさんりょういん。
衆知	しゅうち。
衆議院	しゅうぎいん。
衆議院解散	しゅうぎいんかいさん。
衆院議員	しゅういんぎいん。
衆院選	しゅういんせん。
行事	ぎょうじ。
行使	こうし。
行列	ぎょうれつ。
行動	こうどう。
行動計画	こうどうけいかく。
行司	ぎょうじ。
行商	ぎょうしょう。
行政	ぎょうせい。
行政処分	ぎょうせいしょぶん。
行政指導	ぎょうせいしどう。
行政改革	ぎょうせいかいかく。
行政書士	ぎょうせいしょし。
行政書士試験	ぎょうせいしょししけん。
行政機関	ぎょうせいきかん。
行方	ゆくえ。
行方不明	ゆくえふめい。
行方不明者	ゆくえふめいしゃ。
行楽地	こうらくち。
行為	こうい。
行進	こうしん。
行進曲	こうしんきょく。
行間	ぎょうかん。
街灯	がいとう。
街角	まちかど。
街頭	がいとう。
街頭演説	がいとうえんぜつ。
衛星	えいせい。
衛星放送	えいせいほうそう。
衛星電話	えいせいでんわ。
衛生	えいせい。
衛生管理	えいせいかんり。
衣料品販売	いりょうひんはんばい。
衣服	いふく。
衣装	いしょう。
衣類	いるい。
衣食住	いしょくじゅう。
表彰台	ひょうしょうだい。
表彰式	ひょうしょうしき。
表彰状	ひょうしょうじょう。
表情	ひょじょう。
表敬訪問	ひょうけいほうもん。
表札	ひょうさつ。
表現	ひょうげん。
表現力	ひょうげんりょく。
表示	ひょうじ。
表示価格	ひょうじかかく。
表紙	ひょうし。
表裏	ひょうり。
表記	ひょうき。
表門	おもてもん。
表面	ひょうめん。
表面化	ひょうめんか。
表面張力	ひょうめんちょうりょく。
衰弱	すいじゃく。
衰弱死	すいじゃくし。
衰退	すいたい。
被告	ひこく。
被告人	ひこくにん。
被害	ひがい。
被害届	ひがいとどけ。
被害総額	ひがいそうがく。
被害者	ひがいしゃ。
被害額	ひがいがく。
被災地	ひさいち。
被災状況	ひさいじょうきょう。
被災者支援	ひさいしゃしえん。
被爆体験	ひばくたいけん。
裁判	さいばん。
裁判員制度	さいばんいんせいど。
裁判官	さいばんかん。
裁判所	さいばんしょ。
裁判長	さいばんちょう。
装備	そうび。
装置	そうち。
裏側	うらがわ。
裏千家	うらせんけ。
裏口	うらぐち。
裏口入学	うらぐちにゅうがく。
裏声	うらごえ。
裏目	うらめ。
裏腹	うらはら。
裏表	うらおもて。
裏話	うらばなし。
裏面	うらめん。
補佐	ほさ。
補充	ほじゅう。
補助	ほじょ。
補助輪	ほじょりん。
補助金	ほじょきん。
補導	ほどう。
補強	ほきょう。
補強材	ほきょうざい。
補欠	ほけつ。
補正予算	ほせいよさん。
補正予算案	ほせいよさんあん。
補給	ほきゅう。
補習	ほしゅう。
補聴器	ほちょうき。
補足	ほそく。
製作	せいさく。
製作所	せいさくじょ。
製品	せいひん。
製品開発	せいひんかいはつ。
製図	せいず。
製本	せいほん。
製氷	せいひょう。
製氷機	せいひょうき。
製法	せいほう。
製紙	せいし。
製綱	せいこう。
製薬業界	せいやくぎょうかい。
製造	せいぞう。
製造元	せいぞうもと。
製造年月日	せいぞうねんがっぴ。
製造所固有記号	せいぞうしょこゆうきごう。
製造技術	せいぞうぎじゅつ。
製造業	せいぞうぎょう。
製造物責任法	せいぞうぶつせきにんほう。
製造番号	せいぞうばんごう。
製造者	せいぞうしゃ。
製造販売	せいぞうはんばい。
製造販売元	せいぞうはんばいもと。
製造過程	せいぞうかてい。
製鉄	せいてつ。
製鉄所	せいてつじょ。
複写	ふくしゃ。
複合映画施設	ふくごうえいがしせつ。
複合機	ふくごうき。
複数	ふくすう。
複数形	ふくすうけい。
複眼	ふくがん。
複製	ふくせい。
複雑	ふくざつ。
西日	にしび。
西日本	にしにほん。
西洋	せいよう。
西洋人	せいようじん。
西洋料理	せいようりょうり。
西遊記	さいゆうき。
西部	せいぶ。
要人	ようじん。
要介護者	ようかいごしゃ。
要因	よういん。
要望	ようぼう。
要望書	ようぼうしょ。
要求	ようきゅう。
要注意	ようちゅうい。
要点	ようてん。
要約	ようやく。
要素	ようそ。
要領	ようりょう。
見事	みごと。
見学	けんがく。
見学会	けんがくかい。
見学料	けんがくりょう。
見所	みどころ。
見方	みかた。
見本	みほん。
見栄	みえ。
見物	みもの。
見物人	けんぶつにん。
見聞	けんぶん。
見解	けんかい。
見識	けんしき。
規制	きせい。
規制強化	きせいきょうか。
規制改革	きせいかいかく。
規制緩和	きせいかんわ。
規則	きそく。
規則性	きそくせい。
規則的	きそくてき。
規定	きてい。
規律	きりつ。
規模	きぼ。
規約	きやく。
視力	しりょく。
視力障害	しりょくしょうがい。
視察	しさつ。
視点	してん。
視界	しかい。
視界不良	しかいふりょう。
視界良好	しかいりょうこう。
視神経	ししんけい。
視線	しせん。
視聴率	しちょうりつ。
視覚障害者	しかくしょうがいしゃ。
視野	しや。
親不孝	おやふこう。
親分	おやぶん。
親切	しんせつ。
親友	しんゆう。
親子	おやこ。
親子丼	おやこどん。
親子関係	おやこかんけい。
親孝行	おやこうこう。
親不孝	おやふこう。
親密	しんみつ。
親心	おやごころ。
親愛	しんあい。
親指	おやゆび。
親方	おやかた。
親日家	しんにちか。
親潮	おやしお。
親父	おやじ。
親身	しんみ。
親近感	しんきんかん。
親馬鹿	おやばか。
観光	かんこう。
観光協会	かんきょうきょうかい。
観光地	かんこうち。
観光客	かんこうきゃく。
観光旅行	かんこうりょこう。
観光業界	かんこうぎょうかい。
観光産業	かんきょうさんぎょう。
観光資源	かんこうしげん。
観客	興行などを見る人、見物人のこと。
観客席	カンキャクセキ。
観察	物事の状態や変化を客観的に注意深く見ること。
観察力	カンサツリョク。
観戦	試合などを見物すること。
観測	カン察しソク定すること。
観測所	カンソクジョ。
観点	物事を考察・判断するときの立場。カンテン。
観衆	大勢のカン客・見物人。カンシュウ。
観賞	美しいものを見て味わい心を楽しませること。 
角度	カクの大きさ。
角材	カクザイ。
角柱	多カッ形を底面とするハシラ。カクチュウ。
角笛	ツノブエ。
解体	まとまっているものを、分カイすること。
解体作業	カイタイサギョウ。
解体工事	カイタイコウジ。
解体新書	カイタイシンショ。
解凍	凍結状態を戻すこと。
解放	束縛や制限を取り除いて自由にすること。
解放感	カイホウカン。
解散	会合・団体などが活動をやめて人々が別れチること。
解散総選挙	カイサンソウセンキョ。
解明	わからない事柄をアキらかにすること。
解決	物事や問題を片付けること。
解決済	カイケツズみ。
解決策	カイケツサク。
解消	それまであった関係・状態などをなくすること。
解消法	カイショウホウ。
解熱剤	ゲネツザイ。
解禁	法律などでキン止していたことをトくこと。
解答	問題をトいてコタえを出すこと。
解約	契ヤクを取り消すこと。
解説	物事をわかりやすいように説明すること。
解説者	カイセツシャ。
解釈	表現をトきほぐして意味を明らかにすること。
触感	物にフれた時のカンじ。
触角	頭部から突出し、感覚を司る器官。
言動	コト葉と行ドウ。
言葉	音声または文字による表現のまとまり。
言行一致	ゲンコウイッチ。
言行不一致	ゲンコウフイッチ。
言訳	イいワケ。
言語	コト葉の種類。日本ゴとか英ゴとか。
言語学者	ゲンゴガクシャ。
言語道断	コト葉ではイい表せないほど、まちがったこと。
言論	コト葉によって意見や思想を公表すること。ゲンロン。
言論統制	ゲンロントウセイ。
計器	ケイ量キ械。
計画	プラン。プロジェクト。
計算	数式に従って処理した結果の数値を引き出すこと。
計算機	コンピューター。
計量	重リョウ・分リョウなどをハカること。
討論	ある問題について、互いに意見を述べ合うこと。
討議	ある事について、互いに意見を交わし論じ合うこと。
訓練	トレーニング。
訓読	クンヨみ。
記事	新聞・雑誌などで伝えるコト柄と文章。
記入	書きイれること。
記号	キゴウ。
記念	思い出となるように残しておくこと。
記念写真	キネンシャシン。
記念切手	キネンキッテ。
記念品	キネンヒン。
記念日	キネンビ。
記念病院	キネンビョウイン。
記念硬貨	キネンコウカ。
記念行事	キネンギョウジ。
記憶	頭の中で覚えておくこと。メモリー。
記憶力	キオクリョク。
記者	取材したり、キ事を書いたり、編集したりする人。
記者会見	キシャカイケン。
記載	書類・書物などに書いてシルすこと。キサイ。
記述	文を書きシルすこと。
記述問題	キジュツモンダイ。
記述式	キジュツシキ。
記録	後世に残すために物事を書きシルすこと。レコード。
記録保持者	キロクホジシャ。
記録媒体	キロクバイタイ。
記録的	キロクテキ。
記録的大雨	キロクテキオオアメ。
訪問	他人の家などをオトズれること。
訪問介護	ホウモンカイゴ。
訪問看護	ホウモンカンゴ。
訪問者	ホウモンシャ。
設備	必要な建物・装置などをソナえ付けたもの。セツビ。
設備投資	セツビトウシ。
設定	ある物事や条件を作りサダめること。「舞台○○」
設立	学校・会社などの機関や組織を新しく作ること。
設置	新たな部署や部門や機械などをオくこと。
設置費用	セッチヒヨウ。
設計	デザイン。
設計図	セッケイズ。
許可	禁止されている行為を特定の場合または人に限ってユルすこと。
許可証	キョカショウ。
許容	ある程度までをユルして受け入れること。 
許容範囲	キョヨウハンイ。
訳者	翻ヤクした人。翻ヤクシャ。
診察室	シンサツシツ。
診断書	シンダンショ。
証人	ある事実をショウ明するヒト。
証券会社	ショウケンガイシャ。
証拠品	ショウコヒン。
証明	ある事柄が事実であることをアキらかにすること。
証明写真	ショウメイシャシン。
証言	事柄が事実であることをコト葉によってショウ明すること。
評価	物事の善悪などを考え、カ値を定めること。 
評判	世間でのうわさ。
評論	物事の善悪・価値などについて批ヒョウし、ロンじること。
評論家	ヒョウロンカ。
試作品	シサクヒン。
試作機	シサクキ。
試合	スポーツ・武術などの技を比べ合い勝敗を競うこと。
試合時間	シアイジカン。
試合終了	シアイシュウリョウ。
試合開始	シアイカイシ。
試練	信仰心や実力などを厳しくタメすこと、またはその苦難。
試運転	シウンテン。
試食	タメしにタべてみること。
試食会	シショクカイ。
試食販売	シショクハンバイ。
試験	テスト。
試験官	シケン場の監督をする人。
試験導入	シケンドウニュウ。
試験管	シケンカン。円筒形。
試験紙	シケンシ。
詩人	シを書き、それを発表するヒト。
詩歌	和カ・俳句・シなど韻文の総称。
詩集	シをアツめた書物。
話題	ワダイ。
認印	ミトメイン。
認可	ニンカ。
認定	資格・事実の有無などを調べて決めること。
認知度	ニンチド。
認知機能	ニンチキノウ。
認知症	ニンチショウ。
認識	ある物事を知り、その本質などを理解すること。
認識不足	ニンシキブソク。
誕生日	タンジョウビ。
語句	文章を組み立てているゴとク。
語学	ゴガク。
語学留学	ゴガクリュウガク。
語手	カタりテ。
語源	単語の一番初めの音形と意味。
誠実	偽りがなく、まじめなこと。
誠意	うそ偽りのない心。
誤報	間違えて知らせること。
誤字	間違ったジ。
誤字脱字	ゴジダツジ。
誤差	真の値と測定値または近似値とのサ。
誤算	計算間違い。見込み違い。
誤解	間違った理カイやカイ釈。
誤訳	間違った翻ヤク。
誤認	アヤマったニン識を持つこと。
説得	よく話して、相手に納トクさせること。
説得力	セットクリョク。
説教	オシえ導くために言い聞かせること。「親に○○される」
説明	トきアかして教えること。
説明不足	セツメイブソク。
説明会	セツメイカイ。
説明文	セツメイブン。
説明責任	セツメイセキニン。
読書	本をヨむこと。
読書感想文	ドクショカンソウブン。
読本	やさしく書かれた入門書や解説書。ドクホン。
読点	「、」
読物	ヨみモノ。
読破	ドクハ。
読者	本などをヨんでいる人。
読解力	ドッカイリョク。
課外授業	カガイジュギョウ。
課外活動	カガイカツドウ。
課程	教育や訓練で秩序立って学ぶ一連の流れ。
課税	ゼイ金をカすこと。
課税対象	カゼイタイショウ。
課長	部署あるいは一部門としての課の責任者。
課題	与えられたダイ。解決しなければならない問ダイ。
調合	薬品を混ぜ合わせること。
調味料	チョウミリョウ。
調和	物事の間に釣り合いがとれていること。
調子	音・気分・体チョウなどの状態。「○○に乗る」「○○が悪い」
調教	人間・動物に対して行われる訓練。
調教師	チョウキョウシ。
調整	調子の悪いものに手を加えてトトノえること。
調整中	チョウセイチュウ。
調査	事を明らかにするためにシラべること。
調査中	チョウサチュウ。
調査内容	チョウサナイヨウ。
調査委員会	チョウサイインカイ。
調査目的	チョウサモクテキ。
調査結果	チョウサケッカ。
調理	食べ物を食べやすくおいしく料リすること。
調理台	チョウリダイ。
調理器具	チョウリキグ。
調理場	チョウリバ。
調理家電	チョウリカデン。
調理師	チョウリシ。
調節	チョウセツ。
調達	求めに応じて金品を送り届けること。
談合	ダンゴウ。
談話	ダンワ。
請求書	セイキュウショ。
論争	怒ってロンじ合うこと。言葉のアラソい。
論外	議ロンの範囲ガイのこと。ロンずる価値のないこと。
論文	あるテーマについてロン理的に書き記したブン章。
論文発表	ロンブンハッピョウ。
論理	議ロンや思考を進める道筋。 ロジック。
諸君	ショクン。
諸国	多くのクニ。いろいろなクニ。
諸島	多くのシマ。いろいろなシマ。
諸説	いろいろなセツ。
講師	コウ演・コウ義をする人。
講座	コウ義の行われる場。
講演	聴衆の前で、あるテーマについて話をすること。
講演会	コウエンカイ。
講演料	コウエンリョウ。
講義	人々に学説・物事などの意味や内容を口頭で説明すること。
講習	人を集めて一定期間、学問・技芸などを教え指導すること。
講習会	コウシュウカイ。
謝礼	感謝・おレイの気持ちを表す金品。
謝礼金	シャレイキン。
謝罪	ツミや過ちをわびること。
謝罪文	シャザイブン。
識別	物事の相違を見分けること。
識字率	シキジリツ。
識者	物事に対して正しい判断をくだす力のある人。
警備	セキュリティ。
警備会社	ケイビガイシャ。
警備員	ケイビイン。
警備強化	ケイビキョウカ。
警告	起こりえる悪い状況について、前もって注意を与えておくこと。
警報	都合の悪いことが起きたことや起きそうなことを広く知らせること。
警報音	ケイホウオン。
警官	ケイ察カン。
警察	ポリス。
警察学校	ケイサツガッコウ。
警察官	ケイサツカン。
警察犬	ケイサツケン。
警察署	ケイサツショ。
警察署長	ケイサツショチョウ。
警察関係者	ケイサツカンケイシャ。
警戒区域	ケイカイクイキ。
警戒情報	ケイカイジョウホウ。
警視庁	ケイシチョウ。
警護	人・物などをケイ戒して守ること。
議事堂	ギジドウ。
議会	ギカイ。
議会政治	ギカイセイジ。
議員	ギ会の構成イン。
議員定数削減	ギインテイスウサクゲン。
議員年金	ギインネンキン。
議員立法	ギインリッポウ。
議案	会ギで審ギ・決定するための原アン。
議論	ギロン。
議長	会ギの最高責任者。
議院内閣制	ギインナイカクセイ。
議題	会ギで行うギ論のダイ材。
護岸工事	ゴガンコウジ。
護衛艦	ゴエイカン。
護身術	ゴシンジュツ。
豆知識	マメチシキ。
豆電球	マメデンキュウ。
豊作	サク物がたくさん収穫されること。
豊富	ユタかであること。ふんだんにあること。
豊年	ホウ作のトシ。
豊胸手術	ホウキョウシュジュツ。
豊臣秀吉	安土桃山時代の戦国大名。天下統一を成し遂げる。
象形文字	ショウケイモジ。
貝柱	カイバシラ。
負債総額	フサイソウガク。
負債額	フサイガク。
負傷	キズをオうこと。
負傷者	フショウシャ。
負担	背オったり、肩に担いだりすること。
負担割合	フタンワリアイ。
負担増	フタンゾウ。
負担軽減	フタンケイゲン。
負数	マイナスのカズ。
負荷	電力などを消費するもの。ニ物の重さ。
財力	ザイリョク。
財務体質	ザイムタイシツ。
財務省	ザイムショウ。
財宝	ザイホウ。
財布	おサイフ。
財政	国や公共団体の経済活動。
財政事情	ザイセイジジョウ。
財政健全化	ザイセイケンゼンカ。
財政健全化目標	ザイセイケンゼンカモクヒョウ。
財政再建	ザイセイサイケン。
財政収支	ザイセイシュウシ。
財政投融資	ザイセイトウユウシ。
財政支出	ザイセイシシュツ。
財政支援	ザイセイシエン。
財政赤字	ザイセイアカジ。
財政難	ザイセイナン。
財源	ザイゲン。
財産	ザイサン。
財界	ザイカイ。
貧困	ヒンコン。
貧困家庭	ヒンコンカテイ。
貧富	マズしいこととトんでいること。
貧弱	ヒンジャク。
貧血	ヒンケツ。
貨物	カモツ。
貨車	カ物列シャ。
販促	ハン売ソク進。
販売	商品をウりに出すこと。
販売価格	ハンバイカカク。
販売促進	ハンバイソクシン。
販売元	ハンバイモト。
販売好調	ハンバイコウチョウ。
販売実績	ハンバイジッセキ。
販売広告	ハンバイコウコク。
販売手法	ハンバイシュホウ。
販売計画	ハンバイケイカク。
販路拡大	ハンロカクダイ。
貫通	中をツラヌいて反対側に抜けること。
責任	セキニン。
責任感	セキニンカン。
責任者	セキニンシャ。
責務	セキ任と義ム。果たさなければならないツトめ。
貯水	ミズをタめること。
貯蔵	タクワえ、しまっておくこと。
貯金	おカネをタめること。
貯金箱	チョキンバコ。
貴族	社会の支配階級。キゾク。
貴重	非常に価値のあるさま。「○○な本」
貴重品	キチョウヒン。
貴金属	キキンゾク。
買値	カいネ。
買収	バイシュウ。
買収金額	バイシュウキンガク。
貸付	カしツけ。
貸付金	カシツケキン。
貸借	カすこととカりること。カしカり。
貸借対照表	タイシャクタイショウヒョウ。
貸出	カシダシ。
貸出図書	カシダシトショ。
貸出金利	カシダシキンリ。
貸切温泉	カシキリオンセン。
貸切風呂	カシキリブロ。
貸家	カしイエ。
貸本	カシホン。
費用	ヒヨウ。
費用対効果	ヒヨウタイコウカ。
貿易	二国間の商品の売買行為。
貿易収支	ボウエキシュウシ。
貿易立国	ボウエキリッコク。
貿易統計	ボウエキトウケイ。
貿易赤字	ボウエキアカジ。
貿易風	ボウエキフウ。
貿易黒字	ボウエキクロジ。
賀正	正月を祝うこと。
賃上	チンアげ。
賃貸	カしチンをとって物をカすこと。
賃金	チンギン。
賃金上昇	チンギンジョウショウ。
賃金体系	チンギンタイケイ。
賃金格差	チンギンカクサ。
資料	調査や研究の参考にするデータや文献。
資料作成	シリョウサクセイ。
資本	シホン。
資本主義	シホンシュギ。
資本家	シホンカ。
資本論	シホンロン。
資本金	シホンキン。
資材	ある物を作るもととなるザイ料。シザイ。
資格	あることをする場合の、人の立場や地位。
資格試験	シカクシケン。
資源	産業のもととなる有用物。リソース。
資源調査	シゲンチョウサ。
資源開発	シゲンカイハツ。
資産家	シサンカ。
資産運用	シサンウンヨウ。
資金	用意され使われるキン銭。
資金不足	シキンブソク。
資金洗浄	マネーロンダリング。
資金源	シキンゲン。
資金調達	シキンチョウタツ。
賛同	人の意見・提案などに、サン成・ドウ意すること。
賛否両論	サンピリョウロン。
賛成	提案や意見に同意すること。
賛成多数	サンセイタスウ。
賛成意見	サンセイイケン。
賛成派	サンセイハ。
賛成者	サンセイシャ。
賞味期限	ショウミキゲン。
賞品	成績の良かった者に与えられる品物。
賞状	表彰ジョウ・認定証・感謝ジョウなど。
賞賛	ほめたたえること。ショウサン。
賞金	ショウとして与えるキン銭。
質問	疑モン点やわからない点をトいタダすこと。 
質問状	シツモンジョウ。
質問箱	シツモンバコ。
質屋	シチヤ。
質疑応答	シツギオウトウ。
質素	シッソ。
質素倹約	シッソケンヤク。
質量	物体がもともと持っている重さのリョウ。
購入	買いイれること。
購入額	コウニュウガク。
購読	書籍や新聞・雑誌などを買ってヨむこと。
購読者	コウドクシャ。
購買力	コウバイリョク。
赤信号	アカいシンゴウ。
赤十字	白地にアカいジュウジを書いた記章。「○○○社」
赤外線	熱作用が強く、目に見えない光セン。
赤子	アカゴ。
赤字	支出が収入より多いこと。不足額。
赤字決算	アカジケッサン。
赤字解消	アカジカイショウ。
赤字路線	アカジロセン。
赤富士	フジ山がアカく見える現象。
赤提灯	アカチョウチン。
赤潮	海や湖などがアカく変色する現象。
赤組	アカのクミ。
赤色	アカいイロ。
赤血球	ヘモグロビンを含むケツ液中のたんぱく質。酸素を運ぶ。
赤道	日射量が最も多い場所をたどる線。地図ではアカ線で表される。
赤面	アカらガオ。
赤飯	セキハン。
走者	ランナー。
走行	自動車などがハシること。
走行距離	ソウコウキョリ。
起死回生	だめになりそうだったものが、よい状態にもどること。
起源	物事のオこり。始まり。ミナモト。
起立	「○○！　礼！　着席！」
超党派	各政党の政策・主張を超えて協力し合うこと。
超難問	チョウナンモン。
超高層	非常にタカい建築物。「○○○ビル」
足元	アシモト。
足場	アシバ。
足算	タしザン。
足跡	アシアト。
足音	アシオト。
足首	アシクビ。
距離	キョリ。
距離感	キョリカン。
路上	道ロのウエ。
路上駐車	ロジョウチュウシャ。
路線価	ロセンカ。
路面凍結	ロメントウケツ。
路頭	「妻子が○○に迷う」
身代金	ミノシロキン。
身体	カラダ。
身体検査	シンタイケンサ。
身体能力	シンタイノウリョク。
身体障害	シンタイショウガイ。
身元	ミモト。
身元不明	ミモトフメイ。
身元保証人	ミモトホショウニン。
身元保証書	ミモトホショウショ。
身元調査	ミモトチョウサ。
身内	ミウチ。
身分	ミブン。
身分証明書	ミブンショウメイショ。
身動	ミウゴき。
身支度	ミジタク。
身柄確保	ミガラカクホ。
身軽	ミガル。
身辺整理	シンペンセイリ。
身辺調査	シンペンチョウサ。
身近	ミジカ。
身長	シン体のナガさ。
車両	貨客を輸送するためのクルマ。シャリョウ。
車両保険	シャリョウホケン。
車両消毒	シャリョウショウドク。
車体	クルマのボディー。
車庫	自動シャをとめておく倉コ。
車社会	クルマで成り立つシャカイ。
車窓	クルマのマド。
車輪	シャリン。
車道	クルマの通るミチ。シャドウ。
軍事	グン隊・グン備・戦争に関するコト。
軍事作戦	グンジサクセン。
軍事力	グジリョク。
軍事境界線	グンジキョウカイセン。
軍事大国	グンジ力の強いタイコク。
軍事専門家	グンジセンモンカ。
軍事政権	グンジセイケン。
軍事演習	グンジエンシュウ。
軍事行動	グンジコウドウ。
軍事衛星	グンジに使う人工エイセイ。
軍事衝突	グンジショウトツ。
軍事訓練	グンジクンレン。
軍事費	グンジに使うヒ用。
軍人	戦争に従事するヒト。兵士。
軍国主義	グンコクシュギ。
軍手	白の太い木綿糸で編んだ手袋。作業用。
軍拡競争	グンカクキョウソウ。
軍施設	グンシセツ。
軍服	グン人用のフク。
軍縮	グン備シュク小の略。
軍艦	グンカン。
軍隊	グン人の集団。
転倒	すべってコロぶこと。
転勤	キン務先が変わること。
転居	住キョを変えること。
転居届	テンキョトドケ。
転換	気持ち、方針、方向などを異なるものに変えること。
転校	通学する学コウが変わること。
転校生	テンコウしたセイ徒。
転落	コロんでオちること。
転落死	テンラクシ。
転身	ミ分・職業などをすっかり変えること。
転送	情報やデータを他へオクり出すこと。
軽乗用車	ケイジョウヨウシャ。
軽傷	カルいキズ。
軽口	カルクチ。
軽工業	ケイコウギョウ。
軽快	カロやかで気分がいいこと。
軽業	カルワザ。
軽油	ディーゼル燃料。
軽減	カルくしてヘらすこと。
軽犯罪	ケイハンザイ。
軽率	よく考えずに物事を行うさま。カルはずみ。
軽症	カルいショウ状。
軽石	カルイシ。
軽自動車	ケイジドウシャ。
軽自動車税	ケイジドウシャゼイ。
軽視	重要ではないと考えること。
軽量	重リョウや程度のカルいこと。
軽量化	ケイリョウカ。
軽金属	ケイキンゾク。
軽音楽	ケイオンガク。
輪唱	同じ旋律・歌詞を追ショウする形で行われる声楽の一種。
輸入	外国から商品を購入すること。
輸入価格	ユニュウカカク。
輸入品	ユニュウヒン。
輸入小麦	ユニュウコムギ。
輸入業者	ユニュウギョウシャ。
輸出	自国の商品を他国へ売ること。
輸出産業	ユシュツサンギョウ。
輸血	他の人のケツ液を患者に注入すること。
輸送	乗り物で人や物を運ぶこと。
輸送能力	ユソウノウリョク。
辛口	カラクチ。
辛子明太子	カラシメンタイコ。
辞任	職務を自分からヤめること。
辞典	言葉を集め、その意味などを解説した書籍。ジテン。
辞書	言葉を集め、その意味などを解説した書籍。ジショ。
辞職	自分から会社をヤめること。
辞職願	ジショクネガイ。
辞表	役職のある人がヤめるときに提出する書類。
辞退	権利などを放棄すること。
農作物	ノウサクブツ。
農作物被害	ノウサクブツヒガイ。
農具	ノウグ。
農協	ノウ業キョウ同組合。ＪＡ。
農協改革	ノウキョウカイカク。
農園	野菜・草花・果樹などを栽培するノウ場。
農場	ノウジョウ。
農家	ノウカ。
農村	ノウソン。
農林水産省	ノウリンスイサンショウ。
農業	土地を利用した作物の栽培や、家畜の飼育。
農業体験	ノウギョウタイケン。
農業協同組合	ノウギョウキョウドウクミアイ。
農業団体	ノウギョウダンタイ。
農民	ノウミン。
農産物	ノウサクブツ。
農耕	田畑をタガヤしてノウ作物を作ること。
農耕民族	ノウコウミンゾク。
農薬	ノウヤク。
農薬混入	ノウヤクコンニュウ。
近代化	キンダイカ。
近似値	キンジチ。
近大	キ畿ダイ学。
近年	キンネン。
近所	キンジョ。
近所迷惑	キンジョメイワク。
近日	キンジツ。
近海	陸地にチカいウミ。
近眼	近くが見えて、遠くが見えない状態。キンガン。
近視	近くが見えて、遠くが見えない状態。キンシ。
近辺	キンペン。
近道	チカミチ。
返上	カエすこと。ヘンジョウ。
返事	呼びかけに対して答える言葉。ヘンジ。
返信	受け取った通シンについてヘン事を出すこと。
返品	シナ物をカエすこと。
返済	借りた金や物をカエすこと。
返答	問いや呼びかけなどに対してコタえる言葉。
返送	オクりカエすこと。
返金保証	ヘンキンホショウ。
迫力	ハクリョク。
迫害	ハクガイ。
述語	主ゴを除く、その動作や状態などを述べる部分。
迷信	社会に実害を及ぼし、道徳に反するような知識やシン仰。
迷子	マイゴ。
迷宮	メイキュウ。
迷惑	人のしたことで不快になったり困るさま。
迷惑行為	メイワクコウイ。
迷惑防止条例	メイワクボウシジョウレイ。
迷惑電話	メイワクデンワ。
迷路	複雑に入り組んだ道。
追加	付けクワえること。
追手	オっテ。
追放	ツイホウ。
追求	オいモトめること。
追突	後ろからぶつかること。
追突事故	ツイトツジコ。
追試	ツイシ験。
追試験	ツイシケン。
追跡	逃げる者のアトをオうこと。
追風	オいカゼ。
退化	進カの逆。
退去	ある場所から立ちのくこと。
退去届	タイキョトドケ。
退場	そのバ所・会ジョウなどからシリゾくこと。
退学	タイガク。
退学届	タイダクトドケ
退屈	タイクツ。
退治	悪いものをうち滅ぼすこと。「ネズミを○○する」
退社	勤務時間が終わって会シャから出ること。
退職	ショクをシリゾき、労働契約を解除すること。
退職届	タイショクトドケ。
退職金	タイショクキン。
退職願	タイショクネガイ。
退院	入イン患者の病状が回復して病インから出ること。
送付	オクり届けること。ソウフ。
送信	情報やデータなどを通シンでオクること。
送別	ワカれて行く人をオクること。
送別会	ソウベツカイ。
送料	品物をオクるのに必要なリョウ金。
送料無料	ソウリョウムリョウ。
送球	ボールをオクること。
送迎会	ソウゲイカイ。
送金	キン銭をオクること。
送風	カゼをオクること。
逃亡	ニげて身を隠すこと。
逃亡者	トウボウシャ。
逃走	ニげ去ること。
逃走経路	トウソウケイロ。
逆上	サカアがり。
逆効果	ギャクコウカ。
逆境	物事がうまくゆかず、苦労の多いキョウ遇。
逆手	サカテ。
逆立	サカダち。
逆行	進むべき方向と反対の方へ進むこと。
逆転	事のなりゆきや関係が今までとはギャクになること。
透明	スけて見えること。
透明度	トウメイド。
透明性	トウメイセイ。
透明性確保	トウメイセイカクホ。
途中	トチュウ。
途中出場	トチュウシュツジョウ。
通信	送り手が情報を送り、受け手が情報を受けること。
通信会社	ツウシンガイシャ。
通信制大学	ツウシンセイダイガク。
通信教育	ツウシンキョウイク。
通信業界	ツウシンギョウカイ。
通信販売	ツウシンハンバイ。
通信費	ツウシンヒ。
通信速度	ツウシンソクド。
通分	共通のブン母を持つブン数にすること。
通勤	家とキン務先を往復する行為。
通勤中	ツウキンチュウ。
通勤客	ツウキンキャク。
通勤手当	ツウキンテアテ。
通勤時間	ツウキンジカン。
通報	警察などに告げ知らせること。
通学	ガッ校にカヨうこと。
通帳	金額・数量などを記載するチョウ面。「預金○○」
通常	特別の事情がなく、いつもどおりであること。普ツウ。
通常国会	ツウジョウコッカイ。
通気性	ツウキセイ。
通用	広く世間に認められること。「世間に○○しない」
通称	世間一般にツウ用している名前。
通行	人や車が道をトオること。
通行人	ツウコウニン。
通訳	バイリンガルが言葉を別の言語に変換すること。
通話機能	ツウワキノウ。
通貨	国家などによって価値を保証された、決済のためのカ幣。
通貨危機	ツウカキキ。
通販	ツウハン。
通路	人や物の移動のために空けてある場所。ツウロ。
通過	トオりスぎること。
速報	事故の発生などを素早くホウ道すること。
速度	方向を持ったハヤさ。
速度制限	ソクドセイゲン。
速達	普通よりもハヤく届けること。
速達郵便	ソクタツユウビン。
造船	フネをツクること。
造花	人工的にツクられたハナ。
連中	仲間である者たち。レンチュウ。
連休	レン続したヤスみの日。
連勝	レン続したショウ利。
連合	日本労働組合総レンゴウ会の略。
連合国	レンゴウコク。
連合国軍総司令部	レンゴウコクグンソウシレイブ。ＧＨＱ。
連合軍	レンゴウグン。
連帯	二人以上の者が共同で責任を負うこと。
連帯保証	レンタイホショウ。
連帯保証人	レンタイホショウニン。
連帯感	レンタイカン。
連帯責任	レンタイセキニン。
連想	ある事柄からそれと関連のある事柄を思い浮かべること。
連携強化	レンケイキョウカ。
連敗	レン続したハイ北。
連日	何ニチもレン続で続くこと。
連発	何度も続けてハッ射すること。物事が続いて起きること。
連盟	共同の目的のためにメイ約を結ぶこと。「国際○○」
連立政権	レンリツセイケン。
連結	ひと続きになるようにつなぎ合わせること。
連結子会社	レンケツコガイシャ。
連結決算	レンケツケッサン。
連絡先	レンラクサキ。
連続	つながってツヅくこと。切れ目がないこと。
連続再生	レンゾクサイセイ。
連続放火事件	レンゾクホウカジケン。
連載小説	レンサイショウセツ。
週休	一シュウ間のうちのヤスみの日。
週刊	雑誌・新聞などを一シュウ間ごとに発行すること。
週刊誌	シュウカンシ。
週末	シュウの終わりごろ。
週間	日曜日から土曜日までの七日間。
進出	新しい方面や分野にススみデて、活動を広げること。
進化	生物の形質が世代を経る中で変カしていく現象。
進学	上級のガッ校へススむこと。
進学校	シンガクコウ。
進展	事態がシン行しテン開すること。
進歩	物事がより良い方や望ましい方へススんでいくこと。
進級	等キュウ・学年が上にススむこと。
進行	前へススむこと。物事がはかどること。
進行中	シンコウチュウ。
進路	ススんで行くミチ。
進路変更	シンロヘンコウ。
進退	このまま仕事を続けるかやめるか。
進退問題	シンタイモンダイ。
遊園地	ユウエンチ。
遊牧	移動しながらボク畜を行うこと。
遊牧民	ユウボクミン。
遊牧民族	ユウボクミンゾク。
遊覧船	ユウランセン。
運休	「ウン行キュウ止」の略。
運動	物がウゴくこと。体をウゴかすこと。
運動不足	ウンドウブソク。
運動会	ウンドウカイ。
運動場	ウンドウジョウ。
運動方針	ウンドウホウシン。
運動時間	ウンドウジカン。
運動神経	ウンドウシンケイ。
運動選手	ウンドウセンシュ。
運動部	ウンドウブ。
運勢	幸・不幸の巡ってくる具合。ウン命のイキオい。
運命	天によって決められた人間の定め。
運命共同体	ウンメイキョウドウタイ。
運営	組織などを動かし、うまく機能するようにすること。
運営会社	ウンエイガイシャ。
運河	船が通るために作られた人工的な水路。「スエズ○○」「パナマ○○」
運賃	交通機関に支払う金銭。
運転	ドライビング。
運転免許	ウンテンメンキョ。
運転免許証	ウンテンメンキョショウ。
運転手	ウンテンシュ。
運輸	ウンユ。
運送	品物をハコんでオクること。
運送会社	ウンソウガイシャ。
運送業	ウンソウギョウ。
過保護	カホゴ。
過信	価値・力量などを実際以上に高く評価して頼ること。
過剰	必要な程度や数量を越えて多いこと。
過剰防衛	カジョウボウエイ。
過労	体や頭脳を使いスぎて疲ロウすること。
過労死	カロウシ。
過半数	カハンスウ。
過去	すでに過ぎ去った時間の流れのこと。
過去最低	カコサイテイ。
過去最悪	カコサイアク。
過去最高	カコサイコウ。
過大評価	カダイヒョウカ。
過失	誤りやシッ敗のこと。カシツ。
過密	入れ込みすぎていて、ゆとりがないこと。「○○スケジュール」
過小評価	カショウヒョウカ。
過度	適切な程ドを超えていること。
過激	考え方ややり方が世間の常識からひどくかけ離れていること。
過激思想	カゲキシソウ。
過激派	カゲキハ。
過熱	必要以上にまた限界以上にアツくなること。
過程	物事が変化していく一連の流れ。プロセス。
道具	ドウグ。ツール。
道化師	ドウケシ。
道場	武芸の修練を行う場所。
道州制	ドウシュウセイ。
道徳	善悪・正邪を判断し、正しく行動するための規範。
道徳教育	ドウトクキョウイク。
道案内	ミチアンナイ。
道楽	趣味を楽しむこと。
道理	物事の正しいすじみち。「無リが通れば○○引っ込む」
道草	ミチクサ。
道路	人や車両の交通のために設けられた地上のミチ。
道路交通法	ドウロコウツウホウ。
道路整備	ドウロセイビ。
道路標識	ドウロヒョウシキ。
道順	ミチジュン。
達人	タツジン。
達成	成し遂げること。目的を果たすこと。
達成感	タッセイカン。
達筆	文字を上手に書くさま。勢いのあるフデづかい。
達者	タッシャ。
違反	法規・協定・約束などに従わないこと。
違反駐車	イハンチュウシャ。
違和感	イワカン。
違憲	ケン法に反すること。
違憲状態	イケンジョウタイ。
違法	ホウに反すること。
違法行為	イホウコウイ。
遠回	トオマワし。
遠征	試合・登山などでトオくへ出かけていくこと。
遠征先	エンセイサキ。
遠心力	エンシンリョク。
遠方	トオくのホウ。
遠洋漁業	エンヨウギョギョウ。
遠目	トオメ。
遠視	近い・トオいに関係なく、目の焦点があっていない状態。
遠赤外線	エンセキガイセン。
遠足	エンソク。
遠距離恋愛	エンキョリレンアイ。
遠近法	エンキンホウ。
遠隔操作	リモートコントロール。
遠隔操作事件	エンカクソウサジケン。
遣唐使	ケントウシ。
適任	その仕事やニン務に合っていること。
適切	ふさわしいこと。ぴったりと当てはまること。「○○に対処する」
適合	条件・状況などに当てはまること。「条件に○○する」
適度	程度がちょうどよいさま。
適当	テキ切かつ妥トウ。いい加減。
適応	生物が環境に合わせて変化すること。
適材適所	その人の能力にあった役目につけること。
適格	必要な資カクを満たしていること。
適正	テキ当でタダしいこと。
適正体重	テイセイタイジュウ。
適温	ほどよいオン度。ちょうどよいオン度。
適量	ほどよいリョウ。ちょうどよいリョウ。
選出	エラびダすこと。
選別	複数の物をより分けること。
選別機	センベツキ。
選手	競技者としてスポーツを行っている人。
選手会	センシュカイ。
選手団	センシュダン。
選手権	センシュケン。
選択	複数の中から良いもの、目的にかなうものなどをエラぶこと。
選択式	センタクシキ。
選択科目	センタクカモク
選挙	投票により代表者や役員などをセン出すること。
選挙制度	センキョセイド。
選挙制度改革	センキョセイドカイカク。
選挙区	センキョク。
選挙対策	センキョタイサク。
選挙対策委員会	センキョタイサクイインカイ。
選挙戦	センキョセン。
選挙期間	センキョキカン。
選挙権	センキョケン。
選挙無効	センキョムコウ。
選挙管理委員会	センキョカンリイインカイ。
選挙結果	センキョケッカ。
選挙違反	センキョイハン。
選考理由	センコウリユウ。
遺伝	生殖によって親から子へと形質がツタわる現象。
遺伝子	イデンシ。
遺伝子工学	イデンシコウガク。
遺伝子検査	イデンシケンサ。
遺伝子治療	イデンシチリョウ。
遺伝子解析	イデンシカイセキ。
遺体	死んだ人のカラダ。イタイ。
遺品	イヒン。
遺品整理	イヒンセイリ。
遺族	故人と死に別れ、残された家ゾクや親ゾク。
遺族年金	イゾクネンキン。
遺書	自殺する人が残す文章。イショ。
遺産	故人の残した財サン的な権利や義務。
遺産相続	イサンソウゾク。
遺産相続税	イサンソウゾクゼイ。
遺言	ユイゴン。
遺言書	ユイゴンショ。
遺言状	ユイゴンジョウ。
遺跡	過去の人間の活動のアトが確認できる場所。
遺骨	イコツ。
避難場所	ヒナンバショ。
避難指示	ヒナンシジ。
避難生活	ヒナンセイカツ。
避難経路	ヒナンケイロ。
避難訓練	ヒナンクンレン。
部下	手下。ブカ。
部分	パート。
部品	パーツ。
部品交換	ブヒンコウカン。
部品調達	ブヒンチョウタツ。
部員	ブに所属する構成イン。
部屋	ヘヤ。
部長	ブチョウ。
部隊	軍隊の一組織。ブタイ。
部首	「へん」や「つくり」といった、漢字を構成する要素。
郵便	〒
郵便切手	ユウビンキッテ。
郵便局	ユウビンキョク。
郵便局員	ユウビンキョクイン。
郵便振替	ユウビンフリカエ。
郵便料金	ユウビンリョウキン。
郵便物	ユウビンブツ。
郵便番号	ユウビンバンゴウ。
郵政民営化	ユウセイミンエイカ。
郵政選挙	ユウセイセンキョ。
郵送	ユウ便でオクること。
郷土料理	キョウドリョウリ。
都会	田舎の対義語。
都内	東京トの中。
都合	ツゴウ。
都営	東京トによる経エイ。
都市	人口が多く、商業・交通が発達している地区。
都市伝説	トシデンセツ。
都市計画法	トシケイカクホウ。
都庁	東京トの事務を行う役所。
都心	ト市の中シン部。
都民	東京トの人。
都知事	トチジ。
都立	東京トが設リツ・経営していること。
都道府県	トドウフケン。
配偶者	ハイグウシャ。
配分	割り当ててクバること。ワけ前。
配合飼料	ハイゴウシリョウ。
配布	ゆきわたるようにクバること。
配布資料	ハイフシリョウ。
配給	品物などを割り当ててクバること。
配線	回路や回線を構成するセンをつなぐこと。
配線工事	ハイセンコウジ。
配置	レイアウト。
配置図	ハイチズ。
配置転換	ハイチテンカン。
配色	イロのとり合わせ。
配達	相手に品物が届くこと。
配達先	ハイタツサキ。
配達記録	ハイタツキロク。
酒場	サケを飲む店。サカバ。
酒屋	サカヤ。
酒気	酒のにおい。「○○帯び運転はやめましょう」
酸味	スっぱいアジ。
酸味料	サンミリョウ。
酸性	アルカリセイの反対。
酸性雨	サンセイウ。
酸素	呼吸のために必要な気体。元素記号Ｏ。
酸素系漂白剤	サンソケイヒョウハクザイ。
釈放	シャクホウ。
釈明	誤解や非難に対して説メイし、理解を求めること。
里親	サトオヤ。
重体	命にかかわるほどのオモい病気、負傷のこと。
重傷	命には別状は無いが、後に障害が残りそうな怪我。
重力	ジュウリョク。
重力加速度	ジュウリョクカソクド。
重労働	ジュウロウドウ。
重圧	オモいアツ力。
重大	きわめてジュウ要な事態であるさま。大ゴトであるさま。
重大事件	ジュウダイジケン。
重大事故	ジュウダイジコ。
重宝	たいせつなタカラ物。便利に使うこと。
重工業	ジュウコウギョウ。
重役	責任のオモいヤク目・地位。
重心	オモさの中シン。
重油	ジュウユ。
重油流出事故	ジュウユリュウシュツジコ。
重病	オモいビョウ気。
重病人	ジュウビョウニン。
重症	ショウ状がオモいこと。
重税	負担のオモいゼイ金。
重箱	ジュウバコ。
重罪	オモいツミ。
重荷	オモニ。
重複	チョウフク。
重要	非常に大事で大切なこと。
重要事項	ジュウヨウジコウ。
重要人物	ジュウヨウジンブツ。
重要参考人	ジュウヨウサンコウニン。
重要市場	ジュウヨウシジョウ。
重要性	ジュウヨウセイ。
重要文化財	ジュウヨウブンカザイ。
重要視	ジュウヨウシ。
重要課題	ジュウヨウカダイ。
重視	オモく見ること。大切だと考えること。
重責	オモいセキ任。
重量	物体に働く地球のジュウ力の大きさ。
重量税	ジュウリョウゼイ。
重金属	ジュウキンゾク。
野党	与トウではないトウ。
野党再編	ヤトウサイヘン。
野原	ノハラ。
野営	キャンプ。
野外	ノ原。郊ガイ。ヤガイ。
野宿	ヤ外に寝て夜を明かすこと。
野心	ヤシン。
野放	ノバナし。
野望	ヤボウ。
野次馬	ヤジウマ。
野球	ベースボール。
野球場	ヤキュウジョウ。
野球用品	ヤキュウヨウヒン。
野球部	ヤキュウブ。
野生動物	ヤセイドウブツ。
野良犬	ノライヌ。
野菜	ベジタブル。
野菜工場	ヤサイコウジョウ。
野菜栽培	ヤサイサイバイ。
野鳥	ヤ生のトリ。
野鳥観察	ヤチョウカンサツ。
量産	「大リョウ生サン」の略。
量産化	リョウサンカ。
量的緩和	リョウテキカンワ。
金具	カナグ。
金利	資キンの使用料もしくは賃借料のおカネ。
金利計算	キンリケイサン。
金品	キンピン。
金属	メタル。
金属探知機	キンゾクタンチキ。
金属片	キンゾクヘン。
金属音	キンゾクオン。
金庫	金品を入れ、鍵をかけて保管しておくための箱。
金星	太陽系で太陽に近い方から二番目の惑セイ。
金曜	フライデー。
金曜日	フライデー。
金棒	キン属のボウ。「鬼に○○」
金正恩	キムジョンウン。
金正恩体制	キムジョンウンタイセイ。
金物	カナモノ。
金目	カネメ。
金管楽器	キンカンガッキ。
金粉	キンプン。
金網	カナアミ。
金色	キンイロ。コンジキ。
金融	おキンの流れ。おキンの貸借。
金融危機	キンユウキキ。
金融商品	キンユウショウヒン。
金融市場	キンユウシジョウ。
金融庁	キンユウチョウ。
金融政策	キニュウセイサク。
金融機関	キンユウキカン。
金融緩和	キンユウカンワ。
金融街	キンユウガイ。
金貨	ゴールドメダル。
金賞	展覧会・品評会などで、第一位の入ショウ。
金賞受賞	キンショウジュショウ。
金銭	おカネ。貨幣。ゼニ。
金銭感覚	キンセンカンカク。
金閣寺	キンカクジ。
金額	キンガク。
金髪	キンパツ。
金魚	キンギョ。
針小棒大	ささいなことをオオげさに言うこと。
針山	ハリヤマ。
針葉樹	シンヨウジュ。
針葉樹林	シンヨウジュリン。
針金	ハリガネ。
鉄分	テツブン。
鉄分不足	テツブンブソク。
鉄則	テッソク。
鉄板	テツのイタ。
鉄柱	テツのハシラ。
鉄棒	テツのボウ。
鉄橋	テツのハシ。
鉄筋	コンクリートを補強するため、中に入れる鋼材。
鉄道	テツドウ。
鉄道事業	テツドウジギョウ。
鉄鉱石	テッコウセキ。
鉛直方向	エンチョクホウコウ。
鉛筆	エンピツ。
鉱山	金・銀・銅などの自然資源を採掘するヤマ。
鉱石	イシのように固まった自然資源。
銀世界	ギンセカイ。
銀山	ギンを採掘するヤマ。
銀座	日本を代表する繁華街。東京都中央区南西部。
銀河	無数の星の大きな集まり。
銀河系	ギンガケイ。
銀紙	ギンガミ。
銀色	ギンイロ。シルバー。
銀行	預金を集め、融資をする金融機関。バンク。
銀行振込	ギンコウフリコミ。
銀行株	ギンコウカブ。
銀貨	シルバーコイン。
銅像	ドウゾウ。
銅山	ドウを採掘するヤマ。
銅板	ドウでできたイタ。
銅線	ドウでできたセン。
銭湯	料金をとって客を入浴させる浴場。公衆浴場。風呂屋。
鋭利	刃がスルドく、切れ味のよいさま。
鋭角	九十度よりとがったカク度。
録画	映像・動ガを記ロクすること。
録画機能	ロクガキノウ。
録音	オン声を記ロクすること。
録音機	ボイスレコーダー。
録音機能	ロクオンキノウ。
鎌倉幕府	源頼朝がカマクラに開いたバクフ。
鎌倉時代	1192年～1333年の約140年間。
鏡台	カガミとそれを支えるダイから成る家具。
鑑定	美術品・骨董品などの良し悪しの評価を行うこと。
鑑定人	カンテイニン。
鑑定書	カンテイショ。
鑑賞	芸術作品のよさを味わい楽しみ理解すること。
長女	最初のオンナの子。
長寿命	チョウジュミョウ。
長居	ナガい間、同じ所にイること。
長崎県	九州西端部に位置するケン。原爆が投下された。
長年	ナガいネン月。ナガネン。
長所	すぐれているトコロ。メリット。
長方形	内角がすべて直角の四角ケイ。
長時間	チョウジカン。
長時間使用	チョウジカンシヨウ。
長時間労働	チョウジカンロウドウ。
長期	ナガいキ間。
長期保存	チョウキホゾン。
長期化	チョウキカ。
長期国債	チョウキコクサイ。
長期政権	チョウキセイケン。
長期金利	チョウキキンリ。
長男	最初のオトコの子。
長続	ナガツヅき。
長老	年老いた人を敬っていう語。チョウロウ。
長者	金持ち。チョウジャ。
長者番付	チョウジャバンヅケ。
長調	陽気、活発さといった感情を受ける音楽のチョウ子。
長距離	チョウキョリ。
長身	シン長がナガいさま。
長野県	本州内陸部にあるケンで、冬季オリンピックの開催地。
長針	時計のナガいハリ。
長音	ナガいオト。
門出	旅立ち。カドデ。
閉会	ヘイカイ。
閉口	クチをトじること。
閉店	ミセをトじること。
閉経	月経がなくなること。
閉館	ヤカタをシめること。
開会	カイをヒラくこと。
開会式	カイカイシキ。
開化	「文明○○」
開口部	クチがヒラいているブ分。
開国	外コクとの交流を行うこと。
開始	スタート。
開始時間	カイシジカン。
開封	手紙などのフウをヒラくこと。
開幕	マクがヒラくこと。
開店	ミセをヒラくこと。
開放	アけたままにしておくこと。自由に出入りさせること。
開放感	カイホウカン。
開業	商売や事ギョウを始めること。
開港	ミナトをヒラくこと。
開発	人間の生活に役立つものを作り出すこと。
開発期間	カイハツキカン。
開発途上国	カイハツトジョウコク。
開票	投ヒョウの結果を調べること。 
開票時間	カイヒョウジカン。
開花	草木のハナがヒラくこと。
開通	道路・鉄道などがツウじること。
開閉	ヒラくこととトじること。
開館	ヤカタをヒラくこと。
開館時間	カイカンジカン。
間一髪	カンイッパツ。
間取	マドり。
間近	マヂカ。
間隔	物と物とのアイダ。時間のヘダたり。
間食	朝食・昼食・夕食以外の補助的なショク事。
関係	二つ以上の物事が互いにカカわり合うこと。
関係代名詞	カンケイダイメイシ。
関係修復	カンケイシュウフク。
関係悪化	カンケイアッカ。
関係改善	カンケイカイゼン。
関係機関	カンケイキカン。
関係者	カンケイシャ。
関心	ある物事に特に心を引かれ、注意を向けること。
関東	トウ京を中心に首都圏と呼ばれる地域。
関東地方	カントウチホウ。
関東大震災	カントウダイシンサイ。
関税	輸入貨物に対して課されるゼイ金。
関節	骨と骨が連結する部分。
関西	京阪神地方。カンサイ。
関西人	カンサイジン。
関西弁	カンサイベン。
関連会社	カンレンガイシャ。
関連商品	カンレンショウヒン。
閣下	「デーモン○○」
閣議	 内カクが意思決定するための会ギ。
閣議決定	カクギケッテイ。
阪神	野球のタイガーズといえば…
阪神大震災	ハンシンダイシンサイ。
防止	フセぎトめること。
防水	ミズをフセぐこと。
防火	ヒをフセぐこと。
防災	サイ害をフセぐこと。
防災情報	ボウサイジョウホウ。
防災教育	ボウサイキョウイク。
防災訓練	ボウサイクンレン。
防犯	ハン罪をフセぐこと。
防衛	外国による攻撃に対して国の安全を保持する作用。
防衛協力指針	ボウエイキョウリョクシシン。
防衛大臣	ボウエイダイジン。
防衛省	ボウエイショウ。
防護服	ボウゴフク。
防音	オトをフセぐこと。
降下	高い所からオりること。「ヘリから○○する」
降参	戦いや争いに負け、相手に従うこと。コウサン。
降水量	コウスイリョウ。
降雪	ユキがフること。
限定	物事の範囲や数量をカギること。
限定公開	ゲンテイコウカイ。
限定商品	ゲンテイショウヒン。
限定販売	ゲンテイハンバイ。
限度	ゲンド。
限界	それ以上の値を超えられないこと。
限界集落	ゲンカイシュウリャク。
陛下	皇帝・天皇・国王等の敬称。ヘイカ。
院長	インの最高責任者。
陣地	戦いのために軍隊・火器などを配備してある場所。
除去	ジョキョ。
除名	メイ簿などから、そのナ前を取りノゾくこと。
除外	ジョガイ。
除夜	大みそかの夜には「○○の鐘」を鳴らす。
除染	ある場所の放射能の影響を少なくすること。
除染作業	ジョセンサギョウ。
除草剤	ジョソウザイ。
除雪	ユキを取りノゾくこと。
除雪車	ジョセツシャ。
陰性	反応がなかったこと。「HIV検査の結果が○○だった」
陰性反応	インセイハンノウ。
陰極	マイナスの電キョク。
陸上	リクのウエ。
陸上競技	リクジョウキョウギ。
陸上競技場	リクジョウキョウギジョウ。
陸上自衛隊	リクジョウジエイタイ。
陸地	チ球の表面で、水におおわれていない部分。
陸橋	道路や鉄道線路などの上にかけたハシ。リッキョウ。
陸海空軍	リクカイクウグン。
陸路	リクロ。
陸軍	リクグン。
険悪	ケンアク。
陽性	反応があったこと。「HIV検査の結果が○○だった」
陽性反応	ヨウセイハンノウ。
陽極	プラスの電キョク。
陽気	にぎやかで明るいさま。
隊長	軍タイで、タイの指揮をとる人。
階層	上下にソウをなした重なり。
階段	高さの違う場所をつなぐ、ダンダンのある通路。
階級	身分・地位などの上下の段カイ。
障子	木枠に紙を張った扉や窓。
障子紙	ショウジガミ。
障害	体や心の機能が妨げられて低下すること。
障害年金	ショウガイネンキン。
障害物	ショウガイブツ。
障害物競走	ショウガイブツキョウソウ。
障害者	ショウガイシャ。
障害者年金	ショウガイシャネンキン。
障害者手帳	ショウガイシャテチョウ。
集中	一か所にアツめること。「精神を○○する」
集中力	シュウチュウリョク。
集会	ある目的のために多くの人が一定の場所に集まること。
集合	一ヶ所にアツまること。
集合場所	シュウゴウバショ。
集合時間	シュウゴウジカン。
集団	組織化された複数の人々の集合。
集団感染	シュウダンカンセン。
集団生活	シュウダンセイカツ。
集団的自衛権	シュウダンテキジエイケン。
集団面接	シュウダンメンセツ。
集大成	シュウタイセイ。
集積回路	シュウセキカイロ。ＩＣ。
集荷	各地の物をアツめること。シュウカ。
集計	データをアツめてケイ算すること。
集金	代キンなどをアツめること。
集金代行	シュウキンダイコウ。
集金日	シュウキンビ。
集金袋	シュウキンブクロ。
雇用促進	コヨウソクシン。
雇用創出	コヨウソウシュツ。
雇用問題	コヨウモンダイ。
雇用契約	コヨウケイヤク。
雇用拡大	コヨウカクダイ。
雇用状況	コヨウジョウキョウ。
雇用環境	コヨウカンキョウ。
雑学	ザツガク。
雑木林	ゾウキバヤシ。
雑煮	ゾウニ。
雑用	ザツヨウ。
雑種	ザッシュ。
雑草	ザッソウ。
雑誌	ザッシ。
雑誌広告	ザッシコウコク。
雑談	ザツダン。
雑貨	ザッカ。
雑貨屋	ザッカヤ。
雑音	ザツオン。
雑魚	ザコ。
離党届	リトウトドケ。
離婚届	リコントドケ。
離婚歴	リコンレキ。
離島防衛	リトウボウエイ。
離着陸	リリクとチャクリク。
離陸	航空機などがリク地をハナれて空中に飛び上がること。
難問	ムズカしいモン題。
難攻不落	ナンコウフラク。
難易度	ナンイド。
難民	ナンミン。
難民支援	ナンミンシエン。
難病	治療がムズカしいビョウ気。
難破船	ナンパセン。
難色	賛成できないというような態度。
難解	ムズカしくてカイ釈に苦しむこと。
難関	たやすくは通過できないセキ所。
難関大学	ナンカンダイガク。
難題	ムズカしい問ダイ。
雨具	アマグ。
雨垂	アマダれ。
雨天	ウテン。
雨天中止	ウテンチュウシ。
雨天決行	ウテンケッコウ。
雨季	アメがよく降るキ節。
雨宿	アマヤドり。
雨戸	アマド。
雨支度	アマジタク。
雨模様	アマモヨウ。
雨水	アマミズ。
雨足	アマアシ。
雨量	アメのリョウ。ウリョウ。
雨量計	ウリョウケイ。
雨降	アメフり。
雨雲	アマグモ。
雪合戦	ユキガッセン。
雪国	ユキグニ。
雪女	ユキオンナ。
雪崩	ナダレ。
雪景色	ユキゲシキ。
雪解	ユキドけ。
雪道	ユキミチ。
雲海	ウンカイ。
雲行	クモユき。
雷雨	ライウ。
雷鳴	ライメイ。
電光石火	ほんの短い時間やすばやい行動のたとえ。
電力	デン流が単位時間にする仕事量。
電力会社	デンリョクガイシャ。
電力供給	デンリョクキョウキュウ。
電力改革	デンリョクカイカク。
電力系統	デンリョクケイトウ。
電力自由化	デンリョクジユウカ。
電力輸出	デンリョクユシュツ。
電力量	デン気のエネルギー。
電力需要	デンリョクジュヨウ。
電化製品	デンカセイヒン。
電卓	デンタク。
電圧	デン気を流そうとするアツ力。
電圧計	デンアツケイ。
電子商取引	デンシショウトリヒキ。
電子政府	デンシセイフ。
電子計算機	デンシケイサンキ。
電子部品	デンシブヒン。
電柱	デンチュウ。古くはデン信バシラと言っていた。
電極	デン気的に接続する部分。
電気	デン化製品を作動させるのに必要なもの。
電気信号	デンキシンゴウ。
電気回路	デンキカイロ。
電気抵抗	デンキテイコウ。
電気料金	デンキリョウキン。
電気自動車	デンキジドウシャ。
電池	電気エネルギーを蓄えるもの。バッテリー。
電池交換	デンチコウカン。
電波	デン気のナミ。
電流	デン気のナガれ。
電源	デンゲン。
電灯	デン気を利用した照明装置。
電球	デン気で光る丸い物。
電磁波	デンジハ。
電磁石	デンジシャク。
電線	デン気が流れるセン。
電脳空間	デンノウクウカン。
電解液	デンカイエキ。
電話	デンワ。
電話世論調査	デンワヨロンチョウサ。
電話予約	デンワヨヤク。
電話会談	デンワカイダン。
電話取材	デンワシュザイ。
電話機	デンワキ。
電話番号	デンワバンゴウ。
電話線	デンワセン。
電話連絡	デンワレンラク。
電車	トレイン。
需要	「欲しい」「買いたい」という求め。
震度	地シンの強さ。
震源地	シンゲンチ。
震災	2011.3.11は「東日本大○○」。
震災関連死	シンサイカンレンシ。
露天風呂	ヨテンブロ。
青二才	アオニサイ。
青写真	アオジャシン。
青天井	アオテンジョウ。
青天白日	疑いが完全に晴れること。
青少年	セイショウネン。
青年期	セイネンキ。
青年海外協力隊	セイネンカイガイキョウリョクタイ。
青春	セイシュン。
青果物市況	セイカブツシキョウ。
青森県	日本の本州最北端に位置するケン。リンゴの産地。
青空	アオゾラ。
青空駐車場	アオゾラチュウシャジョウ。
青色	アオイロ。
青葉	アオバ。
青酸化合物	セイサンカゴウブツ。
青銅器	セイドウキ。
静岡県	富士山と伊豆半島を含むケン。
静止	動かず、じっとしていること。
静止画	セイシガ。
静止画像	セイシガゾウ。
静止衛星	セイシエイセイ。
静脈	心臓へ血液を送り込む血管。
静電気	下敷きと頭髪をこすると、ひっぱられます。
静養	仕事を離れて心身を休めること。
非公式	ヒコウシキ。
非売品	ヒバイヒン。
非常	ふだんと異なった状態。
非常時	ヒジョウジ。
非常用	ヒジョウヨウ。
非常識	ヒジョウシキ。
非常階段	ヒジョウカイダン。
非常食	ヒジョウショク。
非政府組織	ヒセイフソシキ（ＮＧＯ）。
非正規労働者	ヒセイキロウドウシャ。
非正規社員	ヒセイキシャイン。
非正規雇用	ヒセイキコヨウ。
非行	青少年の、社会にそむくコウ為。
非課税	ヒカゼイ。
非難	欠点や過失などを取り上げて責めること。
面会	病院などで人に会うこと。
面会時間	メンカイジカン。
面会謝絶	メンカイシャゼツ。
面影	オモカゲ。
面接	求人採用に際して実際に会って話をすること。
面接官	メンセツカン。
面目	メンボク。
面積	一定の面の広さ。
面談	メン会して直接話をすること。
面識	顔見知りであること。「○○がない」
革命	統治体制が急激かつ根底的に変カクされること。
革新	古くからの習慣・制度などをアタラしく変えようとすること。
韓国	朝鮮半島南部に位置するクニ。
韓国人	カンコクジン。
韓国政府	カンコクセイフ。
韓国語	カンコクゴ。
音信不通	ウンセイフツウ。
音域	オトの高さの範囲。
音声	オトとコエ。
音声案内	オンセイアンナイ。
音声認識	オンセイニンシキ。
音感	オトに対するカン覚。
音楽	ミュージック。
音楽会	オンガクカイ。
音楽家	ミュージシャン。
音楽教室	オンガクキョウイク。
音波	オトのナミ。
音程	二つ以上の音の高さの差。
音色	ネイロ。
音質	オトの品シツ。
音速	オトのハヤさ。
音量	オトのリョウ。
音量調節	オンリョウチョウセイ。
音階	音を高さにより並べたもの。
音頭	「よさこい○○」「東京○○」「河内○○」
頂上	山などの一番高い所。チョウジョウ。
頂点	角の端にあるテン。
順位	一定の基準によってジュンに並べたときの、それぞれのイ置。
順位表	ジュンイヒョウ。
順序	何が先で何が後に来るか。物事の相互の前後関係。
順番	ジュンバン。
順調	ジュンチョウ。
預言者	ヨゲンシャ。
預貯金	ヨチョキン。
預金	おカネをアズけること。
預金残高	ヨキンザンダカ。
預金通帳	ヨキンツウチョウ。
預金金利	ヨキンキンリ。
領収書	リョウシュウショ。
領収証	リョウシュウショウ。
領土	リョウ有しているト地。リョウ地。
領土問題	リョウドモンダイ。
領地	リョウ有している土チ。
領域	物事・人がかかわりをもつ範囲。リョウイキ。
領有権	リョウユウケン。
領海	国家の主権が及ぶウミの範囲。
領海侵犯	リョウカイシンパン。
頭上	アタマのウエ。
頭上注意	ズジョウチュウイ。
頭打	アタマウち。
頭数	アタマカズ。
頭文字	カシラモジ。
頭痛	アタマがイタいこと。
頭脳	考えるアタマ。
頭脳流出	ズノウリュウシュツ。
頭髪	アタマの毛。
題名	タイトル。
題材	芸術作品などのもととなるザイ料。 
額面	有価証券に記載された金ガクのこと。
顔写真	カオジャシン。
顔文字	カオモジ。
顔色	カオイロ。
顔面	ガンメン。
願事	ネガいゴト。
願書	ガンショ。
願望	ガンボウ。
類似	よく似ていること。
類似品	ルイジヒン。
類語	意味が似ている単ゴ。
顧客情報	コキャクジョウホウ。
風上	カザカミ。
風下	カザシモ。
風俗店	フウゾクテン。
風刺画	フウシガ。
風力	カゼのチカラ。
風力発電	フウリョクハツデン。
風向	カザムき。
風味	フウミ。
風情	フゼイ。
風景	フウケイ。
風景画	フウケイガ。
風格	フウカク。
風流	フウリュウ。
風潮	フウチョウ。
風物	フウブツ。
風物詩	フウブツシ。
風紀委員会	フウキイインカイ。
風習	フウ俗・シュウ慣。
風船	フウセン。バルーン。
風車	カゼで回るクルマ。
風速	カゼのソク度。
風邪	「寒い服装で外出すると○○を引くよ」
風邪薬	カゼを治すクスリ。
風雨	カゼとアメ。
飛石	トびイシ。
飛行	空をトぶこと。
飛行機	空をトぶキ械。
食中毒	ショクチュウドク。
食事	タべるコト。
食券	タべるために使うケン。ショク事ケン。
食前	タべるマエ。
食卓	ショク事のための台やテーブル。
食品	栄養分を含み、ショク用に供されるシナ。
食品工場	ショクヒンコウジョウ。
食品添加物	ショクヒンテンカブツ。
食品衛生法	ショクヒンエイセイホウ。
食品表示法	ショクヒンヒョウジホウ。
食器	ショク事のために使うウツワ。
食堂	ショク事をするための部屋。
食塩	ショク用のシオ。
食塩水	ショクエンスイ。
食後	タべたアト。
食感	タべたカンじ。
食文化	ショクブンカ。
食料	タべ物。タべ物になる材リョウ。
食料不足	ショクリョウブソク。
食料事情	ショクリョウジジョウ。
食料品店	ショクリョウヒンテン。
食料問題	ショクリョウモンダイ。
食料生産	ショクリョウセイサン。
食料自給率	ショクリョウジキュウリツ。
食材	料理のザイ料となるショク品。
食欲	何かタべたいというヨク求。
食生活	ショクセイカツ。
食用	ショクヨウ。
食費	ショク事にかかるヒ用。
食道	口から胃までをつなぐ管。
飲料	インリョウ。
飲料水	インリョウスイ。
飲物	ノむモノ。
飲薬	クスリをノむこと。
飲酒	サケをノむこと。「○○運転はやめよう」
飲酒運転	サケをノんでウンテンすること。
飲食	ノんだりタべたりすること。
飲食店	ノんだりタべたりするミセ。
飲食禁止	インショクキンシ。
飼主	動物をカっている人。
飼犬	カっているイヌ。「○○に手をかまれる」
飼育	動物をカってソダてる。
飼育法	シイクホウ。
養分	栄ヨウとなる成ブン。
養子	実際の親コではなく、法律上のみの親コ関係。
養成	教育や訓練をして一人前に育てること。
養成所	ヨウセイジョ。
養生	生活に留意して健康の増進を図ること。
養育費	子どもをヤシナいソダてるヒ用。
養蚕	カイコを育てて副産物を利用する産業。
養蚕業	カイコを育てて副産物を利用する仕事。
館長	図書カンで一番偉い人。
首位打者	シュイダシャ。
首相	内閣総理大臣。総理。
首筋	首の後ろの部分。うなじ。
首脳	組織や団体の中心にいて指導的な役割を果たす人。
首脳会談	シュノウカイダン。
首都	東京都。ワシントン。パリ。
首都東京	シュトトウキョウ。
香川県	四国の北東に位置するケン。うどんが有名。
香料	カオりの元となる材リョウ。
香水	カオり付けのためのミズ。
香港政府	ホンコンセイフ。
香辛料	コウシンリョウ。
馬力	ウマの一頭分のチカラ。
馬耳東風	人の意見を気にしないこと。
馬車	ウマで引いて動かすクルマ。
馬鹿	バカ。ウマシカ。
駅伝	エキデン。
駅前	エキのマエ。
駅員	鉄道のエキの従業イン。
駅弁	鉄道のエキで売るベン当。
駅長	エキで一番偉い人。
駆使	思いどおりに使いこなすこと。クシ。
駆除	虫などを退治すること。
駐車	クルマを長時間とめておくこと。
駐車場	クルマを長時間とめておく場所。
骨折	ホネがオれること。
骨格	コッカク。
骨組	ホネグみ。
骨肉	ホネとニク。
高低	タカいこととヒクいこと。
高価	カ格がタカいこと。
高価買取	コウカカイトリ。
高値	ネ段がタカいこと。
高卒	コウ等学校をソツ業したこと。
高台	タカダイ。
高品質	ヒンシツがタカいこと。
高圧	電アツや水アツなどがタカいこと。
高圧線	電アツがタカい電セン。
高密度	ミツドがタカいこと。
高層	タカい建築物。「○○ビル」
高度	タカさのド合い。海水面からのタカさ。
高度成長期	コウドセイチョウキ。
高度経済成長	コウドケイザイセイチョウ。
高度計	コウドケイ。
高性能	セイノウがタカいこと。
高望	タカノゾみ。
高校	コウ等学コウ。
高校受験	コウコウジュケン。
高校生	コウ等学コウの学セイ。
高校進学	コウコウシンガク。
高機能	コウキノウ。
高気圧	キアツがタカいこと。
高温	オン度がタカいこと。
高温多湿	オン度とシツ度がタカいこと。
高潮	タカシオ。
高潮注意報	タカシオチュウイホウ。
高潮警報	タカシオケイホウ。
高濃度	ノウドがタカいこと。
高熱	体温が非常にタカかった。
高画質	コウガシツ。
高知県	四国の太平洋側に位置するケン。坂本竜馬の出身地。
高等学校	中ガッコウの次。
高級	等キュウや品質・程度などがタカいこと。
高級品	コウキュウヒン。
高級時計	コウキュウドケイ。
高級車	コウキュウシャ。
高血圧	ケツアツがタカいこと。
高裁	「コウ等サイ判所」の略。
高速	非常にハヤいソク度。
高速料金	コウソクリョウキン。
高速道路	コウソクドウロ。
高野連	「日本コウ等学校ヤ球レン盟」の略。
高音	タカいオト。
高音質	コウオンシツ。
高額	値段がタカいこと。
高飛車	タカビシャ。
高齢化社会	コウレイカシャカイ。
高齢者	コウレイシャ。
魚介類	ギョカイルイ。
魚屋	サカナを売る店。
魚市場	サカナのイチバ。
魚群探知機	ギョグンタンチキ。
魚肉	サカナのニク。
魚雷	ギョライ。
魚類	サカナの仲間。
鮮度	食材などの新しさ。フレッシュネス。
鮮明	色や形がアザやかではっきりしているさま。
鳥取県	中国地方の日本海側に位置し、砂丘で有名なケン。
鳥居	トリイ。
鶏卵	ニワトリのタマゴ。
鶏肉	ニワトリのニク。
鹿児島県	九州南部に位置するケン。種子島宇宙センターがある。
麦芽	バクガ。
麦茶	ムギチャ。
麻薬	依存性があり、幻覚や妄想などで頭をおかしくする危険なクスリ。
麻薬中毒	マヤクチュウドク。
麻薬取締官	マヤクトリシマリカン。
麻薬取締法違反	マヤクトリシマリホウイハン。
黄色	イエロー。
黄色人種	キイロのジンシュ。
黄身	卵のキ色のミ。
黄金	ゴールド。
黄金色	ゴールドのイロ。
黄金虫	コガネムシ。
黒人	クロいヒト。
黒字	会社で利益が出た。
黒幕	クロマク。
黒星	相撲で負けのこと。
黒板	チョークで字を書くイタ。教室で使う。
黒毛和牛	クロゲワギュウ。
黒潮	クロシオ。
黒点	太陽の比較的温度の低い場所。クロく見える。
黒煙	クロいケムリ。
黒白	クロとシロ。
黒色	クロいイロ。
黒色人種	クロいイロのジンシュ。
黒豚	クロブタ。
鼻息	ハナから出るイキ。
鼻歌	ハナから出るウタ。ふーふふん。
鼻水	ハナから出るミズ。
鼻血	ハナから出るチ。
摩訶不思議	マカフシギ。
貨物車	カモツシャ。
一等星	イットウセイ。
入道雲	ニュウドウグモ。
絵葉書	エハガキ。
不愛想	ブアイソウ
未解決事件	ミカイケツジケン。
一方的	イッポウテキ。
直接的	チョクセツテキ。
間接的	カンセツテキ。
友好的	ユウコウテキ。
感情的	カンジョウテキ。
基本的	キホンテキ。
松竹梅	ショウチクバイ。
上中下	ジョウチュウゲ。
大中小	ダイチュウショウ。
心技体	シンギタイ。
天地人	テンチジン。
朝昼晩	アサヒルバン。
和洋中	ワヨウチュウ。
近代的	キンダイテキ。
合理的	ゴウリテキ。
合理性	ゴウリセイ。
危険性	キケンセイ。
具体性	グタイセイ。
具体化	グタイカ。
社会性	シャカイセイ。
社会的	シャカイテキ。
機械的	キカイテキ。
自主性	ジシュセイ。
自主的	ジシュテキ。
対照的	タイショウテキ。
抽象的	チュウショウテキ。
抽象化	チュウショウカ。
非合法	ヒゴウホウ。
不案内	フアンナイ。
不分別	フフンベツ。
未発達	ミハッタツ。
無理解	ムリカイ。
未開拓	ミカイタク。
未開拓地	ミカイタクチ。
不売品	フバイヒン。
不心得	フココロエ。
無関心	ムカンシン。
未確認	ミカクニン。
未発表	ミハッピョウ。
未成熟	ミセイジュク。
微生物	ビセイブツ。
眼科医	ガンカイ。
飛行機雲	ヒコウキグモ。
立候補者	リッコウホシャ。
雪月花	セツゲツカ。
紳士的	シンシテキ。
善後策	ゼンゴサク。
門外漢	モンガイカン。
老婆心	ロウバシン。
太公望	タイコウボウ。
登竜門	トウリュウモン。
下剋上	ゲコクジョウ。
好敵手	コウテキシュ。
皮算用	カワザンヨウ。
無造作	ムゾウサ。
花鳥風月	カチョウフウゲツ。
付和雷同	フワライドウ。
自慢話	ジマンバナシ。
因果応報	インガオウホウ。
五里霧中	ゴリムチュウ。
一覧表	イチランヒョウ。
悪趣味	アクシュミ。
悪循環	アクジュンカン。
悪条件	アクジョウケン。
浅知恵	アサヂエ。
天邪鬼	アマノジャク
荒療治	アラリョウジ。
一見識	イチケンシキ。
一辺倒	イッペントウ。
絵空事	エソラゴト。
大海原	オオウナバラ。
大御所	オオゴショ。
大雑把	オオザッパ。
幼馴染	オサナナジミ。
音沙汰	オトサタ。
表沙汰	オモテザタ。
怪文書	カイブンショ。
案山子	カカシ。
風見鶏	カザミドリ。
過不足	カフソク。
感無量	カンムリョウ。
几帳面	キチョウメン。
既得権	キトクケン。
急先鋒	キュウセンポウ
金字塔	キンジトウ。
小細工	コザイク。
御破算	ゴハサン。
最高潮	サイコウチョウ。
猿芝居	サルシバイ。
猿真似	サルマネ。
自堕落	ジダラク。
守銭奴	シュセンド。
修羅場	シュラバ。
正攻法	セイコウホウ。
千秋楽	センシュウラク。
俗世間	ゾクセケン。
千鳥足	チドリアシ。
追体験	ツイタイケン。
出来心	デキゴコロ。
桃源郷	トウゲンキョウ。
逃避行	トウヒコウ。
土地勘	トチカン。
丼勘定	ドンブリカンジョウ。
並大抵	ナミタイテイ。
裸一貫	ハダカイッカン。
破天荒	ハテンコウ。
一筋縄	ヒトスジナワ。
百人力	ヒャクニンリキ。
日和見	ヒヨリミ。
貧乏神	ビンボウガミ。
不謹慎	フキンシン。
袋小路	フクロコウジ。
不合理	フゴウリ。
不見識	フケンシキ。
不作為	フサクイ。
不退転	フタイテン。
不養生	フヨウジョウ。
雰囲気	フンイキ。
分相応	ブンソウオウ。
屁理屈	ヘリクツ。
愛弟子	マナデシ。
真人間	マニンゲン。
未亡人	ミボウジン。
昔気質	ムカシカタギ。
無作為	ムサクイ。
無尽蔵	ムジンゾウ。
無神論	ムシンロン。
無駄足	ムダアシ。
無駄骨	ムダボネ。
胸算用	ムナザンヨウ。
目一杯	メイッパイ。
目論見	モクロミ。
疫病神	ヤクビョウガミ。
八千代	ヤチヨ。
夢心地	ユメゴコチ。
楽天地	ラクテンチ。
両極端	リョウキョクタン。
類人猿	ルイジンエン。
冷血漢	レイケツカン。
一体化	イッタイカ。
簡体字	カンタイジ。
旧体制	キュウタイセイ。
具体案	グタイアン。
口語体	コウゴタイ。
弱腰外交	ヨワゴシガイコウ。
情報弱者	ジョウホウジャクシャ。
基礎化粧品	キソケショウヒン。
高齢化	コウレイカ
化学結合	カガクケツゴウ。
化学物質	カガクブッシツ。
化学的去勢	カガクテキキョセイ。
感染症	カンセンショウ。
化学兵器	カガクヘイキ。
繁華街	ハンカガイ。
時間設定	ジカンセッテイ。
改正法	カイセイホウ。
不要不急	フヨウフキュウ。
安定的	アンテイテキ。
感染力	カンセンリョク。
多神教	タシンキョウ。
細胞核	サイボウカク。
顕微鏡	ケンビキョウ。
標準的	ヒョウジュンテキ。
細胞膜	サイボウマク。
高分子	コウブンシ。
水素結合	スイソケツゴウ。
大正時代	タイショウジダイ。
電気事業	デンキジギョウ。
昭和時代	ショウワジダイ。
常務	ジョウム。
火力発電所	カリョクハツデンショ。
交渉成立	コウショウセイリツ。
活発化	カッパツカ。
短期間	タンキカン。
長期間	チョウキカン。
有効票	ユウコウヒョウ。
無効票	ムコウヒョウ。
十字型	ジュウジガタ。
円柱状	エンチュウジョウ。
名産品	メイサンヒン。
食物繊維	ショクモツセンイ。
満洲事変	マンシュウジヘン。
国家予算	コッカヨサン。
最盛期	サイセイキ。
植民地支配	ショクミンチシハイ。
敗戦国	ハイセンコク。
航空会社	コウクウガイシャ。
鉄道経営	テツドウケイエイ。
政情不安	セイジョウフアン。
治外法権	チガイホウケン。
都市計画	トシケイカク。
住宅街	ジュウタクガイ。
宿泊施設	シュクハクシセツ。
娯楽施設	ゴラクシセツ。
旧日本軍	キュウニホングン。
発言権	ハツゲンケン。
軍事利用	グンジリヨウ。
好意的	コウイテキ。
議定書	ギテイショ。
給水管	キュウスイカン。
水槽	スイソウ。
施設	シセツ。
決定事項	ケッテイジコウ。
勧告	カンコク。すすめつげること。
譲渡	ジョウト。
改良工事	カイリョウコウジ。
経営権	ケイエイケン。
売却	バイキャク。
建設費	ケンセツヒ。
門戸開放	モンコカイホウ。
機会均等	キカイキントウ。
国際政治	コクサイセイジ。
石油権益	セキユケンエキ。
戦勝国	センショウコク。
人類社会	ジンルイシャカイ。
最高水準	サイコウスイジュン。
工業化	コウギョウカ。
相互作用	ソウゴサヨウ。
日米関係	ニチベイカンケイ。
帝国主義	テイコクシュギ。
社会不安	シャカイフアン。
公共性	コウキョウセイ。
重要局面	ジュウヨウキョクメン。
通院	ツウイン。
定例記者会見	テイレイキシャカイケン。
冒頭	ボウトウ。
官房長官	カンボウチョウカン。
外出自粛	ガイシュツジシュク。
逆風	ギャクフウ。
連載	レンサイ。
自由貿易協定	ジユウボウエキキョウテイ。
経営難	ケイエイナン。
統廃合	トウハイゴウ。
大人数	オオニンズウ。
転換点	テンカンテン。
市場動向	シジョウドウコウ。
失点	シッテン。
性差別	セイサベツ。
人権感覚	ジンケンカンカク。
墜落事故	ツイラクジコ。
運航停止	ウンコウテイシ。
運航再開	ウンコウサイカイ。
概算要求	ガイサンヨウキュウ。
少人数学級	ショウニンズウガッキュウ。
現地時間	ゲンチジカン。
皆様方	ミナサマガタ。
御協力	ゴキョウリョク。
上場廃止	ジョウジョウハイシ。
財務情報	ザイムジョウホウ。
政官財	セイカンザイ。
感染者	カンセンシャ。
条例案	ジョウレイアン。
市議会	シギカイ。
住民投票	ジュウミントウヒョウ。
公聴会	コウチョウカイ。
識別子	シキベツシ。
徹底	テッテイ。
徹底的	テッテイテキ。
徹夜	テツヤ。
防御率	ボウギョリツ。
守護神	シュゴシン。
冷徹	レイテツ。
筆順	ヒツジュン。
常用漢字表	ジョウヨウカンジヒョウ。
七不思議	ナナフシギ。
錬金術士	レンキンジュツシ。
錬金術	レンキンジュツ。
決定版	ケッテイバン。
最新作	サイシンサク。
曲者	クセモノ。
御案内	ゴアンナイ。
一般社団法人	イッパンシャダンホウジン。
社団法人	シャダンホウジン。
構成員	コウセイイン。
非営利	ヒエイリ。
剰余金	ジョウヨキン。
許認可	キョニンカ。
公益性	コウエキセイ。
財団法人	ザイダンホウジン。
会社設立	カイシャセツリツ。
追加料金	ツイカリョウキン。
最高顧問	サイコウコモン。
官僚出身者	カンリョウシュッシンシャ。
代償	ダイショウ。
合理主義	ゴウリシュギ。
排斥運動	ハイセキウンドウ。
好景気	コウケイキ。
選挙資金	センキョシキン。
決定的証拠	ケッテイテキショウコ。
副社長	フクシャチョウ。
常務取締役	ジョウムトリシマリヤク。
理事	リジ。
失業問題	シツギョウモンダイ。
食糧問題	ショクリョウモンダイ。
経営合理化	ケイエイゴウリカ。
関連企業	カンレンキギョウ。
鉄道工事	テツドウコウジ。
後継者不足	コウケイシャブソク。
後継者育成	コウケイシャイクセイ。
後継者問題	コウケイシャモンダイ。
参謀	サンボウ。
共存共栄	キョウゾンキョウエイ。
計画性	ケイカクセイ。
危機的状況	キキテキジョウキョウ。
外国資本	ガイコクシホン。
外資	ガイ国シ本。
世界恐慌	セカイキョウコウ。
沈静化	チンセイカ。
致命的	チメイテキ。
平行線	ヘイコウセン。
最高幹部	サイコウカンブ。
技術力	ギジュツリョク。
所要時間	ショヨウジカン。
代表例	ダイヒョウレイ。
中心人物	チュウシンジンブツ。
記念式典	キネンシキテン。
記念映画	キネンエイガ。
現実味	ゲンジツミ。
交通網	コウツウモウ。
戦利品	センリヒン。
不安定	フアンテイ。
空気抵抗	クウキテイコウ。
創業者	ソウギョウシャ。
衆議院議員	シュウギインギイン。
外務大臣	ガイムダイジン。
大舞台	オオブタイ。
歴史資料	レキシシリョウ。
不平等条約	フビョウドウジョウヤク。
留学生	リュウガクセイ。
伝統的	デントウテキ。
講和条約	コウワジョウヤク。
外交交渉	ガイコウコウショウ。
日英同盟	ニチエイドウメイ。
関税自主権	カンゼイジシュケン。
保存会	ホゾンカイ。
近代国家	キンダイコッカ。
留学経験	リュウガクケイケン。
条約改正	ジョウヤクカイセイ。
哲学	テツガク。
哲学者	テツガクシャ。
教育学者	キョウイクガクシャ。
同性愛	ドウセイアイ。
思考実験	シコウジッケン。
根本的	コンポンテキ。
執筆者	シッピツシャ。
新進気鋭	シンシンキエイ。
資料請求	シリョウセイキュウ。
複雑化	フクザツカ。
研究活動	ケンキュウカツドウ。
正当性	セイトウセイ。
翻訳書	ホンヤクショ。
事象	ジショウ。ものごと。
粘土板	ネンドバン。
人口問題	ジンコウモンダイ。
歴史書	レキシショ。
免責事項	メンセキジコウ。
開発者	カイハツシャ。
利用規約	リヨウキヤク。
解説書	カイセツショ。
忍者	ニンジャ。
縄文時代	ジョウモンジダイ。
弥生時代	ヤヨイジダイ。
古墳時代	コフンジダイ。
飛鳥時代	アスカジダイ。
古代国家	コダイコッカ。
南北朝時代	ナンボクチョウジダイ。
貝塚	カイヅカ。
副反応	フクハンノウ。
稲作	イナサク。
渡来人	トライジン。
前方後円墳	ゼンポウコウエンフン。
北九州	キタキュウシュウ。
仏教文化	ブッキョウブンカ。
政治権力	セイジケンリョク。
冠位十二階	カンイジュウニカイ。
十七条憲法	ジュウナナジョウケンポウ。
親書	シンショ。
神格化	シンカクカ。
税収	ゼイシュウ。
朝廷	チョウテイ。公家政権。
地方分権	チホウブンケン。
政権中枢	セイケンチュウスウ。
貨幣経済	カヘイケイザイ。
金剛力士像	コンゴウリキシゾウ。
抗争	コウソウ。
室町文化	ムロマチブンカ。
南蛮貿易	ナンバンボウエキ。
桃山文化	モモヤマブンカ。
支配体制	シハイタイセイ。
大政奉還	タイセイホウカン。
歌舞伎	カブキ。
王政復古	オウセイフッコ。
琉球王国	リュウキュウオウコク。
小笠原諸島	オガサワラショトウ。
大日本帝国憲法	ダイニッポンテイコクケンポウ。
軍事力強化	グンジリョクキョウカ。
社会的地位	シャカイテキチイ。
真珠湾攻撃	シンジュワンコウゲキ。
農地改革	ノウチカイカク。
財閥解体	ザイバツカイタイ。
経済力	ケイザイリョク。
財閥	ザイバツ。
派閥	ハバツ。
政治資金	セイジシキン。
官邸主導	カンテイシュドウ。
一定期間	イッテイキカン。
新人議員	シンジンギイン。
議員数	ギインスウ。
離党	リトウ。
無派閥	ムハバツ。
日米安全保障条約	ニチベイアンゼンホショウジョウヤク。
主権回復	シュケンカイフク。
竹島占領	タケシマセンリョウ。
日中国交正常化	ニッチュウコッコウセイジョウカ。
沖縄返還	オキナワヘンカン。
中華民国	チュウカミンコク。
軟着陸	ナンチャクリク。
産業構造	サンギョウコウゾウ。
貿易摩擦	ボウエキマサツ。
阪神淡路大震災	ハンシンアワジダイシンサイ。
産業空洞化	サンギョウクウドウカ。
貧困層	ヒンコンソウ。
仮想通貨	カソウツウカ。
人工知能	ジンコウチノウ。
首都高速	シュトコウソク。
米騒動	コメソウドウ。
区画整理	クカクセイリ。
道路拡張	ドウロカクチョウ。
大変革	ダイヘンカク。
環状道路	カンジョウドウロ。
大災害	ダイサイガイ。
総辞職	ソウジショク。
治安維持法	チアンイジホウ。
政党政治	セイトウセイジ。
同人誌	ドウジンシ。
財政負担	ザイセイフタン。
列強	レッキョウ。
意見対立	イケンタイリツ。
三国同盟	サンゴクドウメイ。
枢軸国	スウジクコク。
戦時体制	センジタイセイ。
大政翼賛会	タイセイヨクサンカイ。
町内会	チョウナイカイ。
石油備蓄量	セキユビチクリョウ。
生活物資	セイカツブッシ。
社会資本	シャカイシホン。
原子爆弾	ゲンシバクダン。
民間人	ミンカンジン。
被爆者	ヒバクシャ。
原爆投下	ゲンバクトウカ。
玉音放送	ギョクオンホウソウ。
共和党	キョウワトウ。
自民党	ジミントウ。
共産党	キョウサントウ。
日本共産党	ニホンキョウサントウ。
米軍	アメリカぐん。
朝鮮戦争	チョウセンセンソウ。
在日米軍	ザイニチベイグン。
無差別爆撃	ムサベツバクゲキ。
国内経済	コクナイケイザイ。
中国大陸	チュウゴクタイリク。
毛沢東	モウタクトウ。
日本映画	ニホンエイガ。
当用漢字	トウヨウカンジ。
平和条約	ヘイワジョウヤク。
重要拠点	ジュウヨウキョテン。
大阪万博	オオサカバンパク。
非核三原則	ヒカクサンゲンソク。
都市部	トシブ。
学生運動	ガクセイウンドウ。
社会問題化	シャカイモンダイカ。
地域住民	チイキジュウミン。
消費者庁	ショウヒシャチョウ。
新着情報	シンチャクジョウホウ。
関係省庁	カンケイショウチョウ。
食品事故	ショクヒンジコ。
悪質商法	アクシツショウホウ。
被害防止	ヒガイボウシ。
企画立案	キカクリツアン。
安心安全	アンシンアンゼン。
広報活動	コウホウカツドウ。
内需拡大	ナイジュカクダイ。
超大国	チョウタイコク。
絶対的	ゼッタイテキ。
海外派遣	カイガイハケン
平和維持活動	ヘイワイジカツドウ。
湾岸戦争	ワンガンセンソウ。
資金援助	シキンエンジョ。
肉体労働者	ニクタイロウドウシャ。
低賃金	テイチンギン。
失業者	シツギョウシャ。
就職難	シュウショクナン。
非正規	ヒセイキ。
地方経済	チホウケイザイ。
過疎化	カソカ。
中央省庁再編	チュウオウショウチョウサイヘン。
人件費抑制	ジンケンヒヨクセイ。
内需	ナイジュ。
圧倒的勝利	アットウテキショウリ。
未曾有	ミゾウ。
閉塞感	ヘイソクカン。
個人番号	コジンバンゴウ。
皇室典範	コウシツテンパン。
要人警護	ヨウジンケイゴ。
検索	ケンサク。
潜水士	センスイシ。
不審物	フシンブツ。
文化圏	ブンカケン。
通信技術	ツウシンギジュツ。
文字列	モジレツ。
番組名	バングミメイ。
店舗	テンポ。
舗装	ホソウ。
学籍	ガクセキ。
駐車料金	チュウシャリョウキン。
台数	ダイスウ。
情報量	ジョウホウリョウ。
児童書	ジドウショ。
警察庁	ケイサツチョウ。
公正取引委員会	コウセイトリヒキイインカイ。
日本郵政	ニホンユウセイ。ＪＰ。
消防庁	ショウボウチョウ。
公安	コウアン。
文化庁	ブンカチョウ。
社会保険庁	シャカイホケンチョウ。
林野庁	リンヤチョウ。
水産庁	スイサンチョウ。
中小企業庁	チュウショウキギョウチョウ。
海上保安庁	カイジョウホアンチョウ。
会計検査院	カイケイケンサイン。
人事院	ジンジイン。
会社概要	カイシャガイヨウ。
消臭	においをけすこと。
除菌	ジョキン。
世界征服	セカイセイフク。
胴体	動物の体の頭・首・手・足を取り除いた部分。
布製品	ヌノセイヒン。
温度差	オンドサ。
特殊加工	トクシュカコウ。
消臭剤	ショウシュウザイ。
具材	グザイ。
資質	生まれつき持っている性質や才能。
番組表	バングミヒョウ。
酸化防止剤	サンカボウシザイ。
広報室	コウホウシツ。
販売金額	ハンバイキンガク。
生産工場	セイサンコウジョウ。
小部屋	コベヤ。
蛍光灯	ケイコウトウ。
蛍光塗料	ケイコウトリョウ。
募集中	ボシュウチュウ。
商品番号	ショウヒンバンゴウ。
応募者	オウボシャ。
信頼性	シンライセイ。
操作性	ソウサセイ。
最先端	サイセンタン。
効率的	コウリツテキ。
未然	ミゼン。
暗号化	アンゴウカ。
周辺機器	パソコンのシュウヘンキキ。
音声入力	オンセイニュウリョク。
再起動	パソコンのサイキドウ。
自動化	ジドウカ。
接続先	セツゾクサキ。
理想的	リソウテキ。
負荷分散	フカブンサン。
電子商取引	インターネット上のデンシショウトリヒキ。
互換性	ゴカンセイ。
推奨	スイショウ。オススメすること。
本書	ホンショ。
本製品	ホンセイヒン。
会社名	カイシャメイ。
製品名	セイヒンメイ。
調理法	チョウリホウ。
薄口	ウスクチ。
玉子	タマゴ。
結露	ケツロ。
板状	イタジョウ。
肉体疲労	ニクタイヒロウ。
妊婦	ニンプ。
妊娠	ニンシン。
政財界	セイザイカイ。
使用期限	シヨウキゲン。
虚弱体質	キョジャクタイシツ。
体力低下	タイリョクテイカ。
食欲不振	ショクヨクフシン。
抽出	チュウシュツ。
業務用	ギョウムヨウ。
脱脂粉乳	ダッシフンニュウ。
酢酸	サクサン。
海老	エビ。
焼豚	チャーシュー。
豚肉	ブタニク。
山芋	ヤマイモ。
里芋	サトイモ。
大学芋	ダイガクイモ。
栄養成分表示	エイヨウセイブンヒョウジ。
食塩相当量	ショクエンソウトウリョウ。
原産地	ゲンサンチ。
染色体	センショクタイ。
一般家庭	イッパンカテイ。
国力	コクリョク。
寒冷地	カンレイチ。
影響力	エイキョウリョク。
地上茎	チカケイ。
完熟	カンジュク。
比較的	ヒカクテキ。
切断面	セツダンメン。
意図的	イトテキ。
収穫期	シュウカクキ。
獲得	カクトク。
貯蔵庫	チョゾウコ。
保存状態	ホゾンジョウタイ。
繁殖	ハンショク。勢いよく増えること。
検査日	ケンサビ。
自家栽培	ジカサイバイ。
発育不良	ハツイクフリョウ。
生産地域	セイサンチイキ。
統計資料	トウケイシリョウ。
収穫量	シュウカクリョウ。
片栗粉	カタクリコ。
芋類	イモルイ。
加熱調理	カネツチョウリ。
便秘	ベンピ。
日本食	ニホンショク。
保存食	ホゾンショク。
酒造	シュゾウ。
特産品	トクサンヒン。
事業所	ジギョウショ。
芋焼酎	イモジョウチュウ。
早期治療	ソウキチリョウ。
患部	カンブ。
含有量	ガンユウリョウ。
試験場	シケンジョウ。
腎臓	ジンゾウ。
品種登録	ヒンシュトウロク。
育成	イクセイ。
交配種	コウハイシュ。
品種名	ヒンシュメイ。
販売会社	ハンバイガイシャ。
濃厚	ノウコウ。
抗酸化作用	コウサンカサヨウ。
突然変異	トツゼンヘンイ。
普及	フキュウ。一般に出回る。
南米	ミナミアメリカ。
作付面積	サクツケメンセキ。
疫病	エキビョウ。
夜会	ヤカイ。
食糧危機	ショクリョウキキ。
食糧問題	ショクリョウモンダイ。
紙袋	カミブクロ。
加工業者	カコウギョウシャ。
長期貯蔵	チョウキチョゾウ。
一般的	イッパンテキ。
生産国	セイサンコク。
冷暗所	レイアンショ。
生食用	セイショクヨウ。
観葉植物	カンヨウショクブツ。
商業目的	ショウギョウモクテキ。
商用	ショウヨウ。ショウ売で使うこと。
園芸植物	エンゲイショクブツ。
長寿	チョウジュ。
繁栄	ハンエイ。豊かにサカえること。
熱帯産	ネッタイサン。
野生化	ヤセイカ。
放射状	ホウシャジョウ。
中心部	チュウシンブ。
怪物	カイブツ。
怪談	怖い話。
水耕栽培	スイコウサイバイ。
小動物	ショウドウブツ。
盆栽	ボンサイ。
樹脂	ジュシ。
医療器具	イリョウキグ。
自動変速装置	ジドウヘンソクソウチ。
奈落	ナラク。
好男子	コウダンシ。
色男	イロオトコ。
美少年	ビショウネン。
通信社	ツウシンシャ。
大気汚染	タイキオセン。
遠征軍	エンセイグン。
労働党	ロウドウトウ。
看護士	カンゴシ。
旅行業	リョコウギョウ。
取引所	トリヒキジョ。
金脈	キンミャク。
航空隊	コウクウタイ。
専門家会議	センモンカカイギ。
自治会	ジチカイ。
造船業	ゾウセンギョウ。
標準時	ヒョウジュンジ。
原子炉	ゲンシロ。
工業会	コウギョウカイ。
運送料	ウンソウリョウ。
普通便	フツウビン。
原価計算	ゲンカケイサン。
見積	ミツモリ。
見積書	ミツモリショ。
請求	セイキュウ。
防疫	ボウエキ。病気をフセぐこと。
教徒	キョウト。宗キョウの信者。
洗礼	センレイ。信者になる儀式。
内戦	ナイセン。国家のナイ部の紛争。
極東	キョクトウ。
連合会	レンゴウカイ。
離縁	リエン。
偵察	テイサツ。
偵察衛星	テイサツエイセイ。
魔術	マジュツ。
復活祭	フッカツサイ。
通貨単位	ツウカタンイ。
知恵熱	チエネツ。
