# ただいま作成中。。。
愛国	あいこく。
愛国者	あいこくしゃ。
合言葉	あいことば。
愛人	あいじん。
合図	あいず。
相手	あいて。
愛読書	あいどくしょ
相棒	あいぼう。
合間	あいま。
愛用	あいよう。
愛用品	あいようひん。
青空	あおぞら。
赤子	あかご。
赤土	あかつち。
悪臭	あくしゅう。
握手	あくしゅ。
悪事	あくじ。
悪人	あくにん。
悪役	あくやく。
握力	あくりょく。
足跡	あしあと。
足元	あしもと。
味見	あじみ。
小豆	あずき。
悪化	あっか。
厚着	あつぎ。
圧縮	あっしゅく。
圧勝	あっしょう。
圧力	あつりょく。
外圧	がいあつ。
空気圧	くうきあつ。
後始末	あとしまつ。
脂汗	あぶらあせ。
雨戸	あまど。
米国	べいこく。
在処	ありか。
模様	もよう。
暗雲	あんうん。
積乱雲	せきらんうん。
暗殺	あんさつ。
暗殺者	あんさつしゃ。
安産	あんざん。
暗号	あんごう
暗号文	あんごうぶん。
安心	あんしん。
安全	あんぜん
安定	あんてい
案内	あんない
委員会	いいんかい
遺影	いえい。
胃液	いえき。
胃腸	いちょう。
銀杏	ぎんなん。
家出	いえで。
外出	がいしゅつ。
以外	いがい。
意外	いがい。
医学	いがく。
経緯	いきさつ。
生物	せいぶつ。
英国	えいこく。
意気地	いくじ。
育児	いくじ。
育成	いくせい。
意見	いけん。
遺骨	いこつ。
居心地	いごこち。
異彩	いさい。
石頭	いしあたま。
意識	いしき。
医者	いしゃ。
異臭	いしゅう。
遺書	いしょ。
衣装	いしょう。
以上	いじょう。
異常	いじょう。
医術	いじゅつ。
異性	いせい。
威勢	いせい。
遺跡	いせき。
一月	いちがつ。
一日	ついたち。
二日	ふつか。
三日	みっか。
四日	よっか。
五日	いつか。
八日	ようか。
二十歳	はたち。
二十日	はつか。
一大事	いちだいじ。
一同	いちどう。
市場	いちば。しじょう。
一番	いちばん。
一番星	いちばんぼし。
一枚	いちまい。
胃腸	いちょう。
一流	いちりゅう。
一回	いっかい。
一曲	いっきょく。
一生	いっしょう。
一所懸命	いっしょけんめい
移動	いどう。
居所	いどころ。
井戸端会議	いどばたかいぎ。
田舎者	いなかもの。
稲妻	いなずま。
違反者	いはんしゃ。
衣服	いふく。
異物混入	いぶつこんにゅう。
違法駐車	いほうちゅうしゃ。
意欲	いよく。
依頼者	いらいしゃ。
依頼人	いらいにん。
海豚	いるか。
刺青	いれずみ。
刺身	さしみ。
色男	いろおとこ。
色眼鏡	いろめがね。
異論	いろん。
岩場	いわば。
引火	いんか。
印鑑	いんかん。
隠居	いんきょ。
印刷	いんさつ。
印刷機	いんさつき。
飲酒運転	いんしゅうんてん。
印章	いんしょう。
印象	いんしょう。
飲食	いんしょく。
陰性	いんせい。
陽性	ようせい。
印税	いんぜい。
消費税	しょうひぜい。
所得税	しょとくぜい。
引退	いんたい。
印度	いんど。
陰謀	いんぼう。
引用	いんよう。
引力	いんりょく。
万有引力	ばんゆういんりょく。
魚市場	うおいちば。
受付	うけつけ。
薄着	うすぎ。
右折	うせつ。
左折	させつ。
内側	うちがわ。
外側	そとがわ。
内堀	うちぼり。
宇宙人	うちゅうじん。
雨天決行	うてんけっこう。
乳母車	うばぐるま。
海亀	うみがめ。
海辺	うみべ。
梅酒	うめしゅ。
裏金	うらがね。
裏側	うらがわ。
裏声	うらごえ。
売上	うりあげ。
上着	うわぎ。
下着	したぎ。
運営	うんえい。
経営	けいえい。
経営者	けいえいしゃ。
運河	うんが。
運送料	うんそうりょう。
運転手	うんてんしゅ。
運命	うんめい。
永遠	えいえん。
英会話	えいかいわ。
鋭角	えいかく。
鈍角	どんかく。
永久	えいきゅう。
影響	えいきょう。
営業	えいぎょう。
営業日	えいぎょうび。
休日	きゅうじつ。
衛生	えいせい。
人工衛星	じんこうえいせい。
映像	えいぞう。
英文	えいぶん。
永眠	えいみん。
栄養	えいよう。
栄養士	えいようし。
笑顔	えがお。
液体	えきたい。
駅員	えきいん。
駅長	えきちょう。
駅弁	えきべん。
番組表	ばんぐみひょう。
長期間	ちょうきかん。
長時間	ちょうじかん。
短時間	たんじかん。
短期間	たんきかん。
乾電池	かんでんち。
誤動作	ごどうさ。
誤作動	ごさどう。
取扱説明書	とりあつかいせつめいしょ。
日本製	にほんせい。
令和	れいわ。
開封	かいふう。
早期発見	そうきはっけん。
国保	こくほ。
無料	むりょう。
自覚症状	じかくしょうじょう。
生活習慣	せいかつしゅうかん。
受信	じゅしん。
受診	じゅしん。
信頼度	しんらいど。
供給源	きょうきゅうげん。
相談室	そうだんしつ。
製品	せいひん。
底面	ていめん。
祝日	しゅくじつ。
国連	こくれん。
吸着	きゅうちゃく。
報告書	ほうこくしょ。
確定申告	かくていしんこく。
留意点	りゅういてん。
配当金	はいとうきん。
年間	ねんかん。
月刊	げっかん。
廃止	はいし。
累計	るいけい。
税務署	ぜいむしょ。
音声案内	おんせいあんない。
電話相談	でんわそうだん。
個人事業者	こじんじぎょうしゃ。
法人税	ほうじんぜい。
納税	のうぜい。
職員	しょくいん。
電話機	でんわき。
受話器	じゅわき。
水虫	みずむし。
医薬品	いやくひん。
幹部	かんぶ。
患部	かんぶ。
保管	ほかん。
薬剤師	やくざいし。
直射日光	ちょくしゃにっこう。
顔面	がんめん。
粘膜	ねんまく。
販売者	はんばいしゃ。
成分	せいぶん。
塩酸	えんさん。
電話番号	でんわばんごう。
窓口	まどぐち。
医療機器	いりょうきき。
市町村	しちょうそん。
領収書	りょうしゅうしょ。
紛失防止	ふんしつぼうし。
保証期間	ほしょうきかん。
証明書	しょうめいしょ。
落雷	らくらい。
自信	じしん。
地震	じしん。
天変地異	てんぺんちい。
湿度	しつど。
湿地	しっち。
故障	こしょう。
送料	そうりょう。
負担	ふたん。
日本国	にほんこく。
代金	だいきん。
交換	こうかん。
受付時間	うけつけじかん。
登録商標	とうろくしょうひょう。
原材料名	げんざいりょうめい。
活性炭	かっせいたん。
有効期限	ゆうこうきげん。
鉄粉	てっぷん。
低温	ていおん。
就寝	しゅうしん。
乳幼児	にゅうようじ。
万全	ばんぜん。
不良品	ふりょうひん。
有効期限	ゆうこうきげん。
持続時間	じぞくじかん。
裏面	うらめん。
消臭剤	しょうしゅうざい。
緑茶	りょくちゃ。
布製品	ぬのせいひん。
衣類	いるい。
料理	りょうり。
防止	ぼうし。
船体	せんたい。
表面	ひょうめん。
場合	ばあい。
部屋	へや。
人工皮革	じんこうひかく。
毛皮	けがわ。
心配	しんぱい。
防水加工	ぼうすいかこう。
換気	かんき。
原因	げんいん。
照明器具	しょうめいきぐ。
電気製品	でんきせいひん。
精密機器	せいみつきき。
保管	ほかん。
温度差	おんどさ。
自動車	じどうしゃ。
業務用	ぎょうむよう。
容器	ようき。
気分	きぶん。
風味	ふうみ。
使用後	しようご。
砂糖	さとう。
酸化防止剤	さんかぼうしざい。
食塩	しょくえん。
粉末	ふんまつ。
調味料	ちょうみりょう。
着色料	ちゃくしょくりょう。
賞味期限	しょうみきげん。
保存方法	ほぞんほうほう。
開封後	かいふうご。
調理	ちょうり。
調理師	ちょうりし。
具材	ぐざい。
目安	めやす。
秘密	ひみつ。
豆腐	とうふ。
両面	りょうめん。
高温多湿	こうおんたしつ。
大根	だいこん。
内容量	ないようりょう。
素材	そざい。
製法	せいほう。
密封	みっぷう。
品質	ひんしつ。
酸味料	さんみりょう。
原材料	げんざいりょう。
対象	たいしょう。
栄養	えいよう。
未開封	みかいふう。
植物油脂	しょくぶつゆし。
酢酸	さくさん。
小麦	こむぎ。
大豆	だいず。
乳成分	にゅうせいぶん。
小麦粉	こむぎこ。
株式会社	かぶしきがいしゃ。
消費期限	しょうひきげん。
製造者	せいぞうしゃ。
包装	ほうそう。
放送	ほうそう。
朝食	ちょうしょく。
記載	きさい。
変色	へんしょく。
区分	くぶん。
感想	かんそう。
乾燥機	かんそうき。
廃棄	はいき。
自治体	じちたい。
中性洗剤	ちゅうせいせんざい。
家具	かぐ。
材質	ざいしつ。
掃除	そうじ。
清掃作業	せいそうさぎょう。
界面活性剤	かいめんかっせいざい。
使用方法	しようほうほう。
乾燥剤	かんそうざい。
炭水化物	たんすいかぶつ。
乳化剤	にゅうかざい。
表面	ひょうめん。
割引	わりびき。
高熱	こうねつ。
電子	でんし。
不都合	ふつごう。
液体	えきたい。
油性	ゆせい。
情報	じょうほう。
家電	かでん。
透明	とうめい。
半透明	はんとうめい。
高密度	こうみつど。
企画	きかく。
新規格	しんきかく。
新企画	しんきかく。
規格	きかく。
名詞	めいし。
名刺	めいし。
手間	てま。
温度	おんど。
時間	じかん。
採用	さいよう。
参加	さんか。
参加者	さんかしゃ。
空気	くうき。
空気圧	くうきあつ。
牛乳	ぎゅうにゅう。
製造所	せいぞうしょ。
保存方法	ほぞんほうほう。
工場	こうじょう。
換算	かんざん。
沈殿	ちんでん。
番号	ばんごう。
問題	もんだい。
当選	とうせん。
当選者	とうせんしゃ。
当選番号	とうせんばんごう。
製法	せいほう。
三日月	みかづき。
模様	もよう。
常温	じょうおん。
中火	ちゅうび。
水気	みずけ。
液体	えきたい。
固体	こたい。
完全	かんぜん。
野菜	やさい。
豚肉	ぶたにく。
落花生	らっかせい。
牛肉	ぎゅうにく。
設備	せつび。
漁法	ぎょほう。
採取	さいしゅ。
注意	ちゅうい。
香辛料	こうしんりょう。
色素	しきそ。
食品	しょくひん。
当社比	とうしゃひ。
特製	とくせい。
鉄板	てっぱん。
枠内	わくない。
鶏肉	とりにく。
厚手	あつで。
少量	しょうりょう。
多量	たりょう。
調理	ちょうり。
計量	けいりょう。
脱脂粉乳	だっしふんにゅう。
加工品	かこうひん。
乳化剤	にゅうかざい。
側面	そくめん。
密封容器	みっぷうようき。
減量	げんりょう。
原料	げんりょう。
味見	あじみ。
変化	へんか。
矢印	やじるし。
方向	ほうこう。
反対	はんたい。
外箱	そとばこ。
食感	しょっかん。
保存	ほぞん。
便利	べんり。
水気	みずけ。
冷蔵庫	れいぞうこ。
変質	へんしつ。
発生	はっせい。
大量発生	たいりょうはっせい。
有限会社	ゆうげんがいしゃ。
材質	ざいしつ。
薬品	やくひん。
唐辛子	とうがらし。
最低	さいてい。
最適	さいてき。
沸騰	ふっとう。
沸点	ふってん。
完成	かんせい。
完成品	かんせいひん。
日本酒	にほんしゅ。
魚類	ぎょるい。
脱酸素剤	だつさんそざい。
良質	りょうしつ。
食品衛生法	しょくひんえいせいほう。
左右	さゆう。
清潔	せいけつ。
作業	さぎょう。
弁当	べんとう。
手袋	てぶくろ。
中指	なかゆび。
全長	ぜんちょう。
開口部	かいこうぶ。
写真	しゃしん。
個人差	こじんさ。
兼用	けんよう。
日曜大工	にちようだいく。
園芸	えんげい。
防止	ぼうし。
体質	たいしつ。
感電死	かんでんし。
重量	じゅうりょう。
保管場所	ほかんばしょ。
適合	てきごう。
添加物	てんかぶつ。
不備	ふび。
販売元	はんばいもと。
生命	せいめい。
特徴	とくちょう。
園芸用品	えんげいようひん。
紅茶	こうちゃ。
料理	りょうり。
表示	ひょうじ。
反対側	はんたいがわ。
状態	じょうたい。
簡単	かんたん。
試験	しけん。
分析	ぶんせき。
食品	しょくひん。
再度	さいど。
工程	こうてい。
材料	ざいりょう。
処理	しょり。
特定	とくてい。
定番	ていばん。
食欲	しょくよく。
風味	ふうみ。
厳選	げんせん。
全体	ぜんたい。
動画	どうが。
中辛	ちゅうから。
充分	じゅうぶん。
今日	きょう。
中火	ちゅうび。
薬用	やくよう。
進行	しんこう。
視界	しかい。
歯科医	しかい。
異常	いじょう。
医薬部外品	いやくぶがいひん。
講習	こうしゅう。
口臭	こうしゅう。
上品	じょうひん。
長期保存	ちょうきほぞん。
窓口	まどぐち。
保険	ほけん。
資料請求	しりょうせいきゅう。
死亡保険	しぼうほけん。
通常	つうじょう。
保険料	ほけんりょう。
健康状態	けんこうじょうたい。
重要	じゅうよう。
収集日	しゅうしゅうび。
分別	ぶんべつ。
国道	こくどう。
剣道	けんどう。
西側	にしがわ。
東側	ひがしがわ。
北側	きたがわ。
南側	みなみがわ。
自治区	じちく。
地域	ちいき。
新聞紙	しんぶんし。
雑誌	ざっし。
温度計	おんどけい。
蛍光管	けいこうかん。
体温計	たいおんけい。
古紙	こし。
金属	きんぞく。
毎週	まいしゅう。
無色	むしょく。
医薬品	いやくひん。
手数料	てすうりょう。
運搬	うんぱん。
推進	すいしん。
耐熱	たいねつ。
危険物	きけんぶつ。
未満	みまん。
指定	してい。
応募券	おうぼけん。
毎回	まいかい。
当選	とうせん。
発表	はっぴょう。
発表会	はっぴょうかい。
抽選	ちゅうせん。
抽選会	ちゅうせんかい。
指名	しめい。
氏名	しめい。
住所	じゅうしょ。
自然	しぜん。
浸透	しんとう。
心地	ここち。
洗顔	せんがん。
適量	てきりょう。
毛穴	けあな。
保湿	ほしつ。
失神	しっしん。
刺激	しげき。
相談	そうだん。
悪化	あっか。
日光	にっこう。
香料	こうりょう。
空気	くうき。
細菌	さいきん。
感染	かんせん。
感染者	かんせんしゃ。
侵入	しんにゅう。
侵入者	しんにゅうしゃ。
新入社員	しんにゅうしゃいん。
構造	こうぞう。
不織布	ふしょくふ。
花粉	かふん。
立体	りったい。
加工	かこう。
静電気	せいでんき。
吸着	きゅうちゃく。
形状	けいじょう。
空間	くうかん。
軽減	けいげん。
気分	きぶん。
有毒	ゆうどく。
有害	ゆうがい。
産業	さんぎょう。
枝葉	えだは。
絵日記	えにっき。
絵葉書	えはがき。
海老	えび。
絵本	えほん。
演歌	えんか。
宴会	えんかい。
遠隔操作	えんかくそうさ。
塩害	えんがい。
沿岸	えんがん。
延期	えんき。
演技	えんぎ。
円形	えんけい。
塩酸	えんさん。
冤罪	えんざい。
円周	えんしゅう。
演習	えんしゅう。
園児	えんじ。
援助	えんじょ。
炎上	えんじょう。
演説	えんぜつ。
塩素	えんそ。
水素	すいそ。
演奏	えんそう。
演奏会	えんそうかい。
演奏者	えんそうしゃ。
円高	えんだか。
円柱	えんちゅう。
縁談	えんだん。
延長	えんちょう。
延長線	えんちょうせん。
園長	えんちょう。
円盤	えんばん。
鉛筆	えんぴつ。
塩分	えんぶん。
円安	えんやす。
王位	おうい。
応急措置	おうきゅうそち。
王宮	おうきゅう。
王家	おうけ。
王国	おうこく。
黄金	おうごん。
欧州	おうしゅう。
押収品	おうしゅうひん。
王子	おうじ。
応接室	おうせつしつ。
殴打	おうだ。
横断	おうだん。
横断歩道	おうだんほどう。
横着	おうちゃく。
王手	おうて。
横転	おうてん。
応答	おうとう。
往復	おうふく。
横柄	おうへい。
欧米	おうべい。
応募	おうぼ。
横暴	おうぼう。
応用	おうよう。
情報処理	じょうほうしょり。
横領罪	おうりょうざい。
大雨	おおあめ。
大男	おおおとこ。
大型	おおがた。
大声	おおごえ。
大事	おおごと。だいじ。
大勢	おおぜい。
大掃除	おおそうじ。
大道具	おおどうぐ。
大文字	おおもじ。
大物	おおもの。
大盛	おおもり。
置物	おきもの。
屋外	おくがい。
奥様	おくさま。
屋上	おくじょう。
憶測	おくそく。
屋内	おくない。
奥歯	おくば。
汚職	おしょく。
汚水	おすい。
汚染	おせん。
落葉樹	らくようじゅ。
汚泥	おでい。
一昨日	おととい。
大人	おとな。
乙姫	おとひめ。
乙女	おとめ。
汚名返上	おめいへんじょう。
面影	おもかげ。
親方	おやかた。
親心	おやごころ。
親不孝	おやふこう。
親孝行	おやこうこう。
親指	おやゆび。
小指	こゆび。
織物	おりもの。
卸売	おろしうり。
音域	おんいき。
音感	おんかん。
絶対音感	ぜったいおんかん。
音楽	おんがく。
音楽家	おんがくか。
音響	おんきょう。
恩恵	おんけい。
温室効果	おんしつこうか。
恩人	おんじん。
音声	おんせい。
温泉	おんせん。
温泉卵	おんせんたまご。
音速	おんそく。
音程	おんてい。
温度	おんど。
音頭	おんど。
音符	おんぷ。
音量	おんりょう。
改悪	かいあく。
会員	かいいん。
開運	かいうん。
開花	かいか。
開会式	かいかいしき。
改革	かいかく。
快感	かいかん。
絵画	かいが。
海外	かいがい。
海岸	かいがん。
快挙	かいきょ。
解禁	かいきん。
開業	かいぎょう。
海軍	かいぐん。
会計	かいけい。
解決	かいけつ。
会見	かいけん。
解雇	かいこ。
開催日	かいさいび。
改札	かいさつ。
解散	かいさん。
開始	かいし。
会社	かいしゃ。
解釈	かいしゃく。
回収	かいしゅう。
回収率	かいしゅうりつ。
解消	かいしょう。
解除	かいじょ。
会場	かいじょう。
海水	かいすい。
海水浴	かいすいよく。
回数	かいすう。
解説	かいせつ。
回線	かいせん。
改善策	かいぜんさく。
解体工事	かいたいこうじ。
開拓	かいたく。
快諾	かいだく。
改築工事	かいちくこうじ。
懐中電灯	かいちゅうでんとう。
会長	かいちょう。
開通	かいつう。
改定	かいてい。
海底	かいてい。
解読	かいどく。
介入	かいにゅう。
開発	かいはつ。
回避	かいひ。
会費	かいひ。
回復	かいふく。
回文	かいぶん。
開閉	かいへい。
解放	かいほう。
皆無	かいむ。
改名	かいめい。
解明	かいめい。
壊滅	かいめつ。
解約	かいやく。
海洋	かいよう。
快楽	かいらく。
怪力	かいりき。
怪物	かいぶつ。
改良点	かいりょうてん。
回路	かいろ。
会話	かいわ。
火炎放射器	かえんほうしゃき。
顔文字	かおもじ。
価格	かかく。
加害者	かがいしゃ。
被害者	ひがいしゃ。
架空請求	かくうせいきゅう。
格式	かくしき。
核心	かくしん。
革新	かくしん。
確実	かくじつ。
画数	かくすう。
拡大	かくだい。
各地	かくち。
拡張	かくちょう。
格調	かくちょう。
確定申告	かくていしんこく。
格闘技	かくとうぎ。
獲得	かくとく。
賞金	しょうきん。
角度	かくど。
確認	かくにん。
核兵器	かくへいき。
確保	かくほ。
確立	かくりつ。
確率論	かくりつろん。
格安	かくやす。
家具	かぐ。
家計簿	かけいぼ。
可決	かけつ。
否決	ひけつ。
影絵	かげえ。
過激派	かげきは。
影武者	かげむしゃ。
塩加減	しおかげん。
加工食品	かこうしょくひん。
火災	かさい。
加算	かさん。
風車	かざぐるま。
水車	すいしゃ。
火山灰	かざんばい。
過失	かしつ。
歌手	かしゅ。
頭文字	かしらもじ。
果実	かじつ。
果汁	かじゅう。
火星	かせい。
土星	どせい。
化石	かせき。
仮説	かせつ。
課税	かぜい。
風邪薬	かぜぐすり。
過疎化	かそか。
家族	かぞく。
肩書	かたがき。
型紙	かたがみ。
家宅捜索	かたくそうさく。
片栗粉	かたくりこ。
肩車	かたぐるま。
片言	かたこと。
片隅	かたすみ。
片手	かたて。
両手	りょうて。
片足	かたあし。
両足	りょうあし。
片方	かたほう。
形見	かたみ。
片道	かたみち。
課題	かだい。
花壇	かだん。
価値観	かちかん。
家畜	かちく。
格好	かっこう。
各国	かっこく。
活字	かつじ。
活性化	かっせいか。
活動	かつどう。
活動報告	かつどうほうこく。
活発	かっぱつ。
活躍	かつやく。
家庭科	かていか。
門出	かどで
門松	かどまつ。
金網	かなあみ。
加入者	かにゅうしゃ。
加熱	かねつ。
可能性	かのうせい。
彼女	かのじょ。
彼氏	かれし。
過半数	かはんすう。
株価	かぶか。
歌舞伎	かぶき。
壁紙	かべがみ。
家宝	かほう。
過保護	かほご。
髪型	かみがた。
神様	かみさま。
神業	かみわざ。
仮面	かめん。
科目	かもく。
貨物列車	かもつれっしゃ。
火薬	かやく。
火曜日	かようび。
身体	しんたい。
空手	からて。
柔道	じゅうどう。
剣道	けんどう。
火力発電	かりょくはつでん。
水力発電	すいりょくはつでん。
軽石	かるいし。
過労死	かろうし。
川上	かわかみ。
川下	かわしも。
間隔	かんかく。
感覚	かんかく。
管楽器	かんがっき。
打楽器	だがっき。
換気扇	かんきせん。
観客	かんきゃく。
関係者	かんけいしゃ。
簡潔	かんけつ。
完結編	かんけつへん。
歓迎	かんげい。
観光	かんこう。
観光客	かんこうきゃく。
閑古鳥	かんこどり。
看護師	かんごし。
監視	かんし。
鑑識	かんしき。
感謝祭	かんしゃさい。
感触	かんしょく。
関心	かんしん。
漢字	かんじ。
患者	かんじゃ。
感情	かんじょう。
肝心	かんじん。
完遂	かんすい。
漢数字	かんすうじ。
完成品	かんせいひん。
関節	かんせつ。
関税	かんぜい。
観測	かんそく。
干拓地	かんたくち。
簡単	かんたん。
貫通	かんつう。
官邸	かんてい。
監督	かんとく。
関東	かんとう。
感度	かんど。
感動	かんどう。
乾杯	かんぱい。
看病	かんびょう。
患部	かんぶ。
漢文	かんぶん。
漢方薬	かんぽうやく。
関門	かんもん。
勧誘	かんゆう。
関与	かんよ。
管理者	かんりしゃ。
完了	かんりょう。
寒冷地	かんれいち。
緩和	かんわ。
外見	がいけん。
外交	がいこう。
外国	がいこく。
外国人	がいこくじん。
外資	がいし。
外出先	がいしゅつさき。
外注	がいちゅう。
街頭	がいとう。
該当者	がいとうしゃ。
外部委託	がいぶいたく。
外壁	がいへき。
概要	がいよう。
外来語	がいらいご。
外来種	がいらいしゅ。
画家	がか。
学識	がくしき。
学術	がくじゅつ。
学生	がくせい。
学年	がくねん。
楽譜	がくふ。
医学部	いがくぶ。
学問	がくもん。
楽屋	がくや。
学力	がくりょく。
学歴	がくれき。
学割	がくわり。
画質	がしつ。
高画質	こうがしつ。
画像	がぞう。
学会	がっかい。
楽器	がっき。
打楽器	だがっき。
学級	がっきゅう。
学習	がくしゅう。
合唱団	がっしょうだん。
画伯	がはく。
画風	がふう。
画法	がほう。
我慢	がまん。
画面	がめん。
眼球	がんきゅう。
元日	がんじつ。
岩石	がんせき。
元祖	がんそ。
元旦	がんたん。
岩盤	がんばん。
岸壁	がんぺき。
願望	がんぼう。
顔面	がんめん。
気合	きあい。
合気道	あいきどう。
黄色	きいろ。
記憶装置	きおくそうち。
気温	きおん。
室温	しつおん。
気化	きか。
機械化	きかいか。
規格	きかく。
祈願	きがん。
危機	きき。
気球	ききゅう。
基金	ききん。
貴金属	ききんぞく。
企業	きぎょう。
危険	きけん。
危険物	きけんぶつ。
危険人物	きけんじんぶつ。
機嫌	きげん。
有効期限	ゆうこうきげん。
貴公子	きこうし。
帰国子女	きこくしじょ。
既婚者	きこんしゃ。
季語	きご。
記号	きごう。
記載	きさい。
機材	きざい。
岸辺	きしべ。
貴社	きしゃ。
記者	きしゃ。
新聞記者	しんぶんきしゃ。
帰社	きしゃ。
気象	きしょう。
起承転結	きしょうてんけつ。
記述	きじゅつ。
基準値	きじゅんち。
奇数	きすう。
傷跡	きずあと。
傷口	きずぐち。
規制	きせい。
寄生虫	きせいちゅう。
軌跡	きせき。
奇跡	きせき。
季節	きせつ。
季節感	きせつかん。
気絶	きぜつ。
帰属	きぞく。
貴族	きぞく。
北風	きたかぜ。
帰宅	きたく。
北国	きたぐに。
喫煙	きつえん。
喫茶店	きっさてん。
切手	きって。
郵便切手	ゆうびんきって。
危篤	きとく。
起動	きどう。
記入	きにゅう。
記念	きねん。
記念日	きねんび。
記念品	きねんひん。
機能	きのう。
昨日	きのう。
気迫	きはく。
揮発性	きはつせい。
起爆剤	きばくざい。
寄付金	きふきん。
貴婦人	きふじん。
気分転換	きぶんてんかん。
基本	きほん。
規模	きぼ。
大規模	だいきぼ。
小規模	しょうきぼ。
機密情報	きみつじょうほう。
奇妙	きみょう。
記名	きめい。
着物	きもの。
規約	きやく。
客室	きゃくしつ。
脚本家	きゃくほんか。
求愛	きゅうあい。
吸引車	きゅういんしゃ。
救援物資	きゅうえんぶっし。
休暇	きゅうか。
球界	きゅうかい。
休会	きゅうかい。
休刊	きゅうかん。
休館	きゅうかん。
休学	きゅうがく。
球技	きゅうぎ。
休憩時間	きゅうけいじかん。
休校	きゅうこう。
球根	きゅうこん。
救済策	きゅうさいさく。
旧式	きゅうしき。
急所	きゅうしょ。
青少年	せいしょうねん。
救助	きゅうじょ。
求人票	きゅうじんひょう。
求人情報	きゅうじんじょうほう。
急須	きゅうす。
給水	きゅうすい。
旧姓	きゅうせい。
休戦	きゅうせん。
休息	きゅうそく。
急速	きゅうそく。
急増	きゅうぞう。
球体	きゅうたい。
宮廷	きゅうてい。
宮殿	きゅうでん。
給湯器	きゅうとうき。
吸盤	きゅうばん。
急変	きゅうへん。
急務	きゅうむ。
救命胴衣	きゅうめいどうい。
球面	きゅうめん。
給油	きゅうゆ。
巨悪	きょあく。
今日	きょう。
凶悪犯	きょうあくはん。
脅威	きょうい。
教育	きょういく。
教育実習	きょういくじっしゅう。
教育委員会	きょういくいいんかい。
強運	きょううん。
競泳	きょうえい。
共演	きょうえん。
強化	きょうか。
協会	きょうかい。
教会	きょうかい。
恐喝	きょうかつ。
教官	きょうかん。
共感	きょうかん。
凶器	きょうき。
競技	きょうぎ。
教訓	きょうくん。
境遇	きょうぐう。
強固	きょうこ。
教材	きょうざい。
家庭教師	かていきょうし。
教師	きょうし。
教室	きょうしつ。
教授	きょうじゅ。
強制	きょうせい。
競争	きょうそう。
強打	きょうだ。
兄弟	きょうだい。
姉妹	しまい。
共通	きょうつう。
協定	きょうてい。
強敵	きょうてき。
強度	きょうど。
共同	きょうどう。
脅迫	きょうはく。
共犯	きょうはん。
競売	きょうばい。
恐怖	きょうふ。
胸部	きょうぶ。
共謀	きょうぼう。
興味	きょうみ。
共鳴	きょうめい。
教諭	きょうゆ。
共有	きょうゆう。
教養	きょうよう。
強烈	きょうれつ。
許可証	きょかしょう。
巨漢	きょかん。
巨額	きょがく。
虚偽	きょぎ。
曲芸	きょくげい。
曲線	きょくせん。
極度	きょくど。
局面	きょくめん。
曲面	きょくめん。
挙式	きょしき。
挙手	きょしゅ。
虚弱体質	きょじゃくたいしつ。
居住地	きょじゅうち。
巨人	きょじん。
拒絶反応	きょぜつはんのう。
巨体	きょたい。
拠点	きょてん。
去年	きょねん。
拒否権	きょひけん。
挙兵	きょへい。
巨木	きょぼく。
許容範囲	きょようはんい。
距離	きょり。
長距離	ちょうきょり。
短距離	たんきょり。
気楽	きらく。
気力	きりょく。
記録計	きろくけい。
均一	きんいつ。
百均	ひゃっきん。
金運	きんうん。
金貨	きんか。
金額	きんがく。
近眼	きんがん。
緊急地震速報	きんきゅうじしんそくほう。
緊急連絡先	きんきゅうれんらくさき。
金魚	きんぎょ。
禁句	きんく。
金欠	きんけつ。
金庫	きんこ。
金山	きんざん。
禁止	きんし。
均質	きんしつ。
近日公開	きんじつこうかい。
近所	きんじょ。
金銭感覚	きんせんかんかく。
金属	きんぞく。
金属音	きんぞくおん。
近代化	きんだいか。
禁断	きんだん。
緊張	きんちょう。
均等	きんとう。
筋肉	きんにく。
近年	きんねん。
金歯	きんば。
金箔	きんぱく。
金髪	きんぱつ。
散髪	さんぱつ。
勤勉	きんべん。
金脈	きんみゃく。
勤務表	きんむひょう。
勤務先	きんむさき。
禁物	きんもつ。
金融商品	きんゆうしょうひん。
金曜	きんよう。
金利	きんり。
低金利	ていきんり。
筋力	きんりょく。
勤労感謝	きんろうかんしゃ。
議員	ぎいん。
議会	ぎかい。
儀式	ぎしき。
技術力	ぎじゅつりょく。
技術者	ぎじゅつしゃ。
犠牲者	ぎせいしゃ。
偽造罪	ぎぞうざい。
議題	ぎだい。
議長	ぎちょう。
技法	ぎほう。
偽名	ぎめい。
逆算	ぎゃくさん。
虐待	ぎゃくたい。
逆転	ぎゃくてん。
逆風	ぎゃくふう。
牛肉	ぎゅうにく。
業界	ぎょうかい。
行儀	ぎょうぎ。
業者	ぎょうしゃ。
業種	ぎょうしゅ。
行事	ぎょうじ。
行政	ぎょうせい。
業績	ぎょうせき。
仰天	ぎょうてん。
業務連絡	ぎょうむれんらく。
行列	ぎょうれつ。
漁業	ぎょぎょう。
漁場	ぎょじょう。
漁船	ぎょせん。
魚肉	ぎょにく。
魚雷	ぎょらい。
魚類	ぎょるい。
銀貨	ぎんか。
銀河系	ぎんがけい。
銀杏	ぎんなん。
区域	くいき。
空間	くうかん。
空軍	くうぐん。
空襲	くうしゅう。
空席	くうせき。
空想	くうそう。
空中	くうちゅう。
空白	くうはく。
空爆	くうばく。
空腹感	くうふくかん。
苦境	くきょう。
苦言	くげん。
草木	くさき。
草花	くさばな。
草野球	くさやきゅう。
駆除	くじょ。
苦情	くじょう。
薬指	くすりゆび。
果物	くだもの。
口数	くちかず。
口笛	くちぶえ。
口下手	くちべた。
口元	くちもと。
口調	くちょう。
苦痛	くつう。
屈辱	くつじょく。
句読点	くとうてん。
首輪	くびわ。
工夫	くふう。
区別	くべつ。
供養	くよう。
暗闇	くらやみ。
苦労話	くろうばなし。
勲章	くんしょう。
君臨	くんりん。
訓練	くんれん。
具合	ぐあい。
偶数	ぐうすう。
偶然	ぐうぜん。
軍艦	ぐんかん。
軍事	ぐんじ。
軍人	ぐんじん。
軍隊	ぐんたい。
軍服	ぐんぷく。
毛穴	けあな。
経緯	けいい。
経営者	けいえいしゃ。
警戒	けいかい。
計画書	けいかくしょ。
景観条例	けいかんじょうれい。
計器	けいき。
景気	けいき。
軽減	けいげん。
傾向	けいこう。
警告	けいこく。
警告音	けいこくおん。
敬語	けいご。
掲載	けいさい。
警察	けいさつ。
警察署	けいさつしょ。
計算	けいさん。
計算機	けいさんき。
経済	けいざい。
傾斜	けいしゃ。
軽車両	けいしゃりょう。
掲示板	けいじばん。
形状	けいじょう。
継続	けいぞく。
形態	けいたい。
携帯電話	けいたいでんわ。
毛糸	けいと。
軽度	けいど。
経度	けいど。
啓発	けいはつ。
刑罰	けいばつ。
経費	けいひ。
景品	けいひん。
警備員	けいびいん。
警報	けいほう。
警棒	けいぼう。
刑務所	けいむしょ。
啓蒙	けいもう。
契約	けいやく。
契約書	けいやくしょ。
鶏卵	けいらん。
計量	けいりょう。
競輪	けいりん。
敬礼	けいれい。
経路	けいろ。
敬老	けいろう。
毛皮	けがわ。
今朝	けさ。
消印	けしいん。
景色	けしき。
雪景色	ゆきげしき。
決意	けつい。
血液	けつえき。
血液型	けつえきがた。
血液検査	けつえきけんさ。
血管	けっかん。
結構	けっこう。
結婚式	けっこんしき。
決算	けっさん。
決勝	けっしょう。
決心	けっしん。
結成	けっせい。
欠席	けっせき。
出席	しゅっせき。
決断	けつだん。
決着	けっちゃく。
決定	けってい。
欠点	けってん。
結末	けつまつ。
結論	けつろん。
仮病	けびょう。
毛虫	けむし。
権威	けんい。
検閲	けんえつ。
閲覧	えつらん。
見解	けんかい。
見学会	けんがくかい。
見学者	けんがくしゃ。
研究者	けんきゅうしゃ。
研究家	けんきゅうか。
研究所	けんきゅうじょ。
検挙	けんきょ。
献血	けんけつ。
健康	けんこう。
健康診断	けんこうしんだん。
健康保険証	けんこうほけんしょう。
建国	けんこく。
検査	けんさ。
検索	けんさく。
検算	けんざん。
検証	けんしょう。
献上	けんじょう。
件数	けんすう。
建設	けんせつ。
建設業	けんせつぎょう。
健全	けんぜん。
建築	けんちく。
検定	けんてい。
検討	けんとう。
検尿	けんにょう。
見物客	けんぶつきゃく。
検便	けんべん。
憲法	けんぽう。
研磨	けんま。
県民	けんみん。
兼務	けんむ。
件名	けんめい。
倹約家	けんやくか。
兼用	けんよう。
権利	けんり。
権力者	けんりょくしゃ。
検証	けんしょう。
迎春	げいしゅん。
芸術家	げいじゅつか。
芸名	げいめい。
激化	げきか。
激減	げきげん。
激震	げきしん。
劇場	げきじょう。
激戦	げきせん。
劇団	げきだん。
劇団員	げきだんいん。
撃沈	げきちん。
撃墜	げきつい。
激痛	げきつう。
激突	げきとつ。
激怒	げきど。
激務	げきむ。
劇薬	げきやく。
下校時間	げこうじかん。
下剤	げざい。
下水道	げすいどう。
月刊	げっかん。
月間	げっかん。
月額	げつがく。
月光	げっこう。
月収	げっしゅう。
月食	げっしょく。
月曜	げつよう。
原因	げんいん。
現役	げんえき。
限界	げんかい。
玄関	げんかん。
減額	げんがく。
弦楽器	げんがっき。
元気	げんき。
言及	げんきゅう。
現金	げんきん。
言語	げんご。
現在	げんざい。
原始時代	げんしじだい。
原子核	げんしかく。
原始人	げんしじん。
厳守	げんしゅ。
現象	げんしょう。
現実	げんじつ。
厳重	げんじゅう。
原石	げんせき。
厳選	げんせん。
減税	げんぜい。
元素	げんそ。
幻想	げんそう。
原則	げんそく。
減速	げんそく。
現代	げんだい。
現代人	げんだいじん。
幻聴	げんちょう。
原点	げんてん。
減点	げんてん。
限度	げんど。
言動	げんどう。
現場	げんば。
原爆	げんばく。
原子爆弾	げんしばくだん。
厳密	げんみつ。
原油	げんゆ。
原理	げんり。
原料	げんりょう。
言論	げんろん。
恋心	こいごころ。
恋人	こいびと。
恋文	こいぶみ。
高圧	こうあつ。
考案者	こうあんしゃ。
行為	こうい。
幸運	こううん。
公園	こうえん。
講演会	こうえんかい。
効果	こうか。
校歌	こうか。
公開	こうかい。
後悔	こうかい。
航海	こうかい。
降格	こうかく。
交換	こうかん。
公害	こうがい。
郊外	こうがい。
光学	こうがく。
工学	こうがく。
高額	こうがく。
後期	こうき。
好機	こうき。
工期	こうき。
高貴	こうき。
高気圧	こうきあつ。
好奇心	こうきしん。
綱紀粛正	こうきしゅくせい。
高級	こうきゅう。
高級車	こうきゅうしゃ。
高級品	こうきゅうひん。
皇居	こうきょ。
公共	こうきょう。
公共施設	こうきょうしせつ。
公共性	こうきょうせい。
抗菌	こうきん。
公金	こうきん。
講義	こうぎ。
抗議	こうぎ。
工業	こうぎょう。
興行	こうぎょう。
鉱業	こうぎょう。
航空	こうくう。
航空機	こうくうき。
航空券	こうくうけん。
航空便	こうくうびん。
工具	こうぐ。
厚遇	こうぐう。
光景	こうけい。
好景気	こうけいき。
後継者	こうけいしゃ。
高潔	こうけつ。
高血圧	こうけつあつ。
低血圧	ていけつあつ。
後見人	こうけんにん。
公権力	こうけんりょく。
工芸品	こうげいひん。
攻撃	こうげき。
抗原	こうげん。
高原	こうげん。
公言	こうげん。
高校	こうこう。
航行	こうこう。
考古学	こうこがく。
広告	こうこく。
交互	こうご。
皇后	こうごう。
光合成	こうごうせい。
交差	こうさ。
黄砂	こうさ。
交際	こうさい。
高裁	こうさい。
工作	こうさく。
交錯	こうさく。
耕作	こうさく。
考察	こうさつ。
交差点	こうさてん。
公算	こうさん。
降参	こうさん。
口座	こうざ。
講座	こうざ。
好材料	こうざいりょう。
鉱山	こうざん。
行使	こうし。
講師	こうし。
公式	こうしき。
公私混同	こうしこんどう。
皇室	こうしつ。
後者	こうしゃ。
校舎	こうしゃ。
口臭	こうしゅう。
講習	こうしゅう。
公衆衛生	こうしゅうえいせい。
高周波	こうしゅうは。
低周波	ていしゅうは。
絞首刑	こうしゅけい。
高所恐怖症	こうしょきょうふしょう。
交渉	こうしょう。
更新	こうしん。
行進	こうしん。
興信所	こうしんじょ。
香辛料	こうしんりょう。
工事	こうじ。
公示	こうじ。
口実	こうじつ。
高次元	こうじげん。
後述	こうじゅつ。
口述	こうじゅつ。
控除	こうじょ。
工場	こうじょう。
向上心	こうじょうしん。
向上	こうじょう。
公序良俗	こうじょりょうぞく。
好人物	こうじんぶつ。
香水	こうすい。
降水量	こうすいりょう。
構図	こうず。
洪水	こうずい。
構成	こうせい。
後世	こうせい。
校正	こうせい。
恒星	こうせい。
厚生施設	こうせいしせつ。
好成績	こうせいせき。
高性能	こうせいのう。
鉱石	こうせき。
功績	こうせき。
降雪量	こうせつりょう。
高専	こうせん。
光線	こうせん。
公然	こうぜん。
酵素	こうそ。
構想	こうそう。
高層建築	こうそうけんちく。
構想力	こうそうりょく。
高速	こうそく
高速道路	こうそくどうろ。
拘束	こうそく。
校則	こうそく。
構造	こうぞう。
後続	こうぞく。
皇族	こうぞく。
交代	こうたい。
後退	こうたい。
抗体	こうたい。
皇太子	こうたいし。
交替	こうたい。
光沢	こうたく。
降誕	こうたん。
構築	こうちく。
紅茶	こうちゃ。
校長	こうちょう。
好調	こうちょう。
硬直	こうちょく。
交通	こうつう。
交通量	こうつうりょう。
好都合	こうつごう。
工程	こうてい。
肯定	こうてい。
高低	こうてい。
公邸	こうてい。
皇帝	こうてい。
好敵手	こうてきしゅ。
鋼鉄	こうてつ。
交点	こうてん。
好転	こうてん。
公転	こうてん。
香典	こうでん。
高等学校	こうとうがっこう。
口頭	こうとう。
後頭部	こうとうぶ。
高度	こうど。
講堂	こうどう。
行動	こうどう。
行動力	こうどうりょく。
公道	こうどう。
高度化	こうどか。
高度差	こうどさ。
高度成長期	こうどせいちょうき。
校内	こうない。
公認	こうにん。
後任	こうにん。
高熱	こうねつ。
光年	こうねん。
効能	こうのう。
後輩	こうはい。
交配	こうはい。
荒廃	こうはい。
高配当	こうはいとう。
紅白	こうはく。
後発	こうはつ。
後半	こうはん。
広範囲	こうはんい。
工場	こうば。
勾配	こうばい。
交番	こうばん。
降板	こうばん。
公表	こうひょう。
好評	こうひょう。
交尾	こうび。
交付	こうふ。
幸福	こうふく。
降伏	こうふく。
興奮	こうふん。
興奮剤	こうふんざい。
興奮状態	こうふんじょうたい。
鉱物	こうぶつ。
好物	こうぶつ。
高分子	こうぶんし。
公文書	こうぶんしょ。
公平	こうへい。
候補	こうほ。
工法	こうほう。
後方	こうほう。
公募	こうぼ。
酵母	こうぼ。
工房	こうぼう。
攻防	こうぼう。
興亡	こうぼう。
公僕	こうぼく。
高慢	こうまん。
鉱脈	こうみゃく。
功名心	こうみょうしん。
香味料	こうみりょう。
公民館	こうみんかん。
公民権運動	こうみんけんうんどう。
公務	こうむ。
公務員	こうむいん。
公明正大	こうめいせいだい。
項目	こうもく。
校門	こうもん。
荒野	こうや。
公約	こうやく。
公約数	こうやくすう。
交友関係	こうゆうかんけい。
効用	こうよう。
広葉樹	こうようじゅ。
行楽地	こうらくち。
公理	こうり。
功利主義	こうりしゅぎ。
効率	こうりつ。
公立	こうりつ。
攻略	こうりゃく。
交流	こうりゅう。
香料	こうりょう。
効力	こうりょく。
後輪	こうりん。
降臨	こうりん。
恒例	こうれい。
航路	こうろ。
口論	こうろん。
興和	こうわ。
講和	こうわ。
港湾	こうわん。
小型	こがた。
黄金色	こがねいろ。
小柄	こがら。
顧客	こきゃく。
呼吸	こきゅう。
故郷	こきょう。
古今和歌集	こきんわかしゅう。
小切手	こぎって。
国益	こくえき。
黒煙	こくえん。
黒鉛	こくえん。
国王	こくおう。
国外	こくがい。
国外追放	こくがいつうほう。
国語	こくご。
国語辞典	こくごじてん。
国際	こくさい。
国債	こくさい。
国際化	こくさいか。
国際会議	こくさいかいぎ。
国際電話	こくさいでんわ。
国際犯罪	こくさいはんざい。
国際法	こくさいほう。
国際問題	こくさいもんだい。
国際連合	こくさいれんごう。
国策	こくさく。
国産	こくさん。
黒色火薬	こくしょくかやく。
国税庁	こくぜいちょう。
国勢調査	こくぜいちょうさ。
国籍	こくせき。
告訴	こくそ。
告訴状	こくそじょう。
告知義務	こくちぎむ。
国道	こくどう。
国内	こくない。
国内線	こくないせん。
告発	こくはつ。
告発者	こくはつしゃ。
黒板	こくばん。
酷評	こくひょう。
克服	こくふく。
告別式	こくべつしき。
国宝	こくほう。
国民	こくみん。
国民栄誉賞	こくみんえいよしょう。
国民皆年金	こくみんかいねんきん。
国民皆保険	こくみんかいほけん。
国民審査	こくみんしんさ。
国有林	こくゆうりん。
国有地	こくゆうち。
国立	こくりつ。
国立大学	こくりつだいがく。
国力	こくりょく。
国連	こくれん。
国連軍	こくれんぐん。
国連平和維持活動	こくれんへいわいじかつどう。
小熊	こぐま。
固形	こけい。
固形燃料	こけいねんりょう。
固形物	こけいぶつ。
孤高	ここう。
心得	こころえ。
古今東西	ここんとうざい。
古語	こご。
小声	こごえ。
小雨	こさめ。
小細工	こざいく。
小魚	こざかな。
個室	こしつ。
孤児	こじ。
誇示	こじ。
固辞	こじ。
個人	こじん。
個人情報	こじんじょうほう。
個人情報保護法	こじんじょうほうほごほう。
古事記	こじき。
個数	こすう。
個性	こせい。
戸籍	こせき。
小銭	こぜに。
固体	こたい。
個体	こたい。
古代	こだい。
誇大広告	こだいこうこく。
子沢山	こだくさん。
東風	こち。
誇張	こちょう。
骨伝導	こつでんどう。
骨年齢	こつねんれい。
骨盤	こつばん。
小粒	こつぶ。
小包	こづつみ。
固定	こてい。
固定観念	こていかんねん。
固定金利	こていきんり。
固定資産税	こていしさんぜい。
固定電話	こていでんわ。
小手先	こてさき。
古典	こてん。
孤島	ことう。
事柄	ことがら。
今年	ことし。
去年	きょねん。
昨年	さくねん。
来年	らいねん。
今年度	こんねんど。
昨年度	さくねんど。
来年度	らいねんど。
言葉	ことば。
小鳥	ことり。
小道具	こどうぐ。
孤独死	こどくし。
子供	こども。
子供部屋	こどもべや。
粉薬	こなぐすり。
粉砂糖	こなざとう。
小春日和	こはるびより。
小判	こばん。
古風	こふう。
古墳	こふん。
古墳時代	こふんじだい。
昆布茶	こぶちゃ。
個別	こべつ。
小部屋	こべや。
小坊主	こぼうず。
独楽	こま。
古米	こまい。
新米	しんまい。
古民家	こみんか。
小麦	こむぎ。
小麦色	こむぎいろ。
小麦粉	こむぎこ。
米粉	こめこ。
米印	こめじるし。
米粒	こめつぶ。
小文字	こもじ。
大文字	おおもじ。
小物	こもの。
子守	こもり。
顧問	こもん。
古文書	こもんじょ。
顧問弁護士	こもんべんごし。
小屋	こや。
山小屋	やまごや。
子役	こやく。
固有	こゆう。
固有種	こゆうしゅ。
固有名詞	こゆうめいし。
雇用	こよう。
雇用者	こようしゃ。
雇用保険	こようほけん。
古来	こらい。
孤立	こりつ。
孤立無援	こりつむえん。
婚姻	こんいん。
婚姻届	こんいんとどけ。
今回	こんかい。
婚活	こんかつ。
根幹	こんかん。
根気	こんき。
婚期	こんき。
今季	こんき。
今期	こんき。
混血	こんけつ。
今月	こんげつ。
今後	こんご。
混合	こんごう。
混合物	こんごうぶつ。
混雑	こんざつ。
今週	こんしゅう。
根性	こんじょう。
根絶	こんぜつ。
献立	こんだて。
献立表	こんだてひょう。
昆虫	こんちゅう。
根底	こんてい。
今度	こんど。
混同	こんどう。
困難	こんなん。
混入	こんにゅう。
今年度	こんねんど。
今晩	こんばん。
今夜	こんや。
昆布	こんぶ。
根本	こんぽん。
梱包	こんぽう。
混迷	こんめい。
婚約者	こんやくしゃ。
婚約	こんやく。
混浴	こんよく。
混乱	こんらん。
困惑	こんわく。
御案内	ごあんない。
誤飲	ごいん。
合意	ごうい。
豪雨	ごうう。
豪華	ごうか。
豪快	ごうかい。
号外	ごうがい。
合格	ごうかく。
合格者	ごうかくしゃ。
号泣	ごうきゅう。
合金	ごうきん。
合計	ごうけい。
合計金額	ごうけいきんがく。
合憲	ごうけん。
強情	ごうじょう。
合成	ごうせい。
豪雪	ごうせつ。
強盗	ごうとう。
降伏	こうふく。
合法	ごうほう。
合理化	ごうりか。
合理性	ごうりせい。
合流	ごうりゅう。
号令	ごうれい。
御恩	ごおん。
誤解	ごかい。
互角	ごかく。
語学	ごがく。
五角形	ごかくけい。
五月病	ごがつびょう。
互換性	ごかんせい。
期限	きげん。
機嫌	きげん。
極悪	ごくあく。
極悪人	ごくあくにん。
極悪非道	ごくあくひどう。
極寒	ごくかん。
極道	ごくどう。
極秘	ごくひ。
極楽	ごくらく。
苦労	くろう。
語源	ごげん。
午後	ごご。
午前	ごぜん。
誤作動	ごさどう。
後日	ごじつ。
御自分	ごじぶん。
御苦労	ごくろう。
御所	ごしょ。
誤診	ごしん。
護身用	ごしんよう。
誤字	ごじ。
誤字脱字	ごじだつじ。
五寸釘	ごすんくぎ。
五線譜	ごせんふ。
誤送信	ごそうしん。
五体満足	ごたいまんぞく。
古代	こだい。
御殿	ごてん。
誤答	ごとう。
誤動作	ごどうさ。
誤認	ごにん。
御法度	ごはっと。
御飯	ごはん。
御飯粒	ごはんつぶ。
誤爆	ごばく。
語尾	ごび。
五分五分	ごぶごぶ。
御無沙汰	ごぶさた。
御無事	ごぶじ。
語弊	ごへい。
誤報	ごほう。
御無用	ごむよう。
御免	ごめん。
誤訳	ごやく。
御用	ごよう。
誤用	ごよう。
御来光	ごらいこう。
御覧	ごらん。
娯楽	ごらく。
御利益	ごりやく。
五輪	ごりん。
言語道断	ごんごどうだん。
最悪	さいあく。
最愛	さいあい。
菜園	さいえん。
最下位	さいかい。
再開	さいかい。
再会	さいかい。
災害	さいがい。
再開発	さいかいはつ。
再起動	さいきどう。
最強	さいきょう。
再教育	さいきょういく。
最近	さいきん。
細菌	さいきん。
細工	さいく。
採掘	さいくつ。
採掘権	さいくつけん。
採決	さいけつ。
採血	さいけつ。
再結晶	さいけっしょう。
再建	さいけん。
債権	さいけん。
再現	さいげん。
再検討	さいけんとう。
最古	さいこ。
最後	さいご。
最期	さいご。
最高	さいこう。
最高学府	さいこうがくふ。
最高裁	さいこうさい。
最高峰	さいこうほう。
最後通告	さいごつうこく。
再雇用	さいこよう。
再婚	さいこん。
採算	さいさん。
妻子	さいし。
祭日	さいじつ。
祝日	しゅくじつ。
採取	さいしゅ。
最終	さいしゅう。
採集	さいしゅう。
最終日	さいしゅうび。
再出発	さいしゅっぱつ。
最初	さいしょ。
最小	さいしょう。
最小限	さいしょうげん。
最大	さいだい。
最大限	さいだいげん。
最小値	さいしょうち。
最大値	さいだいち。
才色兼備	さいしょくけんび。
菜食主義	さいしょくしゅぎ。
再処理	さいしょり。
最新	さいしん。
細心	さいしん。
再診	さいしん。
最新式	さいしんしき。
最新型	さいしんがた。
再生	さいせい。
再生医療	さいせいいりょう。
最盛期	さいせいき。
再生産	さいせいさん。
再生紙	さいせいし。
再選	さいせん。
最善	さいぜん。
最前線	さいぜんせん。
最先端	さいせんたん。
最前列	さいぜんれつ。
再送	さいそう。
催促	さいそく。
最速	さいそく。
最多	さいた。
最大級	さいだいきゅう。
最高値	さいこうち。
最短	さいたん。
裁断	さいだん。
祭壇	さいだん。
最短距離	さいたんきょり。
最中	さいちゅう。
最長	さいちょう。
最低限	さいていげん。
最低	さいてい。
最低賃金	さいていちんぎん。
最適	さいてき。
最適化	さいてきか。
採点	さいてん。
再度	さいど。
災難	さいなん。
最南端	さいなんたん。
採尿	さいにょう。
再任	さいにん。
再認識	さいにんしき。
再燃	さいねん。
最年少	さいねんしょう。
最年長	さいねんちょう。
才能	さいのう。
栽培	さいばい。
促成栽培	そくせいさいばい。
再配当	さいはいとう。
再発	さいはつ。
再発見	さいはっけん。
裁判	さいばん。
裁判官	さいばんかん。
裁判所	さいばんしょ。
裁判員	さいばんいん。
再評価	さいひょうか。
財布	さいふ。
細部	さいぶ。
再編	さいへん。
再編成	さいへんせい。
細胞	さいぼう。
細胞壁	さいぼうへき。
再放送	さいほうそう。
細胞膜	さいぼうまく。
最北端	さいほくたん。
歳末	さいまつ。
催眠	さいみん。
催眠術	さいみんじゅつ。
最安値	さいやすね。
西遊記	さいゆうき。
最優先	さいゆうせん。
採用	さいよう。
最良	さいりょう。
再利用	さいりよう。
裁量	さいりょう。
催涙	さいるい。
催涙弾	さいるいだん。
境目	さかいめ。
逆様	さかさま。
酒屋	さかや。
逆手	さかて。
酒場	さかば。
差額	さがく。
先物	さきもの。
砂丘	さきゅう。
先物取引	さきものとりひき。
詐欺	さぎ。
詐欺師	さぎし。
詐欺罪	さぎざい。
作業	さぎょう。
作業員	さぎょういん。
索引	さくいん。
削減	さくげん。
昨日	さくじつ。
作者	さくしゃ。
削除	さくじょ。
作戦	さくせん。
昨晩	さくばん。
作品	さくひん。
作文	さくぶん。
作物	さくもつ。
昨夜	さくや。
策略	さくりゃく。
鎖国	さこく。
査察	ささつ。
指図	さしず。
差出人	さしだしにん。
刺身	さしみ。
左心室	さしんしつ。
左心房	さしんぼう。
左折	させつ。
右折	うせつ。
早速	さっそく。
殺意	さつい。
撮影	さつえい。
撮影会	さつえいかい。
殺害	さつがい。
五月	さつき。
殺処分	さつしょぶん。
殺人	さつじん。
殺人鬼	さつじんき。
殺人罪	さつじんざい。
殺人犯	さつじんはん。
札束	さつたば。
査定	さてい。
砂鉄	さてつ。
砂糖	さとう。
砂糖水	さとうみず。
里親	さとおや。
作動	さどう。
誤作動	ごさどう。
茶道	さどう。
最中	さなか。
左脳	さのう
右脳	うのう。
砂漠	さばく。
砂漠化	さばくか。
差別	さべつ。
差別化	さべつか。
作法	さほう。
三味線	しゃみせん。
五月雨	さみだれ。
寒気	さむけ。
白湯	さゆ。
左右	さゆう。
作用	さよう。
作用点	さようてん。
支点	してん。
力点	りきてん。
再来月	さらいげつ。
再来週	さらいしゅう。
再来年	さらいねん。
更地	さらち。
猿芝居	さるしばい。
猿知恵	さるぢえ。
猿山	さるやま。
参観日	さんかんび。
酸化	さんか。
参加	さんか。
参加者	さんかしゃ。
加入者	かにゅうしゃ。
三角関係	さんかくかんけい。
三角形	さんかくけい。
四角形	しかくけい。
三角州	さんかくす。
参議院	さんぎいん。
衆議院	しゅうぎいん。
三脚	さんきゃく。
産業	さんぎょう。
産業革命	さんぎょうかくめい。
産業廃棄物	さんぎょうはいきぶつ。
参勤交代	さんきんこうたい。
三権分立	さんけんぶんりつ。
参考書	さんこうしょ。
参考	さんこう。
参考資料	さんこうしりょう。
参考人	さんこうにん。
三国志	さんごくし。
山菜	さんさい。
三次元	さんじげん。
二次元	にじげん。
算数	さんすう。
山水画	さんすいが。
酸性	さんせい。
賛成	さんせい。
酸素	さんそ。
二酸化炭素	にさんかたんそ。
産地	さんち。
産地直送	さんちちょくそう。
産地直売	さんちちょくばい。
山頂	さんちょう。
助産師	じょさんし。
産廃	さんぱい。
三杯酢	さんばいず。
散髪	さんぱつ。
散髪屋	さんぱつや。
賛否	さんぴ。
讃美歌	さんびか。
三拍子	さんびょうし。
散布	さんぷ。
副産物	ふくさんぶつ。
散歩	さんぽ。
散歩道	さんぽみち。
秋刀魚	さんま。
酸味	さんみ。
山脈	さんみゃく。
産油国	さんゆこく。
産卵期	さんらんき。
産卵	さんらん。
散乱	さんらん。
三流	さんりゅう。
三輪車	さんりんしゃ。
参列	さんれつ。
参列者	さんれつしゃ。
罪悪感	ざいあくかん。
財界	ざいかい。
財界人	ざいかいじん。
在学	ざいがく。
財源	ざいげん。
在校生	ざいこうせい。
在庫	ざいこ。
在庫管理	ざいこかんり。
財産	ざいさん。
資産家	しさんか。
材質	ざいしつ。
在職	ざいしょく。
財政	ざいせい。
在籍	ざいせき。
在籍者	ざいせいしゃ。
在宅医療	ざいたくいりょう。
在宅看護	ざいたくかんご。
在宅勤務	ざいたくきんむ。
財団	ざいだん。
在中	ざいちゅう。
在日	ざいにち。
在日外国人	ざいにちがいこくじん。
財閥	ざいばつ。
財宝	ざいほう。
財務	ざいむ。
財務省	ざいむしょう。
材木	ざいもく。
在来種	ざいらいしゅ。
外来種	がいらいしゅ。
材料	ざいりょう。
原材料	げんざいりょう。
原材料名	げんざいりょうめい。
雑魚寝	ざこね。
座禅	ざぜん。
座談会	ざだんかい。
雑音	ざつおん。
雑貨	ざっか。
雑貨店	ざっかてん。
雑学	ざつがく。
雑菌	ざっきん。
雑食	ざっしょく。
座標	ざひょう。
座標系	ざひょうけい。
座標軸	ざひょうじく。
座布団	ざぶとん。
残額	ざんがく。
残業	ざんぎょう。
残業手当	ざんぎょうてあて。
残酷	ざんこく。
残暑	ざんしょ。
残暑見舞	ざんしょみまい。
斬新	ざんしん。
残像	ざんぞう。
残念	ざんねん。
残念賞	ざんねんしょう。
惨敗	ざんぱい。
残飯	ざんぱん。
試合	しあい。
飼育	しいく。
飼育員	しいくいん。
死因	しいん。
試運転	しうんてん。
塩味	しおあじ。
塩加減	しおかげん。
塩水	しおみず。
歯科医	しかい。
司会者	しかいしゃ。
視界	しかい。
司会	しかい。
市街地	しがいち。
紫外線	しがいせん。
資格	しかく。
視覚	しかく。
四角	しかく。
四角形	しかくけい。
資格試験	しかくしけん。
仕方	しかた。
死活問題	しかつもんだい。
志願	しがん。
志願者	しがんしゃ。
四季	しき。
指揮者	しきしゃ。
市議	しぎ。
市議会	しぎかい。
色彩	しきさい。
式辞	しきじ。
識字率	しきじりつ。
式場	しきじょう。
色素	しきそ。
指揮棒	しきぼう。
支給	しきゅう。
至急	しきゅう。
子宮	しきゅう。
死去	しきょ。
市況	しきょう。
始業式	しぎょうしき。
試供品	しきょうひん。
至近距離	しきんきょり。
試金石	しきんせき。
資金力	しきんりょく。
四苦八苦	しくはっく。
時化	しけ。
死刑	しけい。
死刑囚	しけいしゅう。
刺激	しげき。
湿気	しっけ。
止血剤	しけつざい。
試験	しけん。
試験官	しけんかん。
試験管	しけんかん。
資源	しげん。
試験紙	しけんし。
試験場	しけんじょう。
死後	しご。
思考	しこう。
施行	せこう。
試行錯誤	しこうさくご。
始皇帝	しこうてい。
思考力	しこうりょく。
子午線	しごせん。
仕事	しごと。
仕事着	しごとぎ。
仕事場	しごとば。
資材	しざい。
試作品	しさくひん。
視察	しさつ。
資産	しさん。
資産家	しさんか。
死産	しざん。
試算表	しさんひょう。
指示	しじ。
支持	しじ。
支持者	しじしゃ。
史実	しじつ。
脂質	ししつ。
死者	ししゃ。
試写会	ししゃかい。
詩集	ししゅう。
歯周病	ししゅうびょう。
歯周炎	ししゅうえん。
支出	ししゅつ。
思春期	ししゅんき。
死傷者	ししょうしゃ。
市場	しじょう。
史上初	しじょうはつ。
世界初	せかいはつ。
日本初	にほんはつ。
私書箱	ししょばこ。
試食	ししょく。
支持率	しじりつ。
指針	ししん。
詩人	しじん。
視神経	ししんけい。
指数関数	しすうかんすう。
姿勢	しせい。
施設	しせつ。
視線	しせん。
自然	しぜん。
自然環境	しぜんかんきょう。
自然界	しぜんかい。
自然科学	しぜんかがく。
自然体	しぜんたい。
自然発火	しぜんはっか。
始祖鳥	しそちょう。
思想	しそう。
思想家	しそうか。
子孫	しそん。
死体	したい。
次第	しだい。
支度	したく。
下心	したごころ。
下準備	したじゅんび。
下町	したまち。
上目	うわめ。
質屋	しちや。
七面鳥	しちめんちょう。
試着	しちゃく。
支柱	しちゅう。
市中感染	しちゅうかんせん。
市長	しちょう。
視聴者	しちょうしゃ。
視聴覚	しちょうかく。
市町村	しちょうそん。
視聴率	しちょうりつ。
室温	しつおん。
質感	しつかん。
質疑応答	しつぎおうとう。
失脚	しっきゃく。
失業	しつぎょう。
失業者	しつぎょうしゃ。
失業率	しつぎょうりつ。
湿気	しっけ。
失敬	しっけい。
失言	しつげん。
失語症	しつごしょう。
執事	しつじ。
失笑	しっしょう。
失神	しっしん。
失速	しっそく。
失態	しったい。
湿地	しっち。
統合失調症	とうごうしっちょうしょう。
失点	しってん。
湿度	しつど。
湿度計	しつどけい。
室内	しつない。
失敗	しっぱい。
成功者	せいこうしゃ。
執筆	しっぴつ。
湿布	しっぷ。
失望	しつぼう。
尻尾	しっぽ。
失明	しつめい。
質問	しつもん。
質問者	しつもんしゃ。
解答	かいとう。
解凍	かいとう。
回答	かいとう。
質量	しつりょう。
重量	じゅうりょう。
失礼	しつれい。
失恋	しつれん。
指定	してい。
指定席	していせき。
自由席	じゆうせき。
指定文化財	していぶんかざい。
支点	してん。
始点	してん。
支店	してん。
終点	しゅうてん。
使途	しと。
使途不明金	しとふめいきん。
死闘	しとう。
指導	しどう。
指導者	しどうしゃ。
始動	しどう。
品薄	しなうす。
品数	しなかず。
品不足	しなぶそく。
品物	しなもの。
指南役	しなんやく。
歯肉炎	しにくえん。
死人	しにん。
支配	しはい。
支配者	しはいしゃ。
芝居	しばい。
支配人	しはいにん。
始発電車	しはつでんしゃ。
市販	しはん。
支部	しぶ。
四分音符	しぶおんぷ。
私服	しふく。
至福	しふく。
私物化	しぶつか。
私文書	しぶんしょ。
公文書	こうぶんしょ。
紙幣	しへい。
貨幣	かへい。
司法	しほう。
脂肪	しぼう。
死亡	しぼう。
志望	しぼう。
志望動機	しぼうどうき。
死亡者	しぼうしゃ。
脂肪肝	しぼうかん。
司法試験	しほうしけん。
死亡届	しぼうとどけ。
司法取引	しほうとりひき。
死亡保険	しぼうほけん。
死亡率	しぼうりつ。
資本	しほん。
資本主義	しほんしゅぎ。
資本金	しほんきん。
姉妹都市	しまいとし。
島国	しまぐに。
始末	しまつ。
清水	しみず。
市民	しみん。
国民	こくみん。
市民運動	しみんうんどう。
市民権	しみんけん。
市民税	しみんぜい。
氏名	しめい。
指名	しめい。
使命	しめい。
使命感	しめいかん。
指名手配	しめいてはい。
下半期	しもはんき。
社員	しゃいん。
社会	しゃかい。
社会人	しゃかいじん。
社会科	しゃかいか。
市役所	しやくしょ。
射撃	しゃげき。
射撃場	しゃげきじょう。
射撃訓練	しゃげきくんれん。
車検	しゃけん。
車検証	しゃけんしょう。
車載	しゃさい。
謝罪	しゃざい。
謝罪文	しゃざいぶん。
謝罪会見	しゃざいかいけん。
射殺	しゃさつ。
写実	しゃじつ。
写実主義	しゃじつしゅぎ。
車種	しゃしゅ。
感謝状	かんしゃじょう。
写真	しゃしん。
写真集	しゃしんしゅう。
車線	しゃせん。
対向車線	たいこうしゃせん。
車体	しゃたい。
社宅	しゃたく。
社長	しゃちょう。
借金	しゃっきん。
射程距離	しゃていきょり。
車道	しゃどう。
車内	しゃない。
三味線	しゃみせん。
社名	しゃめい。
車輪	しゃりん。
洒落	しゃれ。
謝礼	しゃれい。
謝礼金	しゃれいきん。
車列	しゃれつ。
首位	しゅい。
周囲	しゅうい。
収益	しゅうえき。
集会	しゅうかい。
収穫	しゅうかく。
収穫量	しゅうかくりょう。
収穫祭	しゅうかくさい。
就学義務	しゅうがくぎむ。
就学率	しゅうがくりつ。
修学旅行	しゅうがくりょこう。
就活	しゅうかつ。
就活生	しゅうかつせい。
習慣	しゅうかん。
週刊	しゅうかん。
月間	げっかん。
月刊	げっかん。
週刊誌	しゅうかんし。
周期	しゅうき。
衆議院	しゅうぎいん。
集客	しゅうきゃく。
週休	しゅうきゅう。
宗教	しゅうきょう。
宗教家	しゅうきょうか。
終業式	しゅうぎょうしき。
就業規則	しゅうぎょうきそく。
集金	しゅうきん。
集計	しゅうけい。
終結	しゅうけつ。
集結	しゅうけつ。
集合	しゅうごう。
集合場所	しゅうごうばしょ。
集合時間	しゅうごうじかん。
集合写真	しゅうごうしゃしん。
集合住宅	しゅうごうじゅうたく。
秀才	しゅうさい。
習字	しゅうじ。
終止符	しゅうしふ。
収集	しゅうしゅう。
就職	しゅうしょく。
就職活動	しゅうしょくかつどう。
就職難	しゅうしょくなん。
囚人	しゅうじん。
囚人服	しゅうじんふく。
終身刑	しゅうしんけい。
修正	しゅうせい。
習性	しゅうせい。
修正案	しゅうせいあん。
修正液	しゅうせいえき。
集積回路	しゅうせきかいろ。
終戦	しゅうせん。
戦後	せんご。
終戦記念日	しゅうせんきねんび。
収束	しゅうそく。
集団	しゅうだん。
集団的自衛権	しゅうだんてきじえいけん。
周知	しゅうち。
終着駅	しゅうちゃくえき。
集中	しゅうちゅう。
集中豪雨	しゅうちゅうごうう。
収入	しゅうにゅう。
収入印紙	しゅうにゅういんし。
収納	しゅうのう。
周波数	しゅうはすう。
修復	しゅうふく。
修復工事	しゅうふくこうじ。
周辺	しゅうへん。
周辺事態	しゅうへんじたい。
週末	しゅうまつ。
完結	かんけつ。
簡潔	かんけつ。
収容所	しゅうようじょ。
襲来	しゅうらい。
修理	しゅうり。
終了	しゅうりょう。
修了	しゅうりょう。
就労	しゅうろう。
就労支援	しゅうろうしえん。
収録	しゅうろく。
収賄罪	しゅうわいざい。
主演	しゅえん。
主観	しゅかん。
修行	しゅぎょう。
修行者	しゅぎょうしゃ。
祝賀会	しゅくがかい。
祝日	しゅくじつ。
縮小	しゅくしょう。
粛清	しゅくせい。
宿題	しゅくだい。
宿敵	しゅくてき。
祝福	しゅくふく。
宿命	しゅくめい。
手芸	しゅげい。
手芸教室	しゅげいきょうしつ。
主権	しゅけん。
主権在民	しゅけんざいみん。
主権者	しゅけんしゃ。
主語	しゅご。
守護神	しゅごしん。
取材	しゅざい。
趣旨	しゅし。
主治医	しゅじい。
輸出	ゆしゅつ。
手術	しゅじゅつ。
手術室	しゅじゅつしつ。
首相	しゅしょう。
主食	しゅしょく。
主人	しゅじん。
主人公	しゅじんこう。
取水口	しゅすいこう。
主成分	しゅせいぶん。
種族	しゅぞく。
主題	しゅだい。
主題歌	しゅだいか。
主題曲	しゅだいきょく。
主体性	しゅたいせい。
手段	しゅだん。
最終手段	さいしゅうしゅだん。
酒池肉林	しゅちにくりん。
主張	しゅちょう。
出演者	しゅつえんしゃ。
出荷	しゅっか。
出荷日	しゅっかび。
出火	しゅっか。
出願	しゅつがん。
出勤	しゅっきん。
出勤日数	しゅっきんにっすう。
出勤簿	しゅっきんぼ。
出血	しゅっけつ。
出血多量	しゅっけつたりょう。
出欠	しゅっけつ。
出撃	しゅつげき。
出現	しゅつげん。
出航	しゅっこう。
出港	しゅっこう。
出国	しゅっこく。
出産	しゅっさん。
出産予定日	しゅっさんよていび。
出資法	しゅっしほう。
出社	しゅっしゃ。
出場	しゅつじょう。
出生率	しゅっしょうりつ。
出生届	しゅっしょうとどけ。
出陣	しゅつじん。
出身	しゅっしん。
出世	しゅっせ。
立身出世	りっしんしゅっせ。
出世魚	しゅっせうお。
出張	しゅっちょう。
出張費	しゅっちょうひ。
出廷	しゅってい。
出店	しゅってん。
出土品	しゅつどひん。
出入国	しゅつにゅうこく。
出馬	しゅつば。
出発点	しゅっぱつてん。
出版	しゅっぱん。
出版物	しゅっぱんぶつ。
出費	しゅっぴ。
出品	しゅっぴん。
出没	しゅつぼつ。
出力	しゅつりょく。
首都	しゅと。
手動	しゅどう。
自動	じどう。
主導権	しゅどうけん。
取得	しゅとく。
首都圏	しゅとけん。
朱肉	しゅにく。
主任	しゅにん。
首脳会議	しゅのうかいぎ。
主犯	しゅはん。
守秘義務	しゅひぎむ。
守備	しゅび。
主婦	しゅふ。
主夫	しゅふ。
修復	しゅうふく。
種別	しゅべつ。
手法	しゅほう。
趣味	しゅみ。
種目	しゅもく。
主役	しゅやく。
主要	しゅよう。
修理	しゅうり。
主流	しゅりゅう。
主力	しゅりょく。
種類	しゅるい。
手話	しゅわ。
瞬間	しゅんかん。
春闘	しゅんとう。
瞬発力	しゅんぱつりょく。
春分	しゅんぶん。
使用	しよう。
消火	しょうか。
消火器	しょうかき。
消化	しょうか。
照会	しょうかい。
紹介	しょうかい。
障害	しょうがい。
生涯	しょうがい。
傷害罪	しょうがいざい。
傷害事件	しょうがいじけん。
紹介状	しょうかいじょう。
消化液	しょうかえき。
昇格	しょうかく。
小学生	しょうがくせい。
小学校	しょうがっこう。
少額	しょうがく。
奨学金	しょうがくきん。
消火栓	しょうかせん。
正月	しょうがつ。
試用期間	しようきかん。
小規模	しょうきぼ。
大規模	だいきぼ。
中規模	ちゅうきぼ。
焼却	しょうきゃく。
昇給	しょうきゅう。
消去法	しょうきょほう。
商業	しょうぎょう。
商業主義	しょうぎょうしゅぎ。
賞金王	しょうきんおう。
将軍	しょうぐん。
小計	しょうけい。
象形文字	しょうけいもじ。
衝撃	しょうげき。
証券	しょうけん。
証券会社	しょうけんがいしゃ。
証券取引所	しょうけんとりひきじょ。
証拠	しょうこ。
証拠品	しょうこひん。
消耗品	しょうもうひん。
商工会議所	しょうこうかいぎしょ。
称号	しょうごう。
小国	しょうこく。
大国	たいこく。
詳細	しょうさい。
商材	しょうざい。
小冊子	しょうさっし。
賞賛	しょうさん。
少子化対策	しょうしかたいさく。
少子高齢化	しょうしこうれいか。
正直	しょうじき。
正直者	しょうじきもの。
省資源	しょうしげん。
消失	しょうしつ。
焼死体	しょうしたい。
商習慣	しょうしゅうかん。
消臭剤	しょうしゅうざい。
照準	しょうじゅん。
昇順	しょうじゅん。
降順	こうじゅん。
証書	しょうしょ。
少女	しょうじょ。
仕様書	しようしょ。
症状	しょうじょう。
賞状	しょうじょう。
昇進	しょうしん。
焼身自殺	しょうしんじさつ。
自殺	じさつ。
自殺者	じさつしゃ。
精進	しょうじん。
精進料理	しょうじんりょうり。
少数	しょうすう。
小数点	しょうすうてん。
少数派	しょうすうは。
小説	しょうせつ。
小説家	しょうせつか。
消石灰	しょうせっかい。
商戦	しょうせん。
勝訴	しょうそ。
敗訴	はいそ。
肖像画	しょうぞうが。
正倉院	しょうそういん。
肖像権	しょうぞうけん。
消息	しょうそく。
招待	しょうたい。
正体	しょうたい。
承諾	しょうだく。
商談	しょうだん。
省庁	しょうちょう。
象徴	しょうちょう。
小腸	しょうちょう。
焦点	しょうてん。
商店街	しょうてんがい。
消灯	しょうとう。
消灯時間	しょうとうじかん。
所得税	しょとくぜい。
消毒	しょうどく。
消毒液	しょうどくえき。
衝突	しょうとつ。
商取引	しょうとりひき。
小児科	しょうにか。
承認	しょうにん。
証人	しょうにん。
少人数	しょうにんずう。
少年	しょうねん。
少年時代	しょうねんじだい。
生年月日	せいねんがっぴ。
正念場	しょうねんば。
勝敗	しょうはい。
商売	しょうばい。
商売敵	しょうばいがたき。
商売道具	しょうばいどうぐ。
商売繁盛	しょうばいはんじょう。
消費	しょうひ。
消費者	しょうひしゃ。
消費税	しょうひぜい。
所得税	しょとくぜい。
固定資産税	こていしさんぜい。
消費期限	しょうひきげん。
賞味期限	しょうみきげん。
消費者金融	しょうひしゃきんゆう。
商標	しょうひょう。
商標権	しょうひょうけん。
商品	しょうひん。
商品券	しょうひんけん。
賞品	しょうひん。
商品化	しょうひんか。
勝負	しょうぶ。
勝負服	しょうぶふく。
商法	しょうほう。
消防車	しょうぼうしゃ。
消防士	しょうぼうし。
証明	しょうめい。
照明	しょうめい。
証明書	しょうめいしょ。
照明器具	しょうめいきぐ。
消滅	しょうめつ。
正面	しょうめん。
正面衝突	しょうめんしょうとつ。
消耗品	しょうもうひん。
消耗戦	しょうもうせん。
商用	しょうよう。
将来性	しょうらいせい。
将来	しょうらい。
勝利	しょうり。
勝率	しょうりつ。
省略	しょうりゃく。
少量	しょうりょう。
使用量	しようりょう。
使用料	しようりょう。
省力化	しょうりょくか。
奨励金	しょうれいきん。
小論文	しょうろんぶん。
昭和基地	しょうわきち。
小惑星	しょうわくせい。
太陽	たいよう。
太陽系	たいようけい。
月面基地	げつめんきち。
昭和天皇	しょうわてんのう。
初夏	しょか。
初回	しょかい。
初期	しょき。
職員	しょくいん。
職員室	しょくいんしつ。
食塩	しょくえん。
食塩水	しょくえんすい。
職業	しょくぎょう。
職業訓練	しょくぎょうくんれん。
職業安定所	しょくぎょうあんていじょ。
職安	しょくあん。
食後	しょくご。
食材	しょくざい。
食事	しょくじ。
食事代	しょくじだい。
職務質問	しょくむしつもん。
職質	しょくしつ。
食洗器	しょくせんき。
食中毒	しょくちゅうどく。
食堂	しょくどう。
食道	しょくどう。
食肉	しょくにく。
職人	しょくにん。
職人芸	しょくにんげい。
職場	しょくば。
職場環境	しょくばかんきょう。
食費	しょくひ。
食品	しょくひん。
食品工場	しょくひんこうじょう。
食品衛生法	しょくひんえいせいほう。
植物	しょくぶつ。
植物状態	しょくぶつじょうたい。
植物園	しょくぶつえん。
植民地	しょくみんち。
職務	しょくむ。
食物	しょくもつ。
食物連鎖	しょくもつれんさ。
食用	しょくよう。
食料	しょくりょう。
食料自給率	しょくりょうじきゅうりつ。
食料品	しょくりょうひん。
植林	しょくりん。
職歴	しょくれき。
処刑	しょけい。
所持	しょじ。
書籍	しょせき。
処女	しょじょ。
初心者	しょしんしゃ。
諸説	しょせつ。
所詮	しょせん。
初戦	しょせん。
初代	しょだい。
歴代	れきだい。
初体験	しょたいけん。
触角	しょっかく。
食感	しょっかん。
触感	しょっかん。
食器	しょっき。
食器棚	しょっきだな。
所定	しょてい。
書店	しょてん。
書道	しょどう。
書道家	しょどうか。
初任給	しょにんきゅう。
初年度	しょねんど。
処罰	しょばつ。
処分	しょぶん。
処分場	しょぶんじょう。
書名	しょめい。
署名	しょめい。
書面	しょめん。
書物	しょもつ。
所有権	しょゆうけん。
所有物	しょゆうぶつ。
所有	しょゆう。
所要時間	しょようじかん。
処理	しょり。
書類	しょるい。
書類作成	しょるいさくせい。
書類送検	しょるいそうけん。
初老	しょろう。
小便	しょんべん。
白髪	しらが。
白玉粉	しらたまこ。
白旗	しろはた。
素人	しろうと。
白雪姫	しらゆきひめ。
資料	しりょう。
資料請求	しりょうせいきゅう。
飼料	しりょう。
視力	しりょく。
視力検査	しりょくけんさ。
視力回復	しりょくかいふく。
司令塔	しれいとう。
指令	しれい。
城跡	しろあと。
白熊	しろくま。
自腹	じばら。
白星	しろぼし。
黒星	くろぼし。
白身	しろみ。
赤身	あかみ。
白目	しろめ。
代物	しろもの。
仕業	しわざ。
師走	しわす。
親愛	しんあい。
進化	しんか。
進化論	しんかろん。
深海	しんかい。
侵害	しんがい。
心外	しんがい。
深海魚	しんかいぎょ。
進学	しんがく。
新学期	しんがっき。
新幹線	しんかんせん。
心機一転	しんきいってん。
進級	しんきゅう。
新記録	しんきろく。
親近感	しんきんかん。
寝具	しんぐ。
真空	しんくう。
神経	しんけい。
神経質	しんけいしつ。
真剣	しんけん。
震源地	しんげんち。
進行	しんこう。
信号機	しんごうき。
深呼吸	しんこきゅう。
確定申告	かくていしんこく。
深刻	しんこく。
親告罪	しんこくざい。
審査	しんさ。
震災	しんさい。
新作	しんさく。
診察	しんさつ。
診察室	しんさつしつ。
寝室	しんしつ。
真実	しんじつ。
新車	しんしゃ。
伸縮	しんしゅく。
進出	しんしゅつ。
新人	しんじん。
浸水	しんすい。
床下浸水	ゆかしたしんすい。
申請	しんせい。
神聖	しんせい。
親切	しんせつ。
新鮮	しんせん。
親善	しんぜん。
真相	しんそう。
心臓	しんぞう。
心臓部	しんぞうぶ。
身体	しんたい。
新体操	しんたいそう。
診断	しんだん。
診断書	しんだんしょ。
身長	しんちょう。
新陳代謝	しんちんたいしゃ。
神殿	しんでん。
震度	しんど。
振動数	しんどうすう。
浸透圧	しんとうあつ。
侵入	しんにゅう。
侵入者	しんにゅうしゃ。
新入社員	しんにゅうしゃいん。
新年	しんねん。
信念	しんねん。
新年会	しんねんかい。
心肺停止	しんぱいていし。
心肺蘇生法	しんぱいそせいほう。
心拍数	しんぱくすう。
審判	しんぱん。
神秘	しんぴ。
新品	しんぴん。
神父	しんぷ。
心不全	しんふぜん。
新聞	しんぶん。
新聞紙	しんぶんし。
新聞記事	しんぶんきじ。
新聞記者	しんぶんきしゃ。
新聞広告	しんぶんこうこく。
新聞社	しんぶんしゃ。
辛抱	しんぼう。
進歩	しんぽ。
親身	しんみ。
深夜	しんや。
旧約聖書	きゅうやくせいしょ。
新約聖書	しんやくせいしょ。
信用	しんよう。
信用問題	しんようもんだい。
信頼	しんらい。
信頼性	しんらいせい。
心理	しんり。
心理学	しんりがく。
真理	しんり。
心理戦	しんりせん。
森林	しんりん。
心霊現象	しんれいげんしょう。
進路	しんろ。
神話	しんわ。
事案	じあん。
自営業	じえいぎょう。
自衛隊	じえいたい。
自衛官	じえいかん。
集団的自衛権	しゅうだんてきじえいけん。
自我	じが。
自画自賛	じがじさん。
自作自演	じさくじえん。
次回	じかい。
前回	ぜんかい。
自戒	じかい。
自覚	じかく。
自家製	じかせい。
自画像	じがぞう。
時価総額	じかそうがく。
地下足袋	じかたび。
直談判	じかだんぱん。
直火	じかび。
時間	じかん。
時間帯	じかんたい。
時間内	じかんない。
時間外	じかんがい。
時給	じきゅう。
時期	じき。
次期	じき。
磁気	じき。
磁器	じき。
時期尚早	じきしょうそう。
自給自足	じきゅうじそく。
持久戦	じきゅうせん。
持久走	じきゅうそう。
持久力	じきゅうりょく。
自供	じきょう。
事業	じぎょう。
事業所	じぎょうしょ。
事業者	じぎょうしゃ。
事件	じけん。
次元	じげん。
事件発生	じけんはっせい。
時限	じげん。
時限爆弾	じげんばくだん。
自己	じこ。
事故	じこ。
時効	じこう。
自業自得	じごうじとく。
時刻	じこく。
自国	じこく。
地獄	じごく。
地獄絵	じごくえ。
時刻表	じこくひょう。
自己嫌悪	じこけんお。
自己紹介	じこしょうかい。
自己中心的	じこちゅうしんてき。
自己満足	じこまんぞく。
時差	じさ。
自作自演	じさくじえん。
自殺	じさつ。
自殺者	じさつしゃ。
自殺未遂	じさつみすい。
自殺行為	じさつこうい。
持参	じさん。
事実	じじつ。
事実関係	じじつかんけい。
事実婚	じじつこん。
事実無根	じじつむこん。
自社	じしゃ。
磁石	じしゃく。
次週	じしゅう。
自習	じしゅう。
自主規制	じしゅきせい。
辞書	じしょ。
時点	じてん。
自転	じてん。
自称	じしょう。
自傷行為	じしょうこうい。
事情	じじょう。
事情聴取	じじょうちょうしゅ。
事情通	じじょうつう。
辞職	じしょく。
辞職願	じしょくねがい。
地震	じしん。
地震速報	じしんそくほう。
自炊	じすい。
字数	じすう。
次世代	じせだい。
自薦他薦	じせんたせん。
事前	じぜん。
地蔵	じぞう。
時速	じそく。
持続	じぞく。
持続時間	じぞくじかん。
持続性	じぞくせい。
自尊心	じそんしん。
辞退	じたい。
自体	じたい。
事態	じたい。
時代	じだい。
時代劇	じだいげき。
時代錯誤	じだいさくご。
自宅	じたく。
時短	じたん。
自治会	じちかい。
自治区	じちく。
自治体	じちたい。
地方自治体	ちほうじちたい。
実印	じついん。
実家	じっか。
実感	じっかん。
実況	じっきょう。
実業家	じつぎょうか。
実験	じっけん。
実験結果	じっけんけっか。
実験室	じっけんしつ。
実現	じつげん。
実現不可能	じつげんふかのう。
実行	じっこう。
実効支配	じっこうしはい。
実行力	じっこうりょく。
実際	じっさい。
実在	じつざい。
実際問題	じっさいもんだい。
実施	じっし。
実施中	じっしちゅう。
実質	じっしつ。
実写版	じっしゃばん。
実写	じっしゃ。
実習	じっしゅう。
実証	じっしょう。
実証実験	じっしょうじっけん。
実数	じっすう。
十進法	じっしんほう。
実生活	じっせいかつ。
実績	じっせき。
実践	じっせん。
実戦	じっせん。
実線	じっせん。
実像	じつぞう。
虚像	きょぞう。
実測	じっそく。
実測値	じっそくち。
実体経済	じったいけいざい。
実弾	じつだん。
実地試験	じっちしけん。
実体	じったい。
実物	じつぶつ。
実物大	じつぶつだい。
実名	じつめい。
実名報道	じつめいほうどう。
実用化	じつようか。
実力	じつりょく。
実力者	じつりょくしゃ。
実力主義	じつりょくしゅぎ。
実例	じつれい。
実話	じつわ。
自転	じてん。
自伝	じでん。
自転軸	じてんじく。
自転車	じてんしゃ。
自動	じどう。
自動車	じどうしゃ。
自動化	じどうか。
自動改札	じどうかいさつ。
児童虐待	じどうぎゃくたい。
自動詞	じどうし。
他動詞	たどうし。
自動車税	じどうしゃぜい。
自動車保険	じどうしゃほけん。
自動小銃	じどうしょうじゅう。
児童相談所	じどうそうだんじょ。
自動販売機	じどうはんばいき。
自販機	じはんき。
児童文学	じどうぶんがく。
自動翻訳	じどうほんやく。
次男	じなん。
辞任	じにん。
地主	じぬし。
地熱発電	ちねつはつでん。
地場産業	じばさんぎょう。
磁場	じば。
自賠責保険	じばいせきほけん。
自白	じはく。
自爆	じばく。
地肌	じはだ。
地盤	じばん。
地盤沈下	じばんちんか。
耳鼻科	じびか。
自筆	じひつ。
辞表	じひょう。
持病	じびょう。
自負	じふ。
自分	じぶん。
自分自身	じぶんじしん。
自分勝手	じぶんかって。
自分史	じぶんし。
自閉症	じへいしょう。
自暴自棄	じぼうじき。
自前	じまえ。
字幕	じまく。
自慢	じまん。
地味	じみ。
事務	じむ。
事務所	じむしょ。
事務室	じむしつ。
事務員	じむいん。
自滅	じめつ。
自問自答	じもんじとう。
邪悪	じゃあく。
弱酸性	じゃくさんせい。
賛成	さんせい。
酸性	さんせい。
弱者	じゃくしゃ。
弱体化	じゃくたいか。
弱点	じゃくてん。
邪道	じゃどう。
邪魔	じゃま。
邪魔者	じゃまもの。
自由	じゆう。
自由席	じゆうせき。
重圧	じゅうあつ。
獣医	じゅうい。
自由意志	じゆういし。
縦横無尽	じゅうおうむじん。
自由化	じゆうか。
住環境	じゅうかんきょう。
重機	じゅうき。
住居	じゅうきょ。
自由業	じゆうぎょう。
従業員	じゅうぎょういん。
自由競争	じゆうきょうそう。
住居侵入罪	じゅうきょしんにゅうざい。
重金属	じゅうきんぞく。
従軍慰安婦	じゅうぐんいあんふ。
慰安婦	いあんふ。
自由経済	じゆうけいざい。
銃撃	じゅうげき。
充血	じゅうけつ。
銃口	じゅうこう。
自由行動	じゆうこうどう。
重罪	じゅうざい。
銃殺	じゅうさつ。
十字架	じゅうじか。
自由自在	じゆうじざい。
住所	じゅうしょ。
住所変更	じゅうしょへんこう。
重症	じゅうしょう。
重傷	じゅうしょう。
住職	じゅうしょく。
住所録	じゅうしょろく。
銃声	じゅうせい。
重曹	じゅうそう。
重大事故	じゅうだいじこ。
住宅	じゅうたく。
住宅地	じゅうたくち。
銃弾	じゅうだん。
充電	じゅうでん。
充電式	じゅうでんしき。
充電器	じゅうでんき。
重度	じゅうど。
自由度	じゆうど。
銃刀法	じゅうとうほう。
柔軟剤	じゅうなんざい。
柔軟性	じゅうなんせい。
柔軟	じゅうなん。
住人	じゅうにん。
重病	じゅうびょう。
重病者	じゅうびょうしゃ。
重複	ちょうふく。
自由貿易	じゆうぼうえき。
住民	じゅうみん。
住民税	じゅうみんぜい。
住民票	じゅうみんひょう。
住民基本台帳	じゅうみんきほんだいちょう。
重油	じゅうゆ。
軽油	けいゆ。
石油	せきゆ。
重要	じゅうよう。
重要性	じゅうようせい。
重要度	じゅうようど。
従来	じゅうらい。
自由落下	じゆうらっか。
重量	じゅうりょう。
重力	じゅうりょく。
重力加速度	じゅうりょくかそくど。
重労働	じゅうろうどう。
自由恋愛	じゆうれんあい。
樹液	じゅえき。
樹海	じゅかい。
需要	じゅよう。
供給	きょうきゅう。
授業	じゅぎょう。
授業料	じゅぎょうりょう。
授業中	じゅぎょうちゅう。
熟練	じゅくれん。
受刑者	じゅけいしゃ。
受験	じゅけん。
受験生	じゅけんせい。
受験勉強	じゅけんべんきょう。
樹脂	じゅし。
受賞者	じゅしょうしゃ。
授賞式	じゅしょうしき。
受診	じゅしん。
受信箱	じゅしんばこ。
送信	そうしん。
受信機	じゅしんき。
受信料	じゅしんりょう。
受精	じゅせい。
受精卵	じゅせいらん。
無精卵	むせいらん。
受注	じゅちゅう。
受注生産	じゅちゅうせいさん。
樹氷	じゅひょう。
受粉	じゅふん。
花粉	かふん。
花粉症	かふんしょう。
寿命	じゅみょう。
樹木	じゅもく。
呪文	じゅもん。
受理	じゅり。
受話器	じゅわき。
純愛	じゅんあい。
順位	じゅんい。
潤滑油	じゅんかつゆ。
循環	じゅんかん。
純金	じゅんきん。
純金積立	じゅんきんつみたて。
準決勝	じゅんけっしょう。
結晶	けっしょう。
決勝	けっしょう。
順序	じゅんじょ。
純情	じゅんじょう。
純粋	じゅんすい。
順調	じゅんちょう。
純度	じゅんど。
準備	じゅんび。
準備完了	じゅんびかんりょう。
順不同	じゅんふどう。
順列	じゅんれつ。
女王	じょおう。
常温	じょうおん。
浄化	じょうか。
乗客	じょうきゃく。
蒸気	じょうき。
上記	じょうき。
下記	かき。
定規	じょうぎ。
蒸気圧	じょうきあつ。
蒸気機関	じょうききかん。
上機嫌	じょうきげん。
上級者	じょうきゅうしゃ。
上級生	じょうきゅうせい。
下級生	かきゅうせい。
同級生	どうきゅうせい。
状況	じょうきょう。
上京	じょうきょう。
上空	じょうくう。
上下	じょうげ。
情景	じょうけい。
条件	じょうけん。
上限	じょうげん。
加減	かげん。
上皇	じょうこう。
条項	じょうこう。
錠剤	じょうざい。
常時	じょうじ。
常識	じょうしき。
乗車券	じょうしゃけん。
乗車	じょうしゃ。
情弱	じょうじゃく。
情報弱者	じょうほうじゃくしゃ。
常習犯	じょうしゅうはん。
上昇	じょうしょう。
上手	じょうず。
浄水器	じょうすいき。
浄水場	じょうすいじょう。
上水道	じょうすいどう。
状態	じょうたい。
常態化	じょうたいか。
上達	じょうたつ。
冗談	じょうだん。
譲渡	じょうと。
上等	じょうとう。
場内	じょうない。
常任理事国	じょうにんりじこく。
情熱	じょうねつ。
乗馬	じょうば。
蒸発	じょうはつ。
上半身	じょうはんしん。
下半身	かはんしん。
上品	じょうひん。
下品	げひん。
丈夫	じょうぶ。
大丈夫	だいじょうぶ。
成仏	じょうぶつ。
情報	じょうほう。
情報量	じょうほうりょう。
情報収集	じょうほうしゅうしゅう。
情報化社会	じょうほうかしゃかい。
情報源	じょうほうげん。
情報誌	じょうほうし。
静脈	じょうみゃく。
動脈	どうみゃく。
乗務員	じょうむいん。
常務	じょうむ。
縄文時代	じょうもんじだい。
縄文土器	じょうもんどき。
条約	じょうやく。
乗用車	じょうようしゃ。
上陸	じょうりく。
上流社会	じょうりゅうしゃかい。
蒸留酒	じょうりゅうしゅ。
蒸留水	じょうりゅうすい。
常緑樹	じょうりょくじゅ。
条例	じょうれい。
常連	じょうれん。
助監督	じょかんとく。
除去	じょきょ。
助教授	じょきょうじゅ。
教授	きょうじゅ。
序曲	じょきょく。
除菌	じょきん。
抗菌	こうきん。
助言	じょげん。
除光液	じょこうえき。
助産師	じょさんし。
女子	じょし。
男子	だんし。
女子高生	じょしこうせい。
男子高生	だんしこうせい。
女子大生	じょしだいせい。
男子大生	だんしだいせい。
除籍	じょせき。
助手	じょしゅ。
助手席	じょしゅせき。
女性	じょせい。
男性	だんせい。
女優	じょゆう。
男優	だんゆう。
除雪	じょせつ。
除雪機	じょせつき。
除雪車	じょせつしゃ。
女装	じょそう。
助走	じょそう。
除草剤	じょそうざい。
除染	じょせん。
助成金	じょせいきん。
助長	じょちょう。
序盤	じょばん。
除幕式	じょまくしき。
脱毛剤	だつもうざい。
序列化	じょれつか。
地雷	じらい。
地雷原	じらいげん。
自力	じりき。
自立	じりつ。
自律神経	じりつしんけい。
磁力	じりょく。
自力	じりょく。
磁力線	じりょくせん。
事例	じれい。
辞令	じれい。
持論	じろん。
陣営	じんえい。
人格	じんかく。
人格者	じんかくしゃ。
人権	じんけん。
人権侵害	じんけんしんがい。
人件費	じんけんひ。
人工	じんこう。
人工知能	じんこうちのう。
人口	じんこう。
人災	じんさい。
人事	じんじ。
人事異動	じんじいどう。
人事権	じんじけん。
神社	じんじゃ。
人種	じんしゅ。
人種差別	じんしゅさべつ。
人身事故	じんしんじこ。
人身売買	じんしんばいばい。
人生	じんせい。
人生相談	じんせいそうだん。
腎臓	じんぞう。
人体	じんたい。
人体実験	じんたいじっけん。
陣地	じんち。
人畜無害	じんちくむがい。
陣痛	じんつう。
腎不全	じんふぜん。
人物	じんぶつ。
人物像	じんぶつぞう。
人文科学	じんぶんかがく。
人望	じんぼう。
人脈	じんみゃく。
人民	じんみん。
人民元	じんみんげん。
日本円	にほんえん。
人命	じんめい。
人力車	じんりきしゃ。
尽力	じんりょく。
人類	じんるい。
素足	すあし。
水圧	すいあつ。
推移	すいい。
水位	すいい。
水泳	すいえい。
水泳部	すいえいぶ。
水温	すいおん。
水害	すいがい。
水牛	すいぎゅう。
水銀	すいぎん。
推計	すいけい。
水源	すいげん。
遂行	すいこう。
水彩画	すいさいが。
水質	すいしつ。
水車	すいしゃ。
衰弱	すいじゃく。
水準	すいじゅん。
水晶	すいしょう。
推奨	すいしょう。
水蒸気	すいじょうき。
水晶体	すいしょうたい。
水晶時計	すいしょうどけい。
推進	すいしん。
水深	すいしん。
推進力	すいしんりょく。
水星	すいせい。
水性	すいせい。
水性塗料	すいせいとりょう。
油性塗料	ゆせいとりょう。
推薦	すいせん。
推薦状	すいせんじょう。
水洗	すいせん。
水素	すいそ。
水槽	すいそう。
吹奏楽	すいそうがく。
推測	すいそく。
水族館	すいぞくかん。
水素爆弾	すいそばくだん。
衰退	すいたい。
水中	すいちゅう。
垂直	すいちょく。
推定	すいてい。
水滴	すいてき。
水筒	すいとう。
水道	すいどう。
水道料金	すいどうりょうきん。
水爆	すいばく。
炊飯器	すいはんき。
水分	すいぶん。
水分補給	すいぶんほきゅう。
水平	すいへい。
水平線	すいへいせん。
水墨画	すいぼくが。
水没	すいぼつ。
睡魔	すいま。
水脈	すいみゃく。
睡眠	すいみん。
睡眠不足	すいみんぶそく。
睡眠薬	すいみんやく。
水面	すいめん。
水面下	すいめんか。
水溶液	すいようえき。
推理	すいり。
水流	すいりゅう。
水量	すいりょう。
推量	すいりょう。
水力	すいりょく。
水路	すいろ。
推論	すいろん。
数回	すうかい。
数学	すうがく。
数学者	すうがくしゃ。
数字	すうじ。
数式	すうしき。
数日	すうじつ。
数段	すうだん。
数値	すうち。
数直線	すうちょくせん。
数人	すうにん。
崇拝	すうはい。
崇拝者	すうはいしゃ。
数理	すうり。
数量	すうりょう。
数列	すうれつ。
素顔	すがお。
助太刀	すけだち。
双六	すごろく。
筋金	すじがね。
素敵	すてき。
素手	すで。
砂嵐	すなあらし。
素直	すなお。
砂時計	すなどけい。
砂場	すなば。
砂風呂	すなぶろ。
素肌	すはだ。
巣箱	すばこ。
酢豚	すぶた。
酢飯	すめし。
相撲	すもう。
相撲協会	すもうきょうかい。
寸前	すんぜん。
寸法	すんぽう。
図案	ずあん。
随分	ずいぶん。
図体	ずうたい。
図画工作	ずがこうさく。
図鑑	ずかん。
図形	ずけい。
図工	ずこう。
頭上	ずじょう。
頭上注意	ずじょうちゅうい。
頭痛	ずつう。
頭脳	ずのう。
図星	ずぼし。
背油	せあぶら。
性悪説	せいあくせつ。
性善説	せいぜんせつ。
制圧	せいあつ。
誠意	せいい。
聖域	せいいき。
生育	せいいく。
成育	せいいく。
精一杯	せいいっぱい。
精鋭	せいえい。
精液	せいえき。
声援	せいえん。
成果	せいか。
成果物	せいかぶつ。
青果物	せいかぶつ。
製菓	せいか。
正解	せいかい。
政界	せいかい。
正解者	せいかいしゃ。
正会員	せいかいいん。
制海権	せいかいけん。
正確	せいかく。
性格	せいかく。
成果主義	せいかしゅぎ。
生活	せいかつ。
生活科	せいかつか。
生活苦	せいかつく。
生活難	せいかつなん。
生活保護	せいかつほご。
生活費	せいかつひ。
生還	せいかん。
生還者	せいかんしゃ。
正規	せいき。
世紀	せいき。
性器	せいき。
世紀末	せいきまつ。
正義	せいぎ。
正義感	せいぎかん。
請求	せいきゅう。
請求書	せいきゅうしょ。
請求金額	せいきゅうきんがく。
請求権	せいきゅうけん。
制御	せいぎょ。
制御盤	せいぎょばん。
生協	せいきょう。
性教育	せいきょういく。
政教分離	せいきょうぶんり。
政局	せいきょく。
制御棒	せいぎょぼう。
制空権	せいくうけん。
整形	せいけい。
政治経済	せいじけいざい。
整形外科	せいけいげか。
政見放送	せいけんほうそう。
政権	せいけん。
制限	せいげん。
制限時間	せいげんじかん。
正誤表	せいごひょう。
生後	せいご。
成功	せいこう。
成功者	せいこうしゃ。
性交	せいこう。
精巧	せいこう。
性行為	せいこうい。
晴耕雨読	せいこううどく。
整合性	せいごうせい。
正攻法	せいこうほう。
成功裏	せいこうり。
整骨院	せいこついん。
精魂	せいこん。
成婚	せいこん。
精査	せいさ。
星座	せいざ。
正座	せいざ。
制裁	せいさい。
経済制裁	けいざいせいさい。
製剤	せいざい。
製材	せいざい。
制作	せいさく。
製作	せいさく。
製作所	せいさくじょ。
政策	せいさく。
生殺与奪	せいさつよだつ。
性差別	せいさべつ。
生産	せいさん。
大量生産	たいりょうせいさん。
青酸	せいさん。
清算	せいさん。
精算	せいさん。
正三角形	せいさんかくけい。
生産価格	せいさんかかく。
生産過剰	せいさんかじょう。
生産管理	せいさんかんり。
生産者	せいさんしゃ。
生産性	せいさんせい。
生産高	せいさんだか。
生産的	せいさんてき。
建設的	けんせつてき。
製紙	せいし。
精子	せいし。
生死	せいし。
静止	せいし。
制止	せいし。
政治	せいじ。
政治家	せいじか。
静止衛星	せいしえいせい。
静止画	せいしが。
静止画像	せいしがぞう。
正式	せいしき。
政治空白	せいじくうはく。
政治資金規正法	せいじしきんきせいほう。
政治団体	せいじだんたい。
性質	せいしつ。
誠実	せいじつ。
政治犯	せいじはん。
正四面体	せいしめんたい。
聖者	せいじゃ。
正射影	せいしゃえい。
静寂	せいじゃく。
清酒	せいしゅ。
整数	せいすう。
生成	せいせい。
精製	せいせい。
性生活	せいせいかつ。
成績	せいせき。
成績表	せいせきひょう。
生石灰	せいせっかい。
生鮮食品	せいせんしょくひん。
聖戦	せいせん。
生前	せいぜん。
性善説	せいぜんせつ。
性悪説	せいあくせつ。
整然	せいぜん。
清掃	せいそう。
正装	せいそう。
精巣	せいそう。
成層圏	せいそうけん。
正則	せいそく。
生息	せいそく。
生息地	せいそくち。
製造	せいぞう。
製造元	せいぞうもと。
製造業	せいぞうぎょう。
生存	せいぞん。
生存率	せいぞんりつ。
生存者	せいぞんしゃ。
生存権	せいぞんけん。
生体	せいたい。
生態	せいたい。
整体	せいたい。
声帯	せいたい。
生態系	せいたいけい。
正多角形	せいたかくけい。
生誕	せいたん。
生誕地	せいたんち。
聖誕祭	せいたんさい。
盛大	せいだい。
清濁	せいだく。
星団	せいだん。
政談	せいだん。
聖地	せいち。
成虫	せいちゅう。
成長	せいちょう。
成長点	せいちょうてん。
生長	せいちょう。
成鳥	せいちょう。
清聴	せいちょう。
整腸	せいちょう。
成長株	せいちょうかぶ。
精通	せいつう。
制定	せいてい。
制定法	せいていほう。
静的	せいてき。
性的	せいてき。
政敵	せいてき。
施行	しこう。
試行	しこう。
指向	しこう。
思考	しこう。
志向	しこう。
製鉄	せいてつ。
製鉄所	せいてつじょ。
晴天	せいてん。
聖典	せいてん。
青天	せいてん。
性転換	せいてんかん。
静電	せいでん。
静電気	せいでんき。
生徒	せいと。
生徒会	せいとかい。
生徒会長	せいとかいちょう。
政党	せいとう。
正当	せいとう。
正統	せいとう。
正当防衛	せいとうぼうえい。
正答	せいとう。
正当化	せいとうか。
正当性	せいとうせい。
政党制	せいとうせい。
正統派	せいとうは。
政党法	せいとうほう。
生徒指導	せいとしどう。
生徒手帳	せいとてちょう。
精度	せいど。
制度	せいど。
青銅	せいどう。
聖堂	せいどう。
制動	せいどう。
青銅器	せいどうき。
制動距離	せいどうきょり。
制動時間	せいどうじかん。
精読	せいどく。
制度的	せいどてき。
西南	せいなん。
西南西	せいなんせい。
北北西	ほくほくせい。
南南西	なんなんせい。
北西	ほくせい。
北東	ほくとう。
南西	なんせい。
南南西	なんなんせい。
南東	なんとう。
南南東	なんなんとう。
精肉	せいにく。
精肉店	せいにくてん。
生乳	せいにゅう。
青年	せいねん。
生年月日	せいねんがっぴ。
成年	せいねん。
青年期	せいねんき。
成年指定	せいねんしてい。
青年団	せいねんだん。
成年者	せいねんしゃ。
未成年者	みせいねんしゃ。
性能	せいのう。
高性能	こうせいのう。
低性能	ていせいのう。
制覇	せいは。
成敗	せいばい。
聖杯	せいはい。
精白米	せいはくまい。
正八面体	せいはちめんたい。
整髪	せいはつ。
製版	せいはん。
性犯罪	せいはんざい。
正反対	せいはんたい。
成否	せいひ。
正否	せいひ。
製氷	せいひょう。
製氷機	せいひょうき。
正比例	せいひれい。
製品	せいひん。
整備	せいび。
整備工場	せいびこうじょう。
整備士	せいびし。
性病	せいびょう。
政府	せいふ。
制服	せいふく。
征服	せいふく。
私腹	しふく。
私服	しふく。
征服者	せいふくしゃ。
政府系	せいふけい。
政府米	せいふまい。
製粉	せいふん。
製粉業	せいふんぎょう。
製粉機	せいふんき。
西部	せいぶ。
西部劇	せいぶげき。
生物	せいぶつ。
生物学	せいぶつがく。
生物学的	せいぶつがくてき。
静物画	せいぶつが。
生物界	せいぶつかい。
生物化学	せいぶつかがく。
生物工学	せいぶつこうがく。
生物兵器	せいぶつへいき。
成分	せいぶん。
成分表	せいぶんひょう。
成分表示	せいぶんひょうじ。
成文法	せいぶんほう。
成文	せいぶん。
成文化	せいぶんか。
性癖	せいへき。
政変	せいへん。
性別	せいべつ。
性別不明	せいべつふめい。
製法	せいほう。
正方形	せいほうけい。
西方	せいほう。
南方	なんぽう。
北方	ほっぽう。
東宝	とうほう。
東方	とうほう。
西北西	せいほくせい。
製本	せいほん。
歳暮	せいぼ。
聖母	せいぼ。
御歳暮	おせいぼ。
性暴力	せいぼうりょく。
生没年	せいぼつねん。
精米	せいまい。
精米機	せいまいき。
精密	せいみつ。
政務	せいむ。
政務官	せいむかん。
政務次官	せいむじかん。
生命	せいめい。
声明	せいめい。
姓名	せいめい。
生命力	せいめいりょく。
生命体	せいめいたい。
生命線	せいめいせん。
正門	せいもん。
声紋	せいもん。
聖夜	せいや。
制約	せいやく。
成約	せいやく。
誓約	せいやく。
誓約書	せいやくしょ。
精油	せいゆ。
製油所	せいゆじょ。
声優	せいゆう。
政友	せいゆう。
西洋	せいよう。
静養	せいよう。
西洋画	せいようが。
西洋学	せいようがく。
西洋風	せいようふう。
性欲	せいよく。
整理	せいり。
生理	せいり。
生理学	せいりがく。
整理券	せいりけん。
成立	せいりつ。
生理痛	せいりつう。
生理的	せいりてき。
政略	せいりゃく。
清流	せいりゅう。
整流	せいりゅう。
整流器	せいりゅうき。
青龍刀	せいりゅうとう。
清涼飲料水	せいりょういんりょうすい。
清涼剤	せいりょうざい。
勢力	せいりょく。
精力剤	せいりょくざい。
精力	せいりょく。
精力的	せいりょくてき。
生類	しょうるい。
精霊	せいれい。
政令	せいれい。
制令	せいれい。
西暦	せいれき。
和暦	われき。
整列	せいれつ。
清廉	せいれん。
精錬	せいれん。
清廉潔白	せいれんけっぱく。
正露丸	せいろがん。
正論	せいろん。
正六面体	せいろくめんたい。
世界	せかい。
世界中	せかいじゅう。
世界一	せかいいち。
日本一	にほんいち。
世界遺産	せかいいさん。
世界観	せかいかん。
世界史	せかいし。
世界的	せかいてき。
石英	せきえい。
岩塩	がんえん。
赤外線	せきがいせん。
赤軍	せきぐん。
積載	せきさい。
積載量	せきさいりょう。
積載車	せきさいしゃ。
石材	せきざい。
石材店	せきざいてん。
石室	せきしつ。
石質	せきしつ。
積集合	せきしゅうごう。
和集合	わしゅうごう。
赤十字	せきじゅうじ。
席順	せきじゅん。
関所	せきしょ。
赤色	せきしょく。
巨星	きょせい。
去勢	きょせい。
石製	せきせい。
積雪	せきせつ。
積雪量	せきせつりょう。
石造	せきぞう。
石像	せきぞう。
積層	せきそう。
石炭	せきたん。
火力	かりょく。
液化	えきか。
石柱	せきちゅう。
赤道	せきどう。
付近	ふきん。
関取	せきとり。
責任	せきにん。
責任者	せきにんしゃ。
責任感	せきにんかん。
積年	せきねん。
惜敗	せきはい。
赤飯	せきはん。
石板	せきばん。
石版	せきばん。
石盤	せきばん。
石版画	せきはんが。
席札	せきふだ。
石仏	せきぶつ。
積分	せきぶん。
微分	びぶん。
赤壁	せきへき。
惜別	せきべつ。
赤報隊	せきほうたい。
席末	せきまつ。
責務	せきむ。
赤面	せきめん。
石綿	いしわた。
石油	せきゆ。
石油王	せきゆおう。
危機	きき。
積乱雲	せきらんうん。
世銀	せぎん。
世間	せけん。
世間話	せけんばなし。
世間体	せけんてい。
世間的	せけんてき。
施工	せこう。
施行	せこう。
施主	せしゅ。
世襲	せしゅう。
御世辞	おせじ。
世辞	せじ。
施錠	せじょう。
背筋	せすじ。
世相	せそう。
世俗	せぞく。
世俗的	せぞくてき。
世俗化	せぞくか。
世帯	せたい。
世帯主	せたいぬし。
世代	せだい。
世代間	せだいかん。
世知	せち。
節分	せつぶん。
設営	せつえい。
雪害	せつがい。
接眼	せつがん。
接岸	せつがん。
切願	せつがん。
節減	せつげん。
接合	せつごう。
接合部	せつごうぶ。
接辞	せつじ。
切実	せつじつ。
切除	せつじょ。
切除術	せつじょじゅつ。
雪辱	せつじょく。
雪上	せつじょう。
雪上車	せつじょうしゃ。
節税	せつぜい。
接続	せつぞく。
接続詞	せつぞくし。
接続語	せつぞくご。
切断	せつだん。
切断機	せつだんき。
切断面	せつだんめん。
節電	せつでん。
節度	せつど。
設備	せつび。
設備費	せつびひ。
接尾語	せつびご。
接尾辞	せつびじ。
切望	せつぼう。
説明	せつめい。
説明書	せつめいしょ。
説明文	せつめいぶん。
説明会	せつめいかい。
設問	せつもん。
節約	せつやく。
節約術	せつやくじゅつ。
節理	せつり。
設立	せつりつ。
説話	せつわ。
瀬戸際	せとぎわ。
瀬戸物	せともの。
背中	せなか。
背幅	せはば。
背番号	せばんごう。
施肥	せひ。
世評	せひょう。
背表紙	せびょうし。
背広	せびろ。
背骨	せぼね。
施薬	せやく。
台詞	せりふ。
世論	せろん。
世話	せわ。
御世話	おせわ。
世話人	せわにん。
世話物	せわもの。
世話役	せわやく。
戦意	せんい。
船医	せんい。
繊維	せんい。
遷移	せんい。
船員	せんいん。
船員法	せんいんほう。
先鋭化	せんえいか。
千億	せんおく。
戦火	せんか。
専科	せんか。
戦果	せんか。
線画	せんが。
旋回	せんかい。
船外	せんがい。
千回	せんかい。
船外機	せんがいき。
浅海	せんかい。
戦艦	せんかん。
選管	せんかん。
選挙管理委員会	せんきょかんりいいんかい。
洗顔	せんがん。
洗眼	せんがん。
洗顔料	せんがんりょう。
先願	せんがん。
戦記	せんき。
先客	せんきゃく。
船客	せんきゃく。
選挙	せんきょ。
選挙権	せんきょけん。
選挙区	せんきょく。
鮮魚	せんぎょ。
宣教師	せんきょうし。
戦況	せんきょう。
専業	せんぎょう。
専業主婦	せんぎょうしゅふ。
専業主夫	せんぎょうしゅふ。
選挙会	せんきょかい。
選曲	せんきょく。
戦局	せんきょく。
選局	せんきょく。
選挙人	せんきょにん。
千金	せんきん。
先駆者	せんくしゃ。
千家	せんけ。
線形	せんけい。
鮮血	せんけつ。
先決	せんけつ。
先月	せんげつ。
先見	せんけん。
宣言	せんげん。
宣言書	せんげんしょ。
選言	せんげん。
戦後	せんご。
先行	せんこう。
専攻	せんこう。
選考	せんこう。
選好	せんこう。
線香	せんこう。
専攻科	せんこうか。
線香代	せんこうだい。
宣告	せんこく。
戦国	せんごく。
千石	せんごく。
戦後派	せんごは。
戦災	せんさい。
繊細	せんさい。
洗剤	せんざい。
潜在	せんざい。
潜在能力	せんざいのうりょく。
潜在意識	せんざいいしき。
線材	せんざい。
千載一遇	せんざいいちぐう。
潜在株	せんざいかぶ。
潜在的	せんざいてき。
千差万別	せんさばんべつ。
戦士	せんし。
戦死	せんし。
戦時	せんじ。
戦時中	せんじちゅう。
船室	せんしつ。
先日	せんじつ。
洗車	せんしゃ。
洗車代	せんしゃだい。
戦車	せんしゃ。
洗車場	せんしゃじょう。
洗車機	せんしゃき。
選者	せんじゃ。
選手	せんしゅ。
選手権	せんしゅけん。
船主	せんしゅ。
船首	せんしゅ。
先週	せんしゅう。
専修	せんしゅう。
先住民	せんじゅうみん。
先住	せんじゅう。
専従者	せんじゅうしゃ。
専従	せんじゅう。
選出	せんしゅつ。
戦術	せんじゅつ。
占術	せんじゅつ。
先述	せんじゅつ。
戦術核	せんじゅつかく。
戦略核	せんりゃくかく。
専守防衛	せんしゅぼうえい。
選手村	せんしゅむら。
戦勝	せんしょう。
先勝	せんしょう。
洗浄水	せんじょうすい。
洗浄液	せんじょうえき。
洗浄機	せんじょうき。
線状	せんじょう。
戦場	せんじょう。
線上	せんじょう。
扇情	せんじょう。
船上	せんじょう。
洗浄器	せんじょうき。
洗浄剤	せんじょうざい。
扇状地	せんじょうち。
扇情的	せんじょうてき。
染色	せんしょく。
染色体	せんしょくたい。
先進的	せんしんてき。
専心	せんしん。
先進	せんしん。
先進国	せんしんこく。
後進国	こうしんこく。
先人	せんじん。
先人達	せんじんたち。
先陣	せんじん。
扇子	せんす。
潜水	せんすい。
潜水士	せんすいし。
潜水艦	せんすいかん。
潜水病	せんすいびょう。
潜水服	せんすいふく。
先生	せんせい。
先生方	せんせいがた。
先生達	せんせいたち。
先制攻撃	せんせいこうげき。
宣誓	せんせい。
選手宣誓	せんしゅせんせい。
専制君主	せんせいくんしゅ。
宣誓書	せんせいしょ。
占星術	せんせいじゅつ。
専制政治	せんせいせいじ。
船籍	せんせき。
宣戦布告	せんせんふこく。
戦線	せんせん。
戦前	せんぜん。
先月	せんげつ。
先々月	せんせんげつ。
先祖	せんぞ。
戦争	せんそう。
専属	せんぞく。
船体	せんたい。
選対	せんたい。
戦隊	せんたい。
選挙対策	せんきょたいさく。
本部	ほんぶ。
委員会	いいんかい。
先代	せんだい。
線対称	せんたいしょう。
点対称	てんたいしょう。
選択	せんたく。
洗濯	せんたく。
洗濯機	せんたくき。
選択肢	せんたくし。
洗濯板	せんたくいた。
科目	かもく。
洗濯物	せんたくもの。
先端	せんたん。
先端部	せんたんぶ。
船団	せんだん。
護送船団	ごそうせんだん。
先端的	せんたんてき。
戦地	せんち。
先着	せんちゃく。
煎茶	せんちゃ。
線虫	せんちゅう。
戦中	せんちゅう。
船長	せんちょう。
先手	せんて。
選定	せんてい。
宣伝	せんでん。
宣伝費	せんでんひ。
宣伝部	せんでんぶ。
宣伝用	せんでんよう。
先天的	せんてんてき。
遷都	せんと。
鮮度	せんど。
先頭	せんとう。
銭湯	せんとう。
戦闘	せんとう。
戦闘機	せんとうき。
戦闘力	せんとうりょく。
戦闘員	せんとういん。
戦闘中	せんとうちゅう。
船頭	せんどう。
先導	せんどう。
扇動	せんどう。
扇動的	せんどうてき。
先土器	せんどき。
千度	せんど。
船内	せんない。
鮮肉	せんにく。
千日	せんにち。
先入観	せんにゅうかん。
潜入	せんにゅう。
仙人	せんにん。
千人	せんにん。
選任	せんにん。
専任	せんにん。
千人力	せんにんりき。
千年	せんねん。
専念	せんねん。
洗脳	せんのう。
専売	せんばい。
千倍	せんばい。
百倍	ひゃくばい。
専売特許	せんばいとっきょ。
船舶	せんぱく。
船舶用	せんぱくよう。
船舶法	せんぱくほう。
選抜	せんばつ。
先発	せんぱつ。
後発	こうはつ。
千発	せんぱつ。
洗髪	せんぱつ。
千羽鶴	せんばづる。
旋盤	せんばん。
戦犯	せんぱん。
船尾	せんび。
戦費	せんぴ。
扇風機	せんぷうき。
旋風	せんぷう。
潜伏	せんぷく。
潜伏期	せんぷくき。
線分	せんぶん。
選別	せんべつ。
選別機	せんべつき。
戦法	せんぽう。
千本	せんぼん。
戦没者	せんぼつしゃ。
洗米	せんまい。
千枚	せんまい。
洗米機	せんまいき。
選民	せんみん。
選民思想	せんみんしそう。
専務	せんむ。
洗面器	せんめんき。
洗面台	せんめんだい。
洗面所	せんめんじょ。
専門	せんもん。
専門家	せんもんか。
専門店	せんもんてん。
専門医	せんもんい。
専門語	せんもんご。
専門職	せんもんしょく。
専門的	せんもんてき。
占有率	せんゆうりつ。
専有面積	せんゆうめんせき。
専有	せんゆう。
占有	せんゆう。
占有権	せんゆうけん。
専有部分	せんゆうぶぶん。
専用	せんよう。
専用機	せんようき。
戦乱	せんらん。
千里	せんり。
戦利品	せんりひん。
千里眼	せんりがん。
旋律	せんりつ。
戦略	せんりゃく。
占領	せんりょう。
染料	せんりょう。
千両	せんりょう。
線量	せんりょう。
占領地	せんりょうち。
選良	せんりょう。
線量計	せんりょうけい。
千両箱	せんりょうばこ。
千両役者	せんりょうやくしゃ。
戦力	せんりょく。
戦力外	せんりょくがい。
洗礼	せんれい。
先例	せんれい。
洗礼名	せんれいめい。
戦歴	せんれき。
鮮烈	せんれつ。
洗練	せんれん。
戦列	せんれつ。
線路	せんろ。
線路内	せんろない。
税額	ぜいがく。
税関	ぜいかん。
税金	ぜいきん。
税収	ぜいしゅう。
税務署	ぜいむしょ。
税務調査	ぜいむちょうさ。
税理士	ぜいりし。
税率	ぜいりつ。
消費税	しょうひぜい。
是正	ぜせい。
絶縁	ぜつえん。
絶縁体	ぜつえんたい。
絶句	ぜっく。
絶景	ぜっけい。
絶好	ぜっこう。
絶交	ぜっこう。
絶好調	ぜっこうちょう。
絶対	ぜったい。
絶対値	ぜったいち。
絶大	ぜつだい。
絶対音感	ぜったいおんかん。
絶頂	ぜっちょう。
絶品	ぜっぴん。
絶望	ぜつぼう。
絶望的	ぜつぼうてき。
絶不調	ぜつふちょう。
絶妙	ぜつみょう。
絶滅	ぜつめつ。
絶体絶命	ぜったいぜつめい。
絶倫	ぜつりん。
是非	ぜひ。
善悪	ぜんあく。
善意	ぜんい。
全域	ぜんいき。
全員	ぜんいん。
前衛	ぜんえい。
全米	ぜんべい。
前衛的	ぜんえいてき。
全音	ぜんおん。
半音	はんおん。
前科	ぜんか。
前回	ぜんかい。
全開	ぜんかい。
全壊	ぜんかい。
半壊	はんかい。
全角	ぜんかく。
半角	はんかく。
全額	ぜんがく。
前科者	ぜんかもの。
全巻	ぜんかん。
全館	ぜんかん。
前期	ぜんき。
後期	こうき。
全曲	ぜんきょく。
前屈	ぜんくつ。
全軍	ぜんぐん。
前景	ぜんけい。
前後	ぜんご。
全校	ぜんこう。
全国	ぜんこく。
全国的	ぜんこくてき。
前後賞	ぜんごしょう。
前作	ぜんさく。
前時代的	ぜんじだいてき。
全日制	ぜんにちせい。
前者	ぜんしゃ。
後者	こうしゃ。
全社	ぜんしゃ。
全集	ぜんしゅう。
前述	ぜんじゅつ。
全書	ぜんしょ。
善処	ぜんしょ。
全勝	ぜんしょう。
全焼	ぜんしょう。
前進	ぜんしん。
全身	ぜんしん。
全数	ぜんすう。
前世	ぜんせ。
全盛期	ぜんせいき。
前世紀	ぜんせいき。
全世界	ぜんせかい。
前線	ぜんせん。
善戦	ぜんせん。
全然	ぜんぜん。
全速力	ぜんそくりょく。
全体	ぜんたい。
全体的	ぜんたいてき。
全体主義	ぜんたいしゅぎ。
前代未聞	ぜんだいみもん。
善玉	ぜんだま。
悪玉	あくだま。
全治	ぜんち。
全知全能	ぜんちぜんのう。
前置詞	ぜんちし。
全長	ぜんちょう。
前兆	ぜんちょう。
前提	ぜんてい。
全店	ぜんてん。
前転	ぜんてん。
前途	ぜんと。
前途多難	ぜんとたなん。
全土	ぜんど。
前頭葉	ぜんとうよう。
全日本	ぜんにほん。
前任者	ぜんにんしゃ。
後任者	こうにんしゃ。
善人	ぜんにん。
悪人	あくにん。
前年	ぜんねん。
前年度	ぜんねんど。
全敗	ぜんぱい。
全廃	ぜんぱい。
前半	ぜんはん。
前半戦	ぜんはんせん。
全般	ぜんぱん。
全反射	ぜんはんしゃ。
全般的	ぜんぱんてき。
全否定	ぜんひてい。
全品	ぜんぴん。
全部	ぜんぶ。
全仏	ぜんふつ。
全文	ぜんぶん。
前文	ぜんぶん。
全米	ぜんべい。
全編	ぜんぺん。
前編	ぜんぺん。
後編	こうへん。
全方位	ぜんほうい。
前方一致	ぜんぽういっち。
後方一致	こうほういっち。
全滅	ぜんめつ。
前面	ぜんめん。
全面	ぜんめん。
全面的	ぜんめんてき。
全面安	ぜんめんやす。
全問	ぜんもん。
正解者	せいかいしゃ。
全国区	ぜんこくく。
禅問答	ぜんもんどう。
前夜	ぜんや。
前夜祭	ぜんやさい。
全容	ぜんよう。
前葉体	ぜんようたい。
全裸	ぜんら。
前立腺	ぜんりつせん。
前略	ぜんりゃく。
全粒粉	ぜんりゅうふん。
全量	ぜんりょう。
善良	ぜんりょう。
全力	ぜんりょく。
前輪	ぜんりん。
前例	ぜんれい。
前列	ぜんれつ。
後列	こうれつ。
粗悪	そあく。
粗悪品	そあくひん。
素因数	そいんすう。
相思相愛	そうしそうあい。
草案	そうあん。
創意工夫	そういくふう。
総意	そうい。
相違	そうい。
総員	そういん。
相応	そうおう。
騒音	そうおん。
騒音計	そうおんけい。
総会	そうかい。
爽快	そうかい。
壮快	そうかい。
総画数	そうかくすう。
総額	そうがく。
相加平均	そうかへいきん。
相乗平均	そうじょうへいきん。
送還	そうかん。
創刊	そうかん。
相関	そうかん。
壮観	そうかん。
相関関係	そうかんかんけい。
双眼鏡	そうがんきょう。
相関図	そうかんず。
早期	そうき。
想起	そうき。
葬儀	そうぎ。
争議	そうぎ。
送球	そうきゅう。
早急	そうきゅう。
総業	そうぎょう。
創業	そうぎょう。
操業	そうぎょう。
双曲線	そうきょくせん。
送金	そうきん。
遭遇	そうぐう。
宗家	そうけ。
早計	そうけい。
総計	そうけい。
送迎	そうげい。
送迎車	そうげいしゃ。
送検	そうけん。
総研	そうけん。
創建	そうけん。
草原	そうげん。
倉庫	そうこ。
相互	そうご。
走行	そうこう。
走行中	そうこうちゅう。
装甲車	そうこうしゃ。
奏功	そうこう。
草稿	そうこう。
総合	そうごう。
総合的	そうごうてき。
壮行会	そうこうかい。
総攻撃	そうこうげき。
走行性	そうこうせい。
荘厳	そうごん。
早婚	そうこん。
捜査	そうさ。
捜査官	そうさかん。
操作	そうさ。
走査	そうさ。
操作性	そうさせい。
総裁	そうさい。
相殺	そうさい。
冠婚葬祭	かんこんそうさい。
創作	そうさく。
捜索	そうさく。
創作劇	そうさくげき。
走査線	そうさせん。
早産	そうざん。
相思相愛	そうしそうあい。
掃除	そうじ。
掃除機	そうじき。
相似	そうじ。
葬式	そうしき。
総指揮	そうしき。
創始者	そうししゃ。
総辞職	そうじしょく。
喪失	そうしつ。
喪失感	そうしつかん。
総支配人	そうしはいにん。
総資本	そうしほん。
走者	そうしゃ。
送受信	そうじゅしん。
操縦	そうじゅう。
操縦性	そうじゅうせい。
操縦席	そうじゅうせき。
総重量	そうじゅうりょう。
早熟	そうじゅく。
宗主国	そうしゅこく。
創出	そうしゅつ。
送出	そうしゅつ。
草書	そうしょ。
総称	そうしょう。
相乗	そうじょう。
層状	そうじょう。
装飾	そうしょく。
草食	そうしょく。
装飾品	そうしょくひん。
草食系	そうしょくけい。
草食性	そうしょくけい。
肉食性	にくしょくせい。
総司令官	そうしれいかん。
送信	そうしん。
誤送信	ごそうしん。
送信機	そうしんき。
受信機	じゅしんき。
送信箱	そうしんばこ。
受信箱	じゅしんばこ。
送水	そうすい。
送水管	そうすいかん。
総数	そうすう。
双生児	そうせいじ。
創世記	そうせいき。
創世期	そうせいき。
創成	そうせい。
総勢	そうぜい。
創設	そうせつ。
創設者	そうせつしゃ。
壮絶	そうぜつ。
騒然	そうぜん。
壮絶	そうぜつ。
想像	そうぞう。
想像力	そうぞうりょく。
創造	そうぞう。
創造力	そうぞうりょく。
創造的	そうぞうてき。
総則	そうそく。
相続	そうぞく。
相続税	そうぞくぜい。
相続人	そうぞくにん。
相続者	そうぞくしゃ。
相続権	そうぞくけん。
相対	そうたい。
総体	そうたい。
早退	そうたい。
壮大	そうだい。
相対的	そうたいてき。
相対性	そうたいせい。
相対論	そうたいろん。
送達	そうたつ。
争奪	そうだつ。
争奪戦	そうだつせん。
相談	そうだん。
相談員	そうだんいん。
相談役	そうだんやく。
装置	そうち。
送致	そうち。
装着	そうちゃく。
早朝	そうちょう。
総出	そうで。
想定	そうてい。
想定内	そうていない。
想定外	そうていがい。
争点	そうてん。
送電	そうでん。
送電線	そうでんせん。
送電網	そうでんもう。
相転移	そうてんい。
相当	そうとう。
相当量	そうとうりょう。
相当数	そうとうすう。
騒動	そうどう。
総動員	そうどういん。
遭難	そうなん。
遭難者	そうなんしゃ。
挿入	そうにゅう。
壮年	そうねん。
壮年部	そうねんぶ。
壮年期	そうねんき。
走破	そうは。
相場	そうば。
相場師	そうばし。
早発	そうはつ。
相反	そうはん。
早晩	そうばん。
装備	そうび。
装備品	そうびひん。
総評	そうひょう。
送付	そうふ。
送風	そうふう。
送風機	そうふうき。
送別	そうべつ。
送別会	そうべつかい。
双方	そうほう。
奏法	そうほう。
双方向	そうほうこう。
草本	そうほん。
総本家	そうほんけ。
総本山	そうほんざん。
走馬灯	そうまとう。
総務	そうむ。
総務部	そうむぶ。
総務部長	そうむぶちょう。
総務課	そうむか。
総務省	そうむしょう。
総目次	そうもくじ。
総目録	そうもくろく。
創薬	そうやく。
騒乱	そうらん。
騒乱罪	そうらんざい。
総理	そうり。
総理大臣	そうりだいじん。
創立	そうりつ。
創立者	そうりつしゃ。
僧侶	そうりょ。
送料	そうりょう。
総量	そうりょう。
総領事	そうりょうじ。
総力	そうりょく。
走力	そうりょく。
総力戦	そうりょくせん。
藻類	そうるい。
葬列	そうれつ。
滑走路	かっそうろ。
総和	そうわ。
挿話	そうわ。
疎開	そかい。
疎開先	そかいさき。
疎外	そがい。
阻害	そがい。
疎外感	そがいかん。
訴求	そきゅう。
即位	そくい。
即位式	そくいしき。
即応	そくおう。
即応性	そくおうせい。
促音	そくおん。
即死	そくし。
側室	そくしつ。
即日	そくじつ。
息女	そくじょ。
促進	そくしん。
促進剤	そくしんざい。
促進法	そくしんほう。
即身仏	そくしんぶつ。
促成栽培	そくせいさいばい。
即席	そくせき。
足跡	そくせき。
即戦力	そくせんりょく。
速達	そくたつ。
即断	そくだん。
測定	そくてい。
測定器	そくていき。
測定値	そくていち。
側転	そくてん。
速度	そくど。
速度計	そくどけい。
即答	そくとう。
側頭骨	そくとうこつ。
側頭葉	そくとうよう。
即売会	そくばいかい。
束縛	そくばく。
速報	そくほう。
速報値	そくほうち。
側面	そくめん。
側面図	そくめんず。
正面図	しょうめんず。
平面図	へいめんず。
測量	そくりょう。
測量士	そくりょうし。
測量船	そくりょうせん。
測量図	そくりょうず。
狙撃	そげき。
狙撃手	そげきしゅ。
底意地	そこいじ。
底板	そこいた。
素行	そこう。
祖国	そこく。
底力	そこぢから。
底値	そこね。
素材	そざい。
素材集	そざいしゅう。
粗雑	そざつ。
素子	そし。
阻止	そし。
組織	そしき。
組織図	そしきず。
組織的	そしきてき。
組織力	そしきりょく。
素質	そしつ。
粗品	そしな。
粗品用	そしなよう。
訴訟	そしょう。
素地	そじ。
訴状	そじょう。
疎水性	そすいせい。
素数	そすう。
組成	そせい。
素性	そせい。
手製	てせい。
祖先	そせん。
租税	そぜい。
粗相	そそう。
粗大	そだい。
措置	そち。
措置法	そちほう。
粗茶	そちゃ。
訴追	そつい。
卒園	そつえん。
卒園式	そつえんしき。
卒業	そつぎょう。
卒業式	そつぎょうしき。
卒業生	そつぎょうせい。
卒論	そつろん。
祖父	そふ。
祖母	そぼ。
祖父母	そふぼ。
素朴	そぼく。
粗末	そまつ。
素養	そよう。
微風	そよかぜ。
空色	そらいろ。
空耳	そらみみ。
空模様	そらもよう。
素粒子	そりゅうし。
算盤	そろばん。
損益	そんえき。
損壊	そんかい。
損害	そんがい。
尊敬	そんけい。
尊敬語	そんけいご。
尊厳	そんげん。
尊厳死	そんげんし。
存在	そんざい。
存在感	そんざいかん。
存在者	そんざいしゃ。
尊師	そんし。
損失	そんしつ。
損失額	そんしつがく。
損傷	そんしょう。
存続	そんぞく。
尊重	そんちょう。
村長	そんちょう。
損得	そんとく。
尊王	そんのう。
損保	そんぽ。
存亡	そんぼう。
村民	そんみん。
増員	ぞういん。
増益	ぞうえき。
憎悪	ぞうお。
増加	ぞうか。
造花	ぞうか。
増改築	ぞうかいちく。
増加率	ぞうかりつ。
増額	ぞうがく。
臓器	ぞうき。
臓器移植	ぞうきいしょく。
雑木林	ぞうきばやし。
増強	ぞうきょう。
象牙	ぞうげ。
造形	ぞうけい。
象牙質	ぞうげしつ。
造血	ぞうけつ。
増減	ぞうげん。
増減額	ぞうげんがく。
造語	ぞうご。
増刷	ぞうさつ。
増産	ぞうさん。
増資	ぞうし。
増収	ぞうしゅう。
増収増益	ぞうしゅうぞうえき。
贈収賄	ぞうしゅうわい。
蔵書	ぞうしょ。
増床	ぞうしょう。
増殖	ぞうしょく。
雑炊	ぞうすい。
造成	ぞうせい。
増税	ぞうぜい。
増税分	ぞうぜいぶん。
増設	ぞうせつ。
造船	ぞうせん。
造船所	ぞうせんじょ。
増大	ぞうだい。
増築	ぞうちく。
贈呈	ぞうてい。
贈呈式	ぞうていしき。
雑煮	ぞうに。
造反	ぞうはん。
造反者	ぞうはんしゃ。
増版	ぞうはん。
増便	ぞうびん。
増幅	ぞうふく。
増幅器	ぞうふくき。
増分	ぞうぶん。
造幣局	ぞうへいきょく。
贈与	ぞうよ。
贈与税	ぞうよぜい。
増量	ぞうりょう。
増量中	ぞうりょうちゅう。
贈賄	ぞうわい。
贈賄罪	ぞうわいざい。
続柄	ぞくがら。
族議員	ぞくぎいん。
俗語	ぞくご。
俗字	ぞくじ。
俗事	ぞくじ。
俗耳	ぞくじ。
続出	ぞくしゅつ。
俗称	ぞくしょう。
続伸	ぞくしん。
続落	ぞくらく。
俗人	ぞくじん。
俗世	ぞくせ。
属性	ぞくせい。
俗世間	ぞくせけん。
俗説	ぞくせつ。
続投	ぞくとう。
続発	ぞくはつ。
続編	ぞくへん。
続行	ぞっこう。
属国	ぞっこく。
存分	ぞんぶん。
存命	ぞんめい。
他愛	たあい。
他意	たい。
耐圧	たいあつ。
対案	たいあん。
大安	たいあん。
退位	たいい。
体位	たいい。
帯域	たいいき。
体育	たいいく。
体育館	たいいくかん。
体育祭	たいいくさい。
体育会	たいいくかい。
退院	たいいん。
退院後	たいいんご。
隊員	たいいん。
太陰暦	たいいんれき。
体液	たいえき。
対応	たいおう。
対応策	たいおうさく。
体温	たいおん。
体温計	たいおんけい。
退化	たいか。
対価	たいか。
大家	たいか。
大火	たいか。
耐火	たいか。
耐火性	たいかせい。
大化	たいか。
大河	たいが。
大会	たいかい。
大海	たいかい。
退会	たいかい。
対外	たいがい。
体外	たいがい。
大概	たいがい。
対角	たいかく。
体格	たいかく。
退学	たいがく。
退学者	たいがくしゃ。
対角線	たいかくせん。
体感	たいかん。
退官	たいかん。
耐寒	たいかん。
大観	たいかん。
体幹	たいかん。
対岸	たいがん。
耐寒性	たいかんせい。
待機	たいき。
耐久	たいきゅう。
耐久性	たいきゅうせい。
大気中	たいきちゅう。
待機中	たいきちゅう。
大義	たいぎ。
大儀	たいぎ。
大気圧	たいきあつ。
大気汚染	たいきおせん。
大気圏	たいきけん。
対義語	たいぎご。
待機児童	たいきじどう。
大器晩成	たいきばんせい。
大義名分	たいぎめいぶん。
退却	たいきゃく。
耐久力	たいきゅうりょく。
退去	たいきょ。
大魚	たいぎょ。
対局	たいきょく。
太極拳	たいきょくけん。
対極	たいきょく。
退局	たいきょく。
大局的	たいきょくてき。
大金	たいきん。
退勤	たいきん。
対空	たいくう。
待遇	たいぐう。
対偶	たいぐう。
退屈	たいくつ。
大群	たいぐん。
体形	たいけい。
体系	たいけい。
体系的	たいけいてき。
体験	たいけん。
体験談	たいけんだん。
体験版	たいけんばん。
体験会	たいけんかい。
体現	たいげん。
体言	たいげん。
体験型	たいけんがた。
大言壮語	たいげんそうご。
太古	たいこ。
退行	たいこう。
対抗	たいこう。
対抗戦	たいこうせん。
対向	たいこう。
対向車	たいこうしゃ。
対向車線	たいこうしゃせん。
大綱	たいこう。
対向性	たいこうせい。
退行性	たいこうせい。
耐候性	たいこうせい。
対抗馬	たいこうば。
対抗力	たいこうりょく。
大国	たいこく。
経済大国	けいざいたいこく。
大差	たいさ。
滞在	たいざい。
滞在中	たいざいちゅう。
滞在地	たいざいち。
体細胞	たいさいぼう。
対策	たいさく。
退散	たいさん。
大使	たいし。
大志	たいし。
胎児	たいじ。
退治	たいじ。
大使館	たいしかん。
体質	たいしつ。
退室	たいしつ。
退室時	たいしつじ。
体質的	たいしつてき。
体脂肪	たいしぼう。
体脂肪計	たいしぼうけい。
体脂肪率	たいしぼうりつ。
退社	たいしゃ。
代謝	たいしゃ。
貸借	たいしゃく。
貸借対照表	たいしゃくたいしょうひょう。
大樹	たいじゅ。
大衆	たいしゅう。
体臭	たいしゅう。
体重	たいじゅう。
体重計	たいじゅうけい。
大衆化	たいしゅうか。
大衆誌	たいしゅうし。
大衆性	たいしゅうせい。
大衆的	たいしゅうてき。
退出	たいしゅつ。
退出時	たいしゅつじ。
体循環	たいじゅんかん。
対処	たいしょ。
対照	たいしょう。
対照表	たいしょうひょう。
対象	たいしょう。
対象者	たいしょうしゃ。
対象物	たいしょうぶつ。
大賞	たいしょう。
対称	たいしょう。
大正	たいしょう。
退場	たいじょう。
対象化	たいしょうか。
対称性	たいしょうせい。
対照的	たいしょうてき。
対称的	たいしょうてき。
対称律	たいしょうりつ。
退職	たいしょく。
退職金	たいしょくきん。
退職者	たいしょくしゃ。
退職願	たいしょくねがい。
退職後	たいしょくご。
退色	たいしょく。
耐震	たいしん。
耐震性	たいしんせい。
退陣	たいじん。
対人	たいじん。
耐震壁	たいしんへき。
耐水	たいすい。
耐水性	たいすいせい。
対数	たいすう。
体制	たいせい。
大政奉還	たいせいほうかん。
態勢	たいせい。
大勢	たいせい。
体勢	たいせい。
耐性	たいせい。
大勢	たいぜい。
耐性菌	たいせいきん。
大西洋	たいせいよう。
体積	たいせき。
退席	たいせき。
堆積	たいせき。
堆積物	たいせきぶつ。
大切	たいせつ。
大雪	たいせつ。
対戦	たいせん。
大戦	たいせん。
世界大戦	せかいたいせん。
対戦車	たいせんしゃ。
体操	たいそう。
体操服	たいそうふく。
体操着	たいそうぎ。
怠惰	たいだ。
対談	たいだん。
退団	たいだん。
退団後	たいだんご。
退団者	たいだんしゃ。
体長	たいちょう。
体調	たいちょう。
体調不良	たいちょうふりょう。
隊長	たいちょう。
退庁	たいちょう。
大抵	たいてい。
大敵	たいてき。
大典	たいてん。
帯電	たいでん。
帯電体	たいでんたい。
態度	たいど。
対等	たいとう。
台頭	たいとう。
胎動	たいどう。
体得	たいとく。
体内	たいない。
胎内	たいない。
体内時計	たいないどけい。
対日	たいにち。
対日観	たいにちかん。
退任	たいにん。
退任後	たいにんご。
耐熱	たいねつ。
耐熱性	たいねつせい。
滞納	たいのう。
滞納者	たいのうしゃ。
滞納金	たいのうきん。
大破	たいは。
大敗	たいはい。
退廃的	たいはいてき。
体罰	たいばつ。
大半	たいはん。
胎盤	たいばん。
退避	たいひ。
対比	たいひ。
堆肥	たいひ。
待避所	たいひじょ。
対比的	たいひてき。
大病	たいびょう。
体表	たいひょう。
退部	たいぶ。
台風	たいふう。
台風一過	たいふういっか。
対物	たいぶつ。
帯分数	たいぶんすう。
太平	たいへい。
太平洋	たいへいよう。
太平記	たいへいき。
台北	たいぺい。
大変	たいへん。
対辺	たいへん。
逮捕	たいほ。
逮捕状	たいほじょう。
大砲	たいほう。
待望	たいぼう。
待望論	たいぼうろん。
大麻	たいま。
怠慢	たいまん。
対面	たいめん。
対面式	たいめんしき。
大命	たいめい。
体面	たいめん。
体毛	たいもう。
大役	たいやく。
対訳	たいやく。
貸与	たいよ。
太陽	たいよう。
太陽光	たいようこう。
太陽光発電	たいようこうはつでん。
太陽系	たいようけい。
太陽神	たいようしん。
太陽風	たいようふう。
太陽暦	たいようれき。
大乱	たいらん。
大陸	たいりく。
大陸間	たいりくかん。
大陸棚	たいりくだな。
大陸的	たいりくてき。
対立	たいりつ。
対流	たいりゅう。
滞留	たいりゅう。
大量	たいりょう。
大漁	たいりょう。
大量生産	たいりょうせいさん。
大漁旗	たいりょうばた。
体力	たいりょく。
大輪	たいりん。
隊列	たいれつ。
退路	たいろ。
対露	たいろ。
大老	たいろう。
対話	たいわ。
対話的	たいわてき。
台湾	たいわん。
他界	たかい。
多額	たがく。
多角	たかく。
多角化	たかくか。
多角的	たかくてき。
多角形	たかくけい。
多角形	たかっけい。
高菜	たかな。
高飛車	たかびしゃ。
高床	たかゆか。
宝島	たからじま。
宝船	たからぶね。
宝物	たからもの。
多感	たかん。
多汗症	たかんしょう。
多義	たぎ。
多義語	たぎご。
多義的	たぎてき。
多極化	たきょくか。
沢山	たくさん。
託児所	たくじしょ。
卓上	たくじょう。
宅配	たくはい。
宅配便	たくはいびん。
多芸	たげい。
竹細工	たけざいく。
多元	たげん。
多言	たげん。
他言	たげん。
多言語化	たげんごか。
多元的	たげんてき。
他校	たこう。
多項	たこう。
多項式	たこうしき。
他国	たこく。
多国間	たこくかん。
多国籍	たこくせき。
多国籍軍	たこくせきぐん。
他言	たごん。
多彩	たさい。
多才	たさい。
多剤耐性	たざいたいせい。
他殺	たさつ。
他殺体	たさつたい。
多事多難	たじたなん。
高温多湿	こうおんたしつ。
他社	たしゃ。
他者	たしゃ。
多重	たじゅう。
多種多様	たしゅたよう。
多趣味	たしゅみ。
多少	たしょう。
多色	たしょく。
多神教	たしんきょう。
多数	たすう。
多数決	たすうけつ。
代表制	だいひょうせい。
多数派	たすうは。
多勢	たぜい。
自薦	じせん。
他薦	たせん。
多足類	たそくるい。
太刀	たち。
立会人	たちあいにん。
立入禁止	たちいりきんし。
立入検査	たちいりけんさ。
達観	たっかん。
卓球	たっきゅう。
卓球台	たっきゅうだい。
宅建	たっけん。
宅建業	たっけんぎょう。
達人	たつじん。
達成	たっせい。
達成感	たっせいかん。
手綱	たづな。
達筆	たっぴつ。
竜巻	たつまき。
建具	たてぐ。
殺陣師	たてし。
縦社会	たてしゃかい。
縦長	たてなが。
横長	よこなが。
縦笛	たてぶえ。
横笛	よこぶえ。
縦棒	たてぼう。
横棒	よこぼう。
建前	たてまえ。
縦飯	たてめし。
横飯	よこめし。
建物	たてもの。
建屋	たてや。
立役者	たてやくしゃ。
縦横	たてよこ。
他店	たてん。
他党	たとう。
多頭	たとう。
他動詞	たどうし。
自動詞	じどうし。
多動	たどう。
多読	たどく。
七夕	たなばた。
谷間	たにま。
谷風	たにかぜ。
多肉	たにく。
多尿	たにょう。
他人	たにん。
他人事	ひとごと。
他人事	たにんごと。
多人数	たにんずう。
種油	たねあぶら。
種芋	たねいも。
種牛	たねうし。
種馬	たねうま。
種子島	たねがしま。
種火	たねび。
多年	たねん。
他念	たねん。
多年生	たねんせい。
多年草	たねんそう。
多能性	たのうせい。
多発	たはつ。
多発性	たはつせい。
田畑	たはた。
商人	あきんど。
旅心	たびごころ。
旅先	たびさき。
旅支度	たびじたく。
旅人	たびびと。
多病	たびょう。
一妻多夫	いっさいたふ。
一夫多妻	いっぷたさい。
多分	たぶん。
多聞	たぶん。
他聞	たぶん。
他方	たほう。
多忙	たぼう。
多方面	たほうめん。
卵形	たまごがた。
玉子	たまご。
玉子豆腐	たまごどうふ。
卵豆腐	たまごどうふ。
玉手箱	たまてばこ。
多面性	ためんせい。
多面体	ためんたい。
多面的	ためんてき。
多毛作	たもうさく。
多毛症	たもうしょう。
多目的	たもくてき。
多目的室	たもくてきしつ。
多様	たよう。
多種多様	たしゅたよう。
多様化	たようか。
他力本願	たりきほんがん。
多量	たりょう。
出血多量	しゅっけつたりょう。
単位	たんい。
単位数	たんいすう。
単位円	たんいえん。
単位系	たんいけい。
単位制	たんいせい。
単一	たんいつ。
短音	たんおん。
単音	たんおん。
短音階	たんおんかい。
長音階	ちょうおんかい。
炭化	たんか。
単価	たんか。
短歌	たんか。
担架	たんか。
炭化水素	たんかすいそ。
単科	たんか。
炭化物	たんかぶつ。
短観	たんかん。
嘆願	たんがん。
嘆願書	たんがんしょ。
短期	たんき。
短期大学	たんきだいがく。
短気	たんき。
短期間	たんきかん。
長期間	ちょうきかん。
短期金利	たんききんり。
探求	たんきゅう。
探求心	たんきゅうしん。
探究	たんきゅう。
短距離	たんきょり。
長距離	ちょうきょり。
探検	たんけん。
探検隊	たんけんたい。
探検家	たんけんか。
短剣	たんけん。
単元	たんげん。
短剣符	たんけんふ。
単語	たんご。
端午	たんご。
単語帳	たんごちょう。
単行本	たんこうぼん。
炭鉱	たんこう。
炭鉱夫	たんこうふ。
単項式	たんこうしき。
探査	たんさ。
単細胞	たんさいぼう。
淡彩画	たんさいが。
探索	たんさく。
短冊	たんざく。
短冊状	たんざくじょう。
炭酸	たんさん。
炭酸水	たんさんすい。
単三	たんさん。
炭酸塩	たんさんえん。
炭酸泉	たんさんせん。
端子	たんし。
短時間	たんじかん。
長時間	ちょうじかん。
単式	たんしき。
複式	ふくしき。
腹式	ふくしき。
短軸	たんじく。
長軸	ちょうじく。
短日	たんじつ。
単車	たんしゃ。
単射	たんしゃ。
全単射	ぜんたんしゃ。
全社	ぜんしゃ。
前者	ぜんしゃ。
全射	ぜんしゃ。
短銃	たんじゅう。
胆汁	たんじゅう。
短縮	たんしゅく。
短縮化	たんしゅくか。
短縮形	たんしゅくけい。
短縮版	たんしゅくばん。
単純	たんじゅん。
単純化	たんじゅんか。
短所	たんしょ。
長所	ちょうしょ。
短小	たんしょう。
短章	たんしょう。
誕生	たんじょう。
誕生日	たんじょうび。
誕生会	たんじょうかい。
誕生石	たんじょうせき。
単色	たんしょく。
単色光	たんしょくこう。
淡色	たんしょく。
単身	たんしん。
短針	たんしん。
単振動	たんしんどう。
淡水	たんすい。
炭水化物	たんすいかぶつ。
淡水魚	たんすいぎょ。
淡水湖	たんすいこ。
丹精	たんせい。
端正	たんせい。
胆石	たんせき。
胆石症	たんせきしょう。
単線	たんせき。
炭素	たんそ。
探測	たんそく。
短足	たんそく。
炭素鋼	たんそこう。
炭素税	たんそぜい。
単体	たんたい。
短大	たんだい。
探知機	たんちき。
探知	たんち。
単調	たんちょう。
短調	たんちょう。
探偵	たんてい。
探偵団	たんていだん。
端的	たんてき。
炭田	たんでん。
担当	たんとう。
担当者	たんとうしゃ。
担当者名	たんとうしゃめい。
短刀	たんとう。
単独	たんどく。
単独犯	たんどくはん。
単二	たんに。
担任	たんにん。
丹念	たんねん。
単年度	たんねんど。
堪能	たんのう。
短波	たんぱ。
単発	たんぱつ。
短髪	たんぱつ。
単発機	たんぱつき。
単品	たんぴん。
短文	たんぶん。
長文	ちょうぶん。
短編	たんぺん。
長編	ちょうへん。
短辺	たんぺん。
長辺	ちょうへん。
担保	たんぽ。
探訪	たんぼう。
端末	たんまつ。
端末機	たんまつき。
短命	たんめい。
長命	ちょうめい。
単名手形	たんめいてがた。
反物	たんもの。
単四	たんよん。
短絡的	たんらくてき。
単利	たんり。
福利	ふくり。
複利	ふくり。
鍛錬	たんれん。
代案	だいあん。
題意	だいい。
第一	だいいち。
第二	だいに。
第三	だいさん。
第一印象	だいいちいんしょう。
第一次世界大戦	だいいちじせかいたいせん。
第二次世界大戦	だいにじせかいたいせん。
大宇宙	だいうちゅう。
大運河	だいうんが。
大英断	だいえいだん。
大英帝国	だいえいていこく。
大英	だいえい。
大円	だいえん。
小円	しょうえん。
大王	だいおう。
大往生	だいおうじょう。
大恩	だいおん。
大音量	だいおんりょう。
大会社	だいがいしゃ。
大回転	だいかいてん。
大学	だいがく。
大学生	だいがく。
大学芋	だいがくいも。
大学院	だいがくいん。
大学院生	だいがくいんせい。
全入	ぜんにゅう。
大学寮	だいがくりょう。
大家族	だいかぞく。
代価	だいか。
大寒	だいかん。
代官	だいかん。
悪代官	あくだいかん。
代議	だいぎ。
代議員	だいぎいん。
代議士	だいぎし。
大吉	だいきち。
小吉	しょうきち。
中吉	ちゅうきち。
大凶	だいきょう。
大規模	だいきぼ。
大規模集積回路	だいきぼしゅうせきかいろ。
代休	だいきゅう。
代休日	だいきゅうび。
大胸筋	だいきょうきん。
大恐慌	だいきょうこう。
代金	だいきん。
引換	ひきかえ。
大工	だいく。
第九	だいく。
大宮司	だいぐうじ。
台形	だいけい。
大検	だいけん。
大学入学資格検定	だいがくにゅうがくしかくけんてい。
代行	だいこう。
大講堂	だいこうどう。
大好物	だいこうぶつ。
好物	こうぶつ。
大黒	だいこく。
大黒柱	だいこくばしら。
第五	だいご。
世代	せだい。
第五列	だいごれつ。
大根	だいこん。
大根足	だいこんあし。
台座	だいざ。
題材	だいざい。
代作	だいさく。
共和制	きょうわせい。
第三国	だいさんごく。
第一次	だいいちじ。
第二次	だいにじ。
第三次	だいさんじ。
第三者	だいさんしゃ。
台紙	だいし。
大師	だいし。
大字	おおあざ。
大事	だいじ。
大至急	だいしきゅう。
大司教	だいしきょう。
大事件	だいじけん。
大地震	おおじしん。
大自然	だいしぜん。
台車	だいしゃ。
代車	だいしゃ。
大車輪	だいしゃりん。
大主教	だいしゅきょう。
代書	だいしょ。
代償	だいしょう。
大小	だいしょう。
大証	だいしょう。
大丈夫	だいじょうぶ。
大小便	だいしょうべん。
大静脈	だいじょうみゃく。
大動脈	だいどうみゃく。
静脈	じょうみゃく。
動脈	どうみゃく。
大勝利	だいしょうり。
大臣	だいじん。
大震災	だいしんさい。
大人物	だいじんぶつ。
大豆	だいず。
台数	だいすう。
代数	だいすう。
代数学	だいすうがく。
代数式	だいすうしき。
代数的	だいすうてき。
大豆油	だいずゆ。
大前提	だいぜんてい。
代走	だいそう。
大卒	だいそつ。
代打	だいだ。
代替	だいたい。
代替品	だいたいひん。
大体	だいたい。
代替案	だいたいあん。
代替物	だいたいぶつ。
大打撃	だいだげき。
大多数	だいたすう。
大胆	だいたん。
大胆不敵	だいたんふてき。
大地	だいち。
大腸	だいちょう。
大腸菌	だいちょうきん。
台帳	だいちょう。
大腸炎	だいちょうえん。
大天使	だいてんし。
大都	だいと。
大都会	だいとかい。
大同	だいどう。
大道芸	だいどうげい。
大道芸人	だいどうげいにん。
大同小異	だいどうしょうい。
大統領	だいとうりょう。
代読	だいどく。
台所	だいどころ。
大都市	だいとし。
大納言	だいなごん。
第一審	だいいっしん。
第二審	だいにしん。
世銀	せぎん。
大日本	だいにっぽん。
大日本	だいにほん。
大日本史	だいにほんし。
代入	だいにゅう。
大脳	だいのう。
小脳	しょうのう。
代納	だいのう。
大納会	だいのうかい。
大脳皮質	だいのうひしつ。
台場	だいば。
第八	だいはち。
大八	だいはち。
大八車	だいはちぐるま。
人力車	じんりきしゃ。
大発会	だいはっかい。
代筆	だいひつ。
代筆者	だいひつしゃ。
代表	だいひょう。
代表者	だいひょうしゃ。
代表取締役	だいひょうとりしまりやく。
取締役	とりしまりやく。
代表権	だいひょうけん。
代表作	だいひょうさく。
代表的	だいひょうてき。
理事	りじ。
代品	だいひん。
大福	だいふく。
大仏	だいぶつ。
大部分	だいぶぶん。
大分	だいぶ。
大草原	だいそうげん。
大便	だいべん。
小便	しょうべん。
大便器	だいべんき。
小便器	しょうべんき。
代弁	だいべん。
代弁者	だいべんしゃ。
大便所	だいべんじょ。
大法廷	だいほうてい。
大発作	だいほっさ。
小発作	しょうほっさ。
台本	だいほん。
大本営	だいほんえい。
大本山	だいほんざん。
大名	だいみょう。
大明神	だいみょうじん。
大魔王	だいまおう。
代務	だいむ。
題目	だいもく。
大目標	だいもくひょう。
題名	だいめい。
代名詞	だいめいし。
題目	だいもく。
大問	だいもん。
大門	だいもん。
代役	だいやく。
大躍進	だいやくしん。
代用	だいよう。
代用品	だいようひん。
大容量	だいようりょう。
代用食	だいようしょく。
第四	だいよん。
大理石	だいりせき。
内裏	だいり。
代理	だいり。
代理人	だいりにん。
代理業	だいりぎょう。
代理権	だいりけん。
代理店	だいりてん。
代理母	だいりはは。
大流行	だいりゅうこう。
大連立	だいれんりつ。
第六	だいろく。
第六感	だいろっかん。
第六回	だいろっかい。
第五回	だいごかい。
第四回	だいよんかい。
第三回	だいさんかい。
第二回	だいにかい。
第一回	だいいっかい。
