# 「基本辞書データ（漢字、自由）.tsv」片山博文MZ
# This file is public domain software.
一万円札	福沢諭吉が描かれたお札。
一世一代	一生に一度あるかないかの、大切なこと。
一丸	ヒトかたまり。「○○となって戦う」
一人前	成人ヒトリ分。「○○○の仕事をしろよ」
一人旅	ヒトリタビ。
一件落着	このケンは○○○○だ。
一任	ここは、ヒトつ、マカせた。
一体感	ヒトつにまとまったカンじ。
一例	ヒトつの具体的なレイ。
一億	イチ万のイチ万倍。
一兆	イチ億のイチ万倍。
一光年	イチネン間でヒカリが進む距離。
一円玉	イチ番金額の小さい、日本の硬貨。
一刀両断	細かいことにこだわらず、思い切って決めること。
一切	残らず。すべて。「○○関与しない」
一刻千金	わずかな時間でも、大きな価値を持っていること。
一割	10％。
一向	イッコウ。「○○に改善しない」
一周	ひとまわり。
一味	「盗賊のイチミ」
一回転	ひとまわり。
一国一城	ほかからあれこれ言われることなく、しっかり独立していること。
一国二制度	イッコクニセイド。
一場面	ワンシーン。
一塁	イチルイ。
一変	すっかりカわること。「情勢が○○する」
一夜	イチヤ。ヒト晩。
一大事	重ダイな出来ゴト。「これは○○○だ！」
一姫二太郎	イチヒメニタロウ。
一字一句	文の中の、ほんのわずかな一つ一つの言葉のこと。
一存	ヒト人だけの考え。「私の○○では決めかねる」
一学期	イチガク年を分けたキ間。
一安心	ちょっとアンシンすること。「これで○○○だ」
一家	ヒトつのイエ。
一家心中	カ族全員が自殺すること。
一帯	ある地域全体。イッタイ。
一年契約	イチネンケイヤク。
一年生	最初の学ネンの学生。
一心不乱	一つのことに集中してわき目をふらないこと。
一心同体	心が一つになって、力を合わせること。
一応	充分とはいえないが、ヒトとおり。
一念発起	あることをなしとげようと決心すること。
一方通行	道路がイチホウ向のみしかツウコウできないこと。
一日	イチニチ。
一日千秋	イチニチが1000年のように、ひじょうに長く感じられること。
一昔	ヒトムカシ。
一月	イチ年で最初のツキ。
一服	お茶やタバコを一回飲むこと。
一朝一夕	わずかな期間のこと。
一期一会	人との出会いは一生で一度のことなので大切にしなければならないということ。
一杯	コップなどについだ分量。
一枚岩	イチマイイワ。
一様	みんな同じヨウすであること。
一次方程式	イチジホウテイシキ。
一歩前進	ヒトつマエにススむこと。
一流	その分野で第イッ等の地位。第イッ級。
一生	ウまれてから死ぬまで。
一番	最初。
一番星	最初に光った星。
一目	イチ度だけ、またはちょっと見ること。
一目散	必死に走って行くさま。「○○○に逃げ出す」
一直線	イッ本のチョクセン。
一瞬	イッシュン。
一石二鳥	一つのことをすることによって、二つの目的を果たすこと。
一神教	ただヒトつのカミを信仰する宗キョウ。
一等	イットウ。イチ番目の順位。
一等賞	イットウショウ。
一糸	ごくわずかなことのたとえ。「○○乱れず」「○○まとわず」
一網打尽	悪人などを、一度に全部つかまえること。
一緒	「ずっと○○だよ」
一群	ヒトつのムれ。
一致	ぴったり合うこと。
一般人	普通のヒト。
一般会計	イッパンカイケイ。
一般会計補正予算	イッパンカイケイホセイヨサン。
一般常識	イッパンジョウシキ。
一般教書演説	イッパンキョウショエンゼツ。
一般競争入札	イッパンキョウソウニュウサツ。
一般職	イッパンショク。
一般討論	イッパントウロン。
一般質問	イッパンシツモン。
一般道路	料金を取らない普通のドウロ。
一見	少しミたところでは。
一触即発	今にも事件や事故が起きそうなこと。
一身上	その人自シンのミのウエや境遇に関すること。
一輪	車リンがヒトつのみ。
一輪車	車リンがヒトつのみのクルマ。
一週間	イッシュウカン。
一進一退	良くなったり悪くなったりをくり返すこと。
一部	イチブ。あるブ分。
一部始終	はじめから終わりまで。
一酸化炭素	不完全燃焼で発生する有毒ガス。
一長一短	良いところもあるが、悪いところもあるということ。
七五三	11月15日に子どもの成長を祝う行事。
七味唐辛子	ナナつのアジがするトウガラシ。
七夕	タナバタ。
七夕祭	タナバタマツリ。
七日	ナノカ。
七月	七夕と海の日があるツキ。
七福神	フクをもたらすといわれるナナ人のカミ。
七草	ナナ種類のクサ。
七転八倒	のたうちまわって苦しむこと。
七面鳥	アメリカでクリスマスのときに食べられるトリの仲間。
万一	あまりありえないことだが、もしものとき。
万事	ほとんどすべてのことが。
万人	多くのヒト。
万全	バンゼン。まったく完ゼンなこと。
万国	あらゆるクニ。
万年筆	マンネンヒツ。
万有引力	ニュートンが発見したチカラ。
万歩計	ホ数をカウントする機械。
万物	バンブツ。ありとあらゆるモノ。
万病	あらゆるヤマイ。
万能	あらゆることができる。
丈夫	しっかりしていて壊れないさま。
三世	モンキーパンチの「ルパン○○」。
三倍速	サンバイのハヤさ。
三原色	あらゆるイロのもととなるサン種類のイロ。
三味線	サン本の弦で演奏する和楽器。
三塁	サンルイ。
三大文明	メソポタミア・エジプト・インダス・黄河で栄えた。
三女	サン番目のジョ児。
三学期	サン番目のガッキ。
三寒四温	寒い日と暖かい日が数日ごとにくり返されること。
三年生	サンネン目のセイ徒。
三年間	一ネンカンのサン倍。
三拍子	ワンツースリー、ワンツースリー。
三振	スリーストライク。
三日	ミッカ。
三日月	ミカズキ。
三月	ひなまつりのあるツキ。
三権分立	立法ケン、司法ケン、行政ケンを分けること。
三次元	上下、左右、前後のサン方向に広がっていること。
三男	サン版目のダン児。
三等分	サン個にヒトしくワけること。
三角	ミッつのカド。
三角定規	30度、60度、90度。
三角州	河口に土砂がたまってできた扇形の陸地。
三角形	サン個の辺で囲まれた図形。
三角柱	底面がサンカク形の角チュウ。
三輪車	サン個の車リンがついたクルマ。
三連休	ミッ日間、レン続したキュウ日。
三重	ミッつ、カサなる。
三重県	紀伊半島の東側に位置する県。
三階	サン番目のカイ。
三面記事	サンメンキジ。
三面鏡	サンメンキョウ。
上下	ウエとシタ。
上下対称	上下をひっくり返ししても同じ図形。
上下関係	ウエとシタのカンケイ。
上京	東キョウ都にノボる。
上半期	1月1日～6月30日。
上半身	ウエハン分の体。
上司	組織において自分より役職がジョウ位となる人。
上品	ヒンがいいこと。
上場企業	ジョウジョウキギョウ。
上意下達	上の人の意見を下の者に伝えること。
上手	やり方がうまい。
上方修正	ジョウホウシュウセイ。
上昇	ノボってアガること。
上昇気流	ノボるキリュウ。
上映	エイ画を人々に見せること。ジョウエイ。
上機嫌	非常にキゲンが良いこと。
上水道	きれいなミズを運ぶスイドウ。
上流	川の流れにおいて源に近い方。
上流階級	社会のジョウ層部にある人々で構成されるカイキュウ。
上演	人々にエン劇・エン芸などを見せること。
上着	外側にキる服。
上空	高い高いソラのウエ。
上等	ウエのトウ級であること。
上級	ウエのキュウ。
上級生	ウエのキュウのセイ徒。
上記	ウエにシルしたこと。
上質	品シツが優れていること。
上辺	ウワベ。
上達	うまくなる。
上陸	リクにアがる。
下剤	便をやわらかくして排便を促進する薬ザイ。
下半期	7月1日～12月31日。
下半身	シタハン分の体。
下品	言動などに卑しさが感じられるさま。
下宿	一ヶ月以上の期間、シュク泊料を受けてシュク泊させる営業。
下山	ヤマをクダること。
下心	ココロの底でひそかに考えていること。
下手	やり方がまずいこと。
下方修正	カホウシュウセイ。
下校	学コウから家へ帰ること。
下水	汚いミズ。
下水道	汚いミズの通りミチ。
下流	川の流れにおいて、河口に近い方。
下準備	シタジュンビ。
下火	ヒの燃え方や流行などが弱まること。「カゼの流行も○○になった」
下着	内側にキる服。上ギの反対。
下級生	シタのキュウのセイ徒。
下絵	絵を描くためのシタがきのエ。
下線	文字のシタに引いたセン。
下見	ある事をする前に、あらかじめミておくこと。
下調	あらかじめチョウ査しておくこと。
下車	クルマをクダること。
下降	シタにオりていくこと。
下駄	歩くとすてきな音がなる日本独特のはき物。
不作	サク物があまりとれなかったこと。
不便	ベン利ではないこと。
不信感	フシンカン。
不健全	ケンゼンではないこと。
不健康	ケンコウ的ではないこと。
不備	充分にソナえていないこと。
不具合	グアイが悪いこと。
不利	条件・形勢などがよくないこと。
不利益	フリエキ。
不動産	土地と建物などのウゴかない財サン。
不動産事業	フドウサンジギョウ。
不動産会社	フドウサンガイシャ。
不動産投資	フドウサントウシ。
不動産株	フドウサンカブ。
不動産業	フドウサンギョウ。
不動産業者	フドウサンギョウシャ。
不十分	ジュウブンではないこと。
不参加	フサンカ。
不可抗力	抵コウできないチカラ。
不可欠	それが必要なこと。
不可能	できないこと。
不可解	原因がわからず、疑問が残ること。
不可逆	フカギャク。
不合格	ゴウカクしなかったこと。
不器用	上手ではないこと。
不在	その場にいないこと。
不始末	シマツが悪かったこと。
不安	アンシンではないこと。
不完全	カンゼンではないこと。
不完全燃焼	フカンゼンネンショウ。
不定	サダまらないこと。
不審	犯罪が疑われる怪しい様子。
不導体	熱や電気が伝わりにくい物タイ。
不平	満足できなくて心がおだやかでないこと。「○○不満を言う」
不平不満	自分の思っている通りにならないで、いらいらしていること。
不平等	フビョウドウ。
不幸	シアワせではないこと。
不必要	ヒツヨウではないこと。
不快	気持ち悪いこと。
不快指数	蒸し暑さを数値で表したもの。
不思議	予想外だな、おかしいなと思うこと。
不成立	セイリツしないこと。
不戦勝	タタカわずしてカつこと。
不手際	フテギワ。
不振	成績などがよくないこと。
不採用	サイヨウしないこと。
不支持率	フシジリツ。
不明	アキらかではないこと。
不景気	ケイキが悪いこと。
不条理	フジョウリ。
不機嫌	キゲンが悪いこと。
不正	タダしくないこと。
不正受給	フセイジュキュウ。
不正確	セイカクではないこと。
不正競争防止法	フセイキョウソウボウシホウ。
不正解	セイカイしなかったこと。
不正請求	フセイセイキュウ。
不正防止	フセイボウシ。
不死身	シなない体。
不毛	土地に作物が育たないさま。
不気味	ブキミ。
不治	ナオらないこと。
不治病	ナオらないビョウ気。
不況	景気が悪いこと。
不注意	チュウイが足りないこと。
不測	思ってもみないこと。
不満	マン足しないこと。
不潔	清ケツではないこと。
不燃性	モえないセイ質。
不用品	必要ないもの。
不用意	フヨウイ。
不登校	フトウコウ。
不登校児童	フトウコウジドウ。
不眠症	ネムれないショウ状。
不確定	はっきり決まっていないこと。
不細工	見た目がみにくい様子。
不経済	ケイザイ的でないこと。
不老不死	年をとらず、死にもしないこと。
不自然	普通と違っておかしい様子。
不自由	思い通りにならないこと。
不良	ヨくないこと。ならず者。
不良品	ヨくないもの。
不要	イらない。
不規則	キソク的ではないこと。
不親切	シンセツではないこと。
不言実行	あれこれ言わないでだまって行うこと。
不誠実	セイジツではないこと。
不調	チョウ子が悪いこと。
不買運動	商品などをカわないようにするウンドウ。
不起訴処分	フキソショブン。
不足	タりない。
不足気味	フソクギミ。
不透明感	フトウメイカン。
不通	交ツウ・ツウ信などが途絶えること。
不運	ウンが悪い。
不適切	テキセツではない。
不都合	ツゴウが悪い。
与党	政権を担当している政トウ。
与野党	ヨヤトウ。
世代	生まれた年の時期によって区別した年齢層。
世代交代	年齢の高い人を若い人で入れ替えること。
世帯	一つの住居で暮らす生計を同じくする集団。
世帯収入	セタイシュウニュウ。
世界	ワールド。
世界一	セカイでイチ番。
世界一周	地球をヒトまわり。
世界共通	セカイキョウツウ。
世界史	セカイの歴シ。
世界同時株安	セカイドウジカブヤス。
世界地図	セカイチズ。
世界市場	セカイシジョウ。
世界平和	セカイヘイワ。
世界情勢	セカイジョウセイ。
世界新記録	セカイシンキロク。
世界最大	セカイサイダイ。
世界有数	セカイユウスウ。
世界経済	セカイケイザイ。
世界経済危機	セカイケイザイキキ。
世界規模	セカイキボ。
世界記録	ワールドレコード。
世界選手権	セカイセンシュケン。
世界遺産	セカイイサン。
世相	ヨの中のありさま。「○○を反映」
世紀	キリスト誕生の年から100年単位の時代区画。
世紀末	セイキのスエ。
世話	面倒をみること。
世論	ヨロン。
世論調査	ヨロンチョウサ。
世辞	他人に対する愛想のよい言葉。「お○○はいりません」
世間	セケン。
世間体	セケンテイ。
世間話	セケンバナシ。
両側	リョウ方のガワ。
両岸	リョウ方のキシ。
両成敗	ケンカ○○○。
両手	右テと左テ。
両方	どちらも。
両替	お金の種類をカえること。
両替機	お金の種類をカえるキ械。
両生類	カエル、ヤモリ、トカゲなどの仲間。
両目	リョウ方のメ。
両立	「勉強と部活を○○させたい」
両者	リョウ方の人。
両親	リョウ方のオヤ。
両足	リョウ方のアシ。
両面印刷	リョウメンインサツ。
中世	封建制度が存在した時代。
中傷	悪口を言う。「誹謗○○」
中南米	チュウナンベイ。
中古品	使用してややフルくなったシナ物。
中古車	使用してややフルくなったクルマ。
中和	酸性とアルカリ性を混ぜると○○する。
中国	チャイナ。
中国人	チュウゴクジン。
中国人旅行客	チュウゴクジンリョコウキャク。
中国人民元	チュウゴクジンミンゲン。
中国人民解放軍	チュウゴクジンミンカイホウグン。
中国人民銀行	チュウゴクジンミンギンコウ。
中国人観光客	チュウゴクジンカンコウキャク。
中国企業	チュウゴクキギョウ。
中国共産党	チュウゴクキョウサントウ。
中国地方	鳥取県・島根県・岡山県・広島県・山口県。
中国政府	チュウゴクセイフ。
中国経済	チュウゴクケイザイ。
中国製	Made in China.
中国語	チュウゴクゴ。
中央	ある物や場所などのまんナカの位置。
中央分離帯	チュウオウブンリタイ。
中央政府	チュウオウセイフ。
中央線	センターライン。
中学受験	チュウガクジュケン。
中学校	小ガッコウの次は？
中学生	チュウガッ校のセイ徒。
中小企業	チュウ規模・ショウ規模のキギョウ。
中年	４０歳前後。
中庭	ナカニワ。
中心	まんナカ。
中心地	まんナカの場所。
中心市街地	チュウオウシガイチ。
中心的存在	チュウシンテキソンザイ。
中性	酸性でもアルカリ性でもない。
中指	まんナカのユビ。
中断	続いている物事を途チュウでタち切ること。
中東	西アジアとアフリカ北東部の総称。
中東地域	チュウトウチイキ。
中東情勢	チュウトウジョウセイ。
中止	物事を途チュウでヤめること。
中毒	ドクにアタること。
中毒死	チュウドクになってシぬこと。
中空	ナカがカラっぽなこと。
中立	対立するどちらの側にも味方しないこと。
中立公正	チュウリツコウヘイ。
中立国	他の国家間の戦争に参加しない国家。
中絶	胎内の子どもを下ろすこと。
中継	ライブ放送。
中華	「世界のチュウ心」を意味する。「○○丼」
中華人民共和国	東アジア最大の国。
中華思想	チュウカシソウ。
中華料理	チュウ国のリョウリ。
中距離	チュウキョリ。
中途採用	チュウトサイヨウ。
中途採用者	チュウトサイヨウシャ。
中部	チュウブ。「○○地方」
中部地方	チュウブチホウ。
中間	物と物の間の空間や位置。「○○地点」
中間報告	チュウカンホウコク。
中間層	チュウカンソウ。
中間所得層	チュウカンショトクソウ。
中間決算	チュウカンケッサン。
中間管理職	チュウカンカンリショク。
中間貯蔵施設	チュウカンチョゾウシセツ。
中間選挙	チュウカンセンキョ。
丸太	皮をはいだだけのマルい木材。「○○小屋」
丸顔	マルガオ。
主人	マスター。
主人公	物語の中心人物。
主力	オモなチカラ。
主力産業	シュリョクサンギョウ。
主婦	既婚の女性で家庭の運営の責任者。
主将	キャプテン。
主導権	シュドウケン。
主張	自分の意見を他に認めさせようと強く言いハること。
主役	シュ要なヤク目。
主従	シュ人とジュウ者。「○○関係」
主権侵害	シュケンシンガイ。
主流	オモなナガれ。
主演	映画や演劇などでシュ役をエンじること。
主犯	ある犯罪行為の実行の中心となった者。
主義	常に抱いている考え。イズム。
主要	中心となっていて大切なこと。
主要通貨	シュヨウツウカ。
主要都市	シュヨウトシ。
主観的	自分だけの見方にとらわれているさま。
主語	「～は」「～が」にあたる、文の要素。
主題	メインテーマ。
主食	食事の中心として主要なエネルギー源となる食物のこと。
乗務員	ジョウムイン。
乗客	ジョウキャク。
乗用車	ジョウヨウシャ。
乗車	クルマにノること。「○○券」
乗車券	ジョウシャケン。
乗車口	ジョウシャグチ。
乗車駅	ジョウシャエキ。
乗馬	ウマにノること。
九州	福岡県・長崎県・鹿児島などがある大きな島。
九州地方	福岡県・長崎県・鹿児島などがあるチ域。
九州場所	キュウシュウバショ。
九日	ココノカ。
九月	敬老の日のあるツキ。
乱入	無関係な人が紛れ込むこと。
乱反射	ランハンシャ。
乱射	むちゃくちゃに弾丸や矢を飛ばすこと。
乱暴	ランボウ。
乱暴者	ランボウモノ。
乱発	むやみにハッ行すること。
乱立	むやみにタち並ぶこと。
乱視	眼球がゆがんでいて焦点が合わないさま。
乱雑	ミダれていて秩序がないこと。
乳児	生後0日から満1歳未満までの子。
乳化剤	ニュウカザイ。
乳房	おっぱい。
乳歯	子どもの時に生える歯。
乳母	母親に代わって子育てをする女性のこと。
乳母車	ウバグルマ。
乳液	ニュウ状のエキ体化粧品のこと。
乳牛	ギュウニュウを作り出すウシ。
乳製品	ニュウセイヒン。
乳首	チクビ。
乾杯	合図に合わせて酒を飲む儀式。
乾燥	水分が抜けた状態。
乾燥機	カンソウキ。
乾物	カワいたモノ。
乾電池	カンデンチ。
了解	ＯＫ。リョウカイ。
予備	アラカジめ、ジュン備しておくこと。
予告	前もって知らせること。
予報	前もって予測して知らせること。「天気○○」
予定	行事や行動を前もって決めておいたこと。
予定地	ヨテイチ。
予定日	ヨテイビ。
予定表	ヨテイヒョウ。
予想	これから起こることを推し量ること。
予想外	ヨソウガイ。
予想金額	ヨソウキンガク。
予感	これから起きそうなことをカンじ取ること。
予断	なりゆきを前もって判断すること。「○○を許さない情勢」
予測	将来の状態を前もっておしはかること。
予知能力	ヨチノウリョク。
予算	ヨサン。
予算委員会	ヨサンイインカイ。
予算成立	ヨサンセイリツ。
予算案	ヨサンアン。
予算編成	ヨサンヘンセイ。
予算規模	ヨサンキボ。
予算配分	ヨサンハイブン。
予約	前もってヤク束すること。
予習	まだナラっていないことを前もって勉強すること。
予行	練習のために前もって行うこと。「○○演習」
予言	未来のことをイうこと。
予選	出場権を賭けた戦い。
予防	悪いことがおきないように前もってフセぐこと。
予防医学	ヨボウイガク。
予防接種	ヨボウセッシュ。
事件	人々の関心をひく出来ゴト。
事件簿	ジケンボ。
事例	実際に起こった出来ゴト。ケース。
事前	物ゴトの行われるマエや起こるマエ。
事務	書類の作成や整理などを行う仕ゴト。
事務処理	ジムショリ。
事務効率化	ジムコウリツカ。
事務所	ジムショ。
事務用品	ジムヨウヒン。
事務職	ジムショク。
事実	現ジツに起こり，または存在するコト柄。
事実誤認	ジジツゴニン。
事情	物ゴトがある状態に至るまでの理由や経緯。
事態収束	ジタイシュウシュウ。
事故	思いかけず起こった悪い出来ゴト。
事故死	ジコシ。
事故物件	ジコブッケン。
事業	組織・会社などを経営する仕ゴト。
事業拡大	ジギョウカクダイ。
事業者	ジギョウシャ。
事業計画	ジギョウケイカク。
二世帯住宅	ニセタイジュウタク。
二刀流	両手にカタナを持って攻守を行うスタイル。
二十一世紀	2001年から2100年までの100年間。
二十世紀	1901年から2000年までの100年間。
二十四節気	ニジュウシセッキ。
二十日	ハツカ。
二塁	ニルイ。
二大政党制	ニダイセイトウセイ。
二学期	ニガッキ。
二年生	ニネンセイ。
二日	フツカ。
二月	節分とバレンタインデーのあるツキ。
二枚目	やさ男の美男子。
二次創作物	ニジソウサクブツ。
二次災害	ニジサイガイ。
二等分	線分、角、数量などをフタつのヒトしい部分にワけること。
二等分線	線分や角度をニトウブンする直セン。
二等辺三角形	２ヘンがヒトしいサンカッケイ。
二者択一	フタつのうちどちらかヒトつを選ばなければならないこと。
二足歩行	ニソクホコウ。
二酸化炭素	ＣＯ２。
二酸化炭素排出量	ニサンカタンソハイシュツリョウ。
二重	ダブル。
二重人格	ニジュウジンカク。
二階	地面よりも一つ上のカイ層。
互角	優劣の差がないこと。「○○の勝負」
五人組	ゴニングミ。
五体満足	ゴタイマンゾク。
五兆円	千億エンかけるゴ十は？
五分五分	ゴブゴブ。
五十歩百歩	ゴジッポヒャッポ。
五十音順	ゴジュウオンジュン。
五千円札	樋口一葉が描かれたお札。
五年生	ゴネンセイ。
五感	視覚、聴覚、触覚、味覚、嗅覚。
五日	イツカ。
五月	子どもの日があるツキ。
五月雨	サミダレ。
五角形	5つの頂点と辺を持つ多角形の総称。
五輪	オリンピック。
井戸	地下水、温泉などをくみ上げるための設備。
井戸水	イドミズ。
井戸端	世間話に花が咲く「○○○会議」。
井戸端会議	イドバタカイギ。
亜熱帯	ネッタイに次いで気温の高い地域のこと。
亜熱帯気候	アネッタイキコウ。
亜鉛	元素記号Zn。必須ミネラル。摂取しないと味覚障害に。
亡命	政治的な事情で他国に逃れること。
亡国	クニをほろぼすこと。ほろんだクニ。
亡者	執念にとりつかれた人。「金の○○」
交互	たがいちがい。
交付	公の機関が書類や金品などを引き渡すこと。「証明書を○○する」
交付金	コウフキン。
交代	互いに入れ替わること。
交友関係	コウユウカンケイ。
交差	マジわること。「○○点」
交差点	コウサテン。
交換	互いにやり取りすること。「○○日記」
交換日記	コウカンニッキ。
交流	時間とともに周期的に向きが変化する電流。ＡＣ。
交流戦	コウリュウセン。
交渉	ある事を実現するために，当事者と話し合うこと。
交点	マジわるテン。
交通	人や物が物理的に行きカうこと。
交通事故	コウツウジコ。
交通事故死	コウツウジコシ。
交通弱者	コウツウジャクシャ。
交通手段	コウツウシュダン。
交通整理	コウツウセイリ。
交通機関	コウツウキカン。
交通渋滞	コウツウジュウタイ。
交通規則	コウツウキソク。
交通違反	コウツウイハン。
交際	人と人がつきあうこと。
交際宣言	コウサイセンゲン。
京大	キョウ都ダイ学。
京都府	古きミヤコを有する、近畿地方の都道フ県。
京都議定書	キョウトギテイショ。
人一倍	普通の人以上であること。「○○○努力する」
人事	ジンジ。
人事制度	ジンジセイド。
人事異動	ジンジイドウ。
人件費	ジンケンヒ。
人体	ヒトのカラダ。
人出	人が多く出てそこに集まること。ヒトデ。
人前	ヒトビトのマエ。
人力車	ジンリキシャ。
人口	ヒトの数。
人口増加	ジンコウゾウカ。
人口密度	ジンコウミツド。
人口密集地域	ジンコウミッシュウチイキ。
人口流出	ジンコウリュウシュツ。
人口減対策	ジンコウゲンタイサク。
人口減少	ジンコウゲンショウ。
人口減少対策	ジンコウゲンショウタイサク。
人口減社会	ジンコウゲンシャカイ。
人口調査	ジンコウチョウサ。
人命	ヒトのイノチ。
人工呼吸	ジンコウコキュウ。
人工心臓	ジンコウシンゾウ。
人工物	ジンコウブツ。
人工着色料	ジンコウチャクショクリョウ。
人工血管	ジンコウケッカン。
人工衛星	ジンコウエイセイ。
人工関節	ジンコウカンセツ。
人差指	ヒトサシユビ。
人形	紙・木・土などで，人間の形に作ったもの。
人情	ヒトとしての情け。他ニンへの思いやり。
人手	ヒトのテ。
人手不足	ヒトデブソク。
人数	ヒトのカズ。
人文字	ヒトモジ。
人望	他人から寄せられる信頼・崇拝・期待の念。
人材	才能があり、役に立つジン物。
人材不足	ジンザイブソク。
人材交流	ジンザイコウリュウ。
人材派遣	ジンザイハケン。
人材確保	ジンザイカクホ。
人材育成	ジンザイイクセイ。
人格	独立した個ジンとしてのニン間性。キャラクター。
人格者	ジンカクシャ。
人権	幸せに生きるためのケン利。
人権侵害	ジンケンシンガイ。
人殺	ヒトゴロし。
人民元	ジンミンゲン。
人気	好意や関心の的になること。
人気俳優	ニンキハイユウ。
人気商品	ニンキショウヒン。
人気者	ニンキモノ。
人災	ヒトの不注意・怠慢などが主な原因で起こるサイ害。
人為的	ジンイテキ。
人物	ヒト。「登場○○」
人生	ヒトのイき様。ニン間がウまれてから死ぬまで。
人目	ヒトの見るメ。「○○を避けて」
人相	ヒトの顔つき。
人種	ヒトを身体上の特徴によって分類したもの。
人種差別	ジンシュサベツ。
人脈	人々の社会的なつながり。
人質	ヒトジチ。
人質事件	ヒトジチジケン。
人質解放	ヒトジチカイホウ。
人身売買	ジンシンバイバイ。
人造人間	ロボット。
人道的観点	ジンドウテキカンテン。
人間	ニンゲン。
人間社会	ニンゲンシャカイ。
人間関係	ニンゲンカンケイ。
人類	ジンルイ。
人骨	ジンコツ。
人魚	上半身が人間で、下半身が魚である想像上の生物。
今回	コンカイ。
今夜	コンヤ。
今年	コトシ。
今度	コンド。
今後	コンゴ。
今日	キョウ。このヒ。
今晩	コンバン。
今月	現在のツキ。
今週	現在のシュウ。
介入	当事者以外の者がハイり込むこと。
介護職	カイゴショク。
介護職員	カイゴショクイン。
介護費用	カイゴヒヨウ。
仏像	ホトケのゾウ。
仏前	ホトケのマエ。
仏教	ブッダが説いた教え。
仏教徒	ブッダが説いた教えに従う人。
仏様	ホトケの敬称。
仏頂面	無愛想で不機嫌な顔。ブッチョウヅラ。
仕事	すること。しなくてはならないこと。
仕事内容	シゴトナイヨウ。
仕事量	シゴトリョウ。
仕入	再販売を目的として商品を購入すること。
仕方	シカタ。
仕業	「あいつの○○に違いない」
他人	ホカのヒト。
他力	タ人のチカラ。
他国	ホカのクニ。
他殺	タ人にコロされたこと。
他言	秘密などを他の人に話すこと。「○○は無用」
付加価値	フカカチ。
付属	フゾク。
付根	物と物がくっツいているネ元の部分。
付着	くっツくこと。
付着物	くっツいたモノ。
付近	フキン。
付録	フロク。
代名詞	「あれ」「これ」「それ」
代物	シロモノ。
代理	そのヒトにカわって物事を処理すること。「○○人」
代理人	そのヒトにカわって物事を処理するヒト。
代理出産	ダイリシュッサン。
代理母	ダイリハハ。
代用	カわりに使うこと。
代用品	カわりになるもの。
代行	カわって事をオコナうこと。「運転○○」
代表	全体の状態や性質などを、一つのものだけでよく表すこと。
代表作	サク者の特色を最もよく表したサク品。
代表取締役	会社をダイヒョウする権限を持つトリシマリヤク。
代表者	機関やグループに代わって、その考え・意見を外部に表す人。
代表質問	ダイヒョウシツモン。
代表選手	ダイヒョウセンシュ。
代議士	ダイギシ。
代金	品物の買い手が売り手に支払う金。ダイキン。
代金引換	ダイキンヒキカエ。
以上	「x≧0」は、エックスがゼロ○○であることを表す。
以下	「x≦0」は、エックスがゼロ○○であることを表す。
以内	ある数量がある範囲に含まれていること。
以前	イゼン。「○○はやさしかったのに」
以外	そのホカであること。そのホカのもの。 
以後	「○○、気をつけます」
以心伝心	だまっていても相手に気持ちがツタわること。
以来	それよりのち。イライ。
以降	それよりのち。イコウ。
仮名	カナ。
仮定	カリに決めること。カテイ。
仮想敵	カソウテキ。
仮死	一見シんだように見える状態。「○○状態」
仮死状態	カシジョウタイ。
仮病	ケビョウ。
仮眠	カミン。
仮称	カリに付けた名前。
仮設	カリにセッ置すること。「○○トイレ」
仮設住宅	カセツジュウタク。
仮説	セツ明のための基本的なカ定。
仮面	マスク。
仲人	ナコウド。
仲介業者	チュウカイギョウシャ。
仲間	ある物事を一緒になってする者。同じ種類。
件数	ケンスウ。
任務	課せられた仕事。ミッション。
任命	ある官職や役目に就くようメイじること。
任期	その役職に就任するキ間のこと。
任期満了	ニンキマンリョウ。
企業	経済活動を行う経済主体。
企業価値	キギョウカチ。
企業倒産	キギョウトウサン。
企業献金	キギョウケンキン。
企業秘密	キギョウヒミツ。
企業経営	キギョウケイエイ。
企業統治	キギョウトウチ。
企業買収	キギョウバイシュウ。
企画	新しく事柄や催し物を計画すること。
企画書	キカクショ。
休刊	定期カン行物が、ある期間カン行を休むこと。
休場	ヤスんで出ジョウしないこと。
休学	ガッ校をヤスむこと。
休息	イキぬき。
休日	ヤスむヒ。
休校	学コウをヤスむこと。
休業	仕事をヤスむこと。
休業日	仕事をヤスむヒ。
休養	仕事などをヤスんで体力・気力をヤシナうこと。
会合	相談・討議などのために人が寄り集まること。カイゴウ。
会員	カイに加入している人や組織。
会員制	カイインセイ。
会員権	カイインのケン利。「ゴルフ○○○」
会場	カイ議や催し物などが開かれるバ所。
会社	カイシャ。
会社員	カイシャイン。
会見	改まった形で人に会うこと。「記者○○」
会計	金銭の収支を記録すること。
会話	二人以上が、互いにハナシ合うこと。「英○○」
会談	公的にアって話し合うこと。「首脳○○」
会議	カイギ。
伝承	受けついでツタえて行くこと。デンショウ。
伝授	師から弟子にツタえサズけること。
伝来	「16世紀に鉄砲が○○した」
伝染	病原体が別の個体へ移ること。
伝染病	デンセンビョウ。
伝票	デンピョウ。
伝統	慣習、形式などが受け継がれること。「○○工芸」
伝統工芸	デントウコウゲイ。
伝統芸能	デントウゲイノウ。
伝統行事	デントウギョウジ。
伝言	イいツタえること。「○○ゲーム」
伝言板	デンゴンバン。
伝説	人から人へと語り継いだ逸話の事。レジェンド。
似顔絵	ニガオエ。
位置	物のある所。場所。「テーブルの○○を変える」
位置情報	ＧＰＳ衛星との通信で確認。イチジョウホウ。
低下	ヒクくなること。テイカ。
低価格	テイカカク。
低価格商品	テイカカクショウヒン。
低品質	テイヒンシツ。
低姿勢	テイシセイ。
低所得層	テイショトクソウ。
低気圧	テイキアツ。
低温	ヒクいオン度。「○○やけどに気をつけて」
低燃費	テイネンピ。
低燃費車	テイネンピシャ。
低空	ヒクいソラ。「○○飛行」
低空飛行	テイクウヒコウ。
低血圧	テイケツアツ。
低迷	ヒクくただようこと。
低音	ヒクいオト。
住人	スんでいるヒト。ジュウニン。
住宅	人間が生活するための建物。ジュウタク。
住宅地	ジュウタクチ。
住宅市場	ジュウタクシジョウ。
住居	人間が生活するための建物。ジュウキョ。
住所	スんでいる場ショ。
住民	特定の土地に住む人。「○○税」
住民基本台帳	ジュウミンキホンダイチョウ。
住民票	ジュウミンに関する記録。
住職	寺の長である僧。ジュウショク。
佐賀県	九州地方の北西部にある県。
体内	カラダの中。
体内時計	タイナイトケイ。
体力	タイリョク。
体力測定	タイリョクソクテイ。
体型	カラダつき。肥満ガタ、やせガタなど。
体操	身タイを動かす運動をいう。「組み○○」
体操選手	タイソウセンシュ。
体格	カラダの形。「○○がいい」
体温	カラダのオン度。
体温計	タイオンケイ。
体積	空間においてある領域の占める広がりを表わす量。
体罰	肉タイ的苦痛を与えるようなバツ。
体育	タイイク。
体育館	タイイクカン。
体調	カラダのチョウ子。「○○が悪い」
体調不良	タイチョウフリョウ。
体調管理	タイチョウカンリ。
体質	カラダの性シツ。「風邪をひきやすい○○」
体重	カラダのオモさ。
体重計	タイジュウケイ。
体長	動物のカラダのナガさ。
体験	自分で実際に経験すること。「戦争○○」
体験記	タイケンキ。
体験談	タイケンダン。
余分	ヨブン。
余命	残された寿ミョウ。「○○一ヶ月」
余命宣告	ヨメイセンコク。
余地	アマっている土チ。空きチ。ゆとり。「同情の○○がない」
余熱	さめずに残っているネツ。「アイロンの○○を利用する」
余生	残されている人セイ。「○○を楽しく過ごす」
余白	紙面で何も記されないでシロく残っている部分。
余計	ヨケイ。「○○なことを言うな」
余談	本筋をはずれた話。「○○になるが」
作品	芸術活動などで製サクしたシナ。
作品募集中	サクヒンボシュウチュウ。
作家	詩や文章を書くことを職業とする人。
作成	主に書類や計画などをツクりととのえること。
作戦	サクセン。
作文	サクブン。
作曲	サッキョク。
作曲家	サッキョクカ。
作曲者	サッキョクシャ。
作業	サギョウ。
作業着	サギョウギ。
作法	サホウ。
作物	サクモツ。
作用	他に力や影響を及ぼすこと。
作用点	てこの原理で、力が働く場所。
作者	サクシャ。
作詞	歌シを作ること。
作詞家	サクシカ。
作話	ツクりバナシ。
使命	シ者として命ぜられたメイ令・任務。
使命感	シメイカン。
使用	ツカうこと。モチいること。
使用例	シヨウレイ。
使用料	シヨウリョウ。
使用禁止	シヨウキンシ。
使者	ツカいのモノ。
例外	原則にあてはまらないことやもの。
例年	いつものトシ。
例文	用レイ・レイ証として掲げるブン。
例話	タトえバナシ。
例題	練習や説明のためレイとして出す問ダイ。
供物	神や仏にソナえる飲食ブツその他のブッ品。
供給	必要に応じて，物を与えること。キョウキュウ。
供給先	キョウキュウサキ。
供給過剰	キョウキュウカジョウ。
供述	被告人・被疑者・証人が知覚した事実を述べること。
依存	それがなくては我慢できない状態。「○○症」
依存症	あることがやめられない、中毒になるショウ状。
依頼	他人に用件をタノむこと。
価値	役に立つ度合い。ネ打ち。「○○観」
価値観	カチカン。
価格	値段。カカク。
価格低迷	カカクテイメイ。
価格競争	カカクキョウソウ。
価格競争力	カカクキョウソウリョク。
価格表示	カカクヒョウジ。
侵入者	シンニュウシャ。
侵害	他人の権利・領土などをおかし、そこなうこと。「人権○○」
侵略	自衛以外の目的で、主権・領土などを侵すこと。
侵略戦争	シンリャクセンソウ。
侵略者	シンリャクシャ。
便乗	チャンスと見なして都合よく利用すること。「○○値上げ」
便乗値上	ビンジョウネアげ。
便利	都合のよいこと。役に立って具合のよいこと。
便所	トイレ。
係員	カカリイン。
俗語	標準からはずれている言葉。ゾクゴ。
俗説	世間で認められている、根拠のはっきりしないセツ。
保健	ケン康を守りタモつこと
保健体育	ホケンタイイク。
保健室	ホケンシツ。
保健所	ホケンジョ。
保存	そのままの状態でとっておくこと。
保存方法	ホゾンホウホウ。
保守	古くからの考え方・やり方を尊重し、改革に反対すること。
保守的	ホシュテキ。
保持	タモちつづけること。モちつづけること。「記録○○者」
保有株式	ホユウカブシキ。
保母	児童のホ育にあたる女子職員の俗称。保育士。
保温	オン度をタモつこと。
保湿効果	ホシツコウカ。
保留	その場ですぐに決めたり実行したりせずにのばすこと。
保管	預かってホ護・カン理すること。
保管物	ホカンしていたモノ。
保育	守りソダてること。
保育園	乳幼児をホイクする児童福祉施設。ホイクエン。
保育士	ホイクシ。
保育所	乳幼児をホイクする児童福祉施設。ホイクショ。
保育施設	ホイクシセツ。
保証	間違いがない、大丈夫であると認め、責任をもつこと。ホショウ。
保証人	ホショウニン。
保証書	ホショウショ。
保護	危険・破壊・困難などが及ばないように，かばい守ること。
保護主義	ホゴシュギ。
保護者	ホゴシャ。
保険	将来起こりうる危険に対し、○○○料を払って備えること。
保険会社	ホケンガイシャ。
保険制度	ホケンセイド。
保険料	ホケンリョウ。
保険料収入	ホケンリョウシュウニュウ。
保険証	ホケンショウ。
保険適用	ホケンテキヨウ。
保険金	ホケンキン。
保障	「安全○○」を略すると「安ポ」。
信号	特定の情報を伝達するもの。「交差点の○○機」
信号機	シンゴウキ。
信念	正しいとシンじ、堅固に守る自分の考え。「○○を貫く」
信用	人の言動や物事を間違いないとして、受け入れること。
信用情報	個人などのシンヨウにかかわるジョウホウ。
信用調査	シンヨウチョウサ。
信者	ある宗教をシンじる人。
信賞必罰	賞や罰をきちんと正確に与えること。
信頼	タヨりにしてシンじること。
信頼回復	シンライカイフク。
信頼関係	シンライカンケイ。
修学旅行	シュウガクリョコウ。
修復	破損した箇所を作り直すこと。
修正	間違ったところを直すこと。
修理	機械などの悪いところを直すこと。
修理品	機械などの悪いところを直したもの。
修行	習得・鍛錬・仏道などのために、心身を鍛えること。
俳人	ハイ句を詠むヒト。
俳優	せりふやしぐさなどを演じる人や職業。
俳句	五・七・五の短い詩。
倉庫	物品など貯蔵・保管するための建物。
倉庫番	ソウコのバン。
個人	コジン。私ジン。
個人主義	コジンの権利と自由を尊重することをシュ張する立場。
個人事業主	コジンジギョウヌシ。
個人差	ヒトによってサがあること。
個人情報	コジンに関係するジョウホウ。
個人情報保護法	コジンジョウホウホゴホウ。
個人投資家	コジントウシカ。
個人旅行	コジンリョコウ。
個人消費	コジンショウヒ。
個人経営	コジンケイエイ。
個人資産	コジンシサン。
個室	一人用の部屋。
個展	あるコ人の作品だけを集めたテン覧会。
個性	あるコ体に備わる独自の特徴である。
個数	いくつか。物や人のカズ。
倍増	二倍に増えること。「所得○○計画」
倍数	ある整スウの何バイかになっているカズ。
倍率	バイリツ。
倍速	バイのハヤさ。
倒産	会社などが破綻して経済活動ができなくなること。
倒立	さかダち。トウリツ。
借主	物品・金銭をカりるほうの人。
借地	土チをカりること。シャクチ。
借家	借りた状態の住宅のこと。シャクヤ。
借用書	シャクヨウショ。
借金	シャッキン。
借金問題	シャッキンモンダイ。
値千金	センキンのネ打ちがあること。
値打	ネウち。
値段	ネダン。
倹約	ケンヤク。
偉人	エラいヒトのこと。
偉大	優れて立派なさま。優れてオオきいさま。
偉業	すばらしい仕事やギョウ績。
停学処分	テイガクショブン。
停戦	合意の上で一時的にセン闘行為をテイ止すること。
停止	さしトめること。テイシ。
停車	クルマを短時間、トめること。
停電	デン気が途絶えること。
健全	身心が正常に働き、ケン康であること。ケンゼン。
健常者	障害シャや病人でなく、日常生活に支障のない人。
健康	体や心がすこやかであること。
健康保険	ケンコウホケン。
健康保険証	ケンコウホケンショウ。
健康問題	ケンコウモンダイ。
健康増進	ケンコウゾウシン。
健康寿命	ケンコウジュミョウ。
健康法	ケンコウホウ。
健康状態	ケンコウジョウタイ。
健康管理	ケンコウカンリ。
健康被害	ケンコウヒガイ。
健康診断	ケンコウシンダン。
健康食	ケンコウショク。
健康食品	ケンコウショクヒン。
健闘	不利な条件に屈せず、立派にたたかうこと。
側近	ソッキン。
側面	物の横のメン。
側面図	ソクメンズ。
偵察機	テイサツキ。
偶数	２で割り切れるカズ。
偶然	因果関係がなく、予期しないこと。「○○の一致」
偽名	ニセのナ前。
偽善	ゼン良であるようにイツワること。
偽善者	ギゼンシャ。
偽造	ニセ物を作ること。「○○免許証」「文書○○罪」
備品	ビヒン。
備長炭	ビンチョウタン。
債権回収	サイケンカイシュウ。
傷口	キズグチ。
傷害事件	ショウガイジケン。
傷害致死罪	ショウガイチシザイ。
傷心	悲しみにココロをいためること。ショウシン。
傾向	物事の状態が特定の方向にかたむくこと。
傾斜	ナナめになること。カタムいていること。
億万長者	オクやマンの単位の財産を持ったお金持ち。
優位	他の物よりもまさるイ置・地イ。
優先	サキにすべきこと。
優先席	ユウセンセキ。
優先順位	サキにすべきジュン番。
優勝	最後までカち残ること。
優勝劣敗	強い者が勝ち残り、おとった者はほろぶこと。
優勝旗	ユウショウした記念にもらうハタ。
優勢	勢い・形勢が他よりも勝っていること。
優秀作品	ユウシュウサクヒン。
優等生	スグれたセイ徒。
優良	スグれてヨいこと。
優遇	手厚くもてなすこと。
元値	商品の仕入れネ段。モトネ。
元凶	諸悪の根源。
元号	特定の年代に年を単位として付けられる称号。
元年	年号が改まった最初の年。「平成○○」
元手	モトデ。
元日	一年の最初のヒ。
元気	ゲンキ。
元祖	ある物事を最初に始めた人。ガンソ。
元素	化学的反応によってはそれ以上分解できない物質。
元素記号	ゲンソキゴウ。
元首	国家の長。「国家○○」
兄弟	アニとオトウト。キョウダイ。
兄貴	アニキ。
充実	足りない点や欠陥がなく、内容が豊富であること。
充実感	ジュウジツカン。
充満	ある空間にいっぱいにミちること。
充血	血管が拡張して赤く見える状態。「目の○○」
充電	デン気をたくわえること。
充電器	ジュウデンキ。
充電式	ジュウデンシキ。
兆候	物事の起こる前ぶれ。チョウコウ。
先人	昔のヒト。前の人。
先入観	センニュウカン。
先制点	センセイテン。
先取	サキにトること。サキドり。
先客	サキに来ていたキャク。
先手	他よりサキに始めること。「○○を取る」
先方	相手。センポウ。
先日	過去のあるヒ。センジツ。
先月	一つ前のツキ。
先物価格	サキモノカカク。
先物取引	サキモノトリヒキ。
先生	センセイ。
先着	サキにツくこと。「○○順」
先着順	センチャクジュン。
先祖	センゾ。
先端	長い物のいちばんハシの部分。
先端技術	センタンギジュツ。
先細	サキボソり。
先週	前のシュウ。前週。
先進国	センシンコク。
先頭	一番サキ。「○○に立って活躍する」
光化学	「○○○スモッグ」
光合成	水と二酸化炭素をでんぷんと酸素にする反応。
光景	目に映る景色や物事のありさま。コウケイ。
光栄	ほめられたり任されたりして、名誉に思うこと。コウエイ。
光源	ヒカリを発するもと。
光熱費	コウネツヒ。
光線	ヒカリが進む経路や方向を表すセン。
免税対象	メンゼイタイショウ。
免税店	旅行者に対して商品のゼイ金をメン除するミセ。
免許	メンキョ。
免許証	メンキョショウ。
児童	年少の人間。ジドウ。
児童数	ジドウスウ。
児童文学	ジドウブンガク。
児童相談所	ジドウソウダンショ。
党首	政トウの最高職。
入会	ニュウカイ。
入団	ニュウダン。
入国	クニにハイること。
入場	会ジョウ・式ジョウ・競技ジョウなどにハイること。
入場制限	ニュウジョウセイゲン。
入場券	ニュウジョウケン。
入場料	ニュウジョウリョウ。
入場無料	ニュウジョウムリョウ。
入場者	ニュウジョウシャ。
入場者数	ニュウジョウシャスウ。
入場行進	ニュウジョウコウシン。
入学	新ニュウ生としてガッ校にハイること。 
入学式	ニュウガクシキ。
入学試験	ニュウガクシケン。
入学願書	ニュウガクガンショ。
入居者	ニュウキョシャ。
入手	テにイれること。自分のものとすること。
入手困難	ニュウシュコンナン。
入浴	ニュウヨク。
入浴剤	ニュウヨクザイ。
入社	ニュウシャ。
入社試験	ニュウシャシケン。
入荷	ニュウカ。
入試	ニュウシ。
入試問題	ニュウシモンダイ。
入試対策	ニュウシタイサク。
入賞	ショウをもらうことのできる順位にハイること。
入退院	ニュウタイイン。
入選	ニュウセン。
入金	ニュウキン。
入金確認	ニュウキンカクニン。
入門	ニュウモン。
入門書	ニュウモンショ。
入院	治療を受けるため、病インに入って生活すること。
入院患者	ニュウインカンジャ。
入院生活	ニュウインセイカツ。
入隊	ニュウタイ。
全世界	ゼンセカイ。
全体	ゼンタイ。
全体主義	ゼンタイシュギ。
全力	スベてのチカラ。
全力投球	ゼンリョクトウキュウ。
全勝	試合やショウ負のスベてにカつこと。
全勝優勝	ゼンショウユウショウ。
全勝無敗	ゼンショウムハイ。
全員	所属しているスベての人。総イン。
全員帰国	ゼンインキコク。
全員集合	ゼンインシュウゴウ。
全国	クニゼン体。クニ中。
全国各地	ゼンコクカクチ。
全国平均	ゼンコクヘイキン。
全国消費者物価指数	ゼンコクショウヒシャブッカシスウ。
全国高校選手権	ゼンコクコウコウセンシュケン。
全快	病気がすっかりなおること。全治。
全敗	試合や勝負のスベてにヤブれること。
全日本選手権	ゼンニホンセンシュケン。
全日本高校選手権	ゼンニホンコウコウセンシュケン。
全治	病気がすっかりナオること。全快。
全然	ゼンゼン。
全焼	スベてヤくこと。
全盛	真っサカり。ゼンセイ。「○○期」
全盛期	ゼンセイキ。
全知全能	ゼンチゼンノウ。
全自動	ゼンジドウ。
全責任	ゼンセキニン。
全身	体じゅう。「○○の筋肉をときほぐす」
全速力	ゼンソクリョク。
全部	スベてのブ分。
全長	ゼン部のナガさ。
全面禁止	ゼンメンキンシ。
全額	ゼン部の金ガク。
全額負担	ゼンガクフタン。
八方美人	だれからもよく思われるように、要領よく付き合うヒト。
八日	ヨウカ。
八月	終戦記念日のあるツキ。
八百	数の多いもののたとえ。「うそ○○」
八百屋	ヤオヤ。
八百長	ヤオチョウ。
八重	ヤエ。「○○桜」
八重桜	ヤエザクラ。
八重歯	ヤエバ。
公倍数	２つ以上の正の整数の、それらに共通する倍数。
公共	社会全体に関すること。「○○施設」
公共事業	コウキョウジギョウ。
公共交通機関	コウキョウコウツウキカン。
公共団体	コウキョウダンタイ。
公共工事	コウキョウコウジ。
公共放送	コウキョウホウソウ。
公共料金	コウキョウリョウキン。
公共施設	コウキョウシセツ。
公務員	コウムイン。
公務員試験	コウムインシケン。
公園	コウエン。
公害	大気・水質・土壌などの汚染による社会的な災ガイ。
公害防止	コウガイボウシ。
公平	かたよることなく、すべてを同等に扱うこと。
公式	オフィシャル。
公式練習	コウシキレンシュウ。
公文書	コウブンショ。
公明正大	正しく堂々としていること。
公正	コウ平でタダしいこと。
公民館	コウミンカン。
公演	多数の人々の前で演劇・音楽などをエンじること。
公然	他人に隠さずおおっぴらにするさま。「○○わいせつ」
公用車	コウヨウシャ。
公的年金制度	コウテキネンキンセイド。
公的機関	コウテキキカン。
公益社団法人	コウエキシャダンホウジン。
公益通報者保護	コウエキツウホウシャホゴ。
公私	オオヤケとワタクシごと。「○○ともに」「○○混同」
公私混同	コウシコンドウ。
公立	地方コウ共団体によって設リツ、管理、運営されること。
公約	有権者に向けて表明するヤク束。
公約数	２つ以上の自然数について、そのいずれのヤクスウにもなることができる整スウ。
公衆	社会一般の人々。「○○トイレ」
公衆便所	コウシュウベンジョ。
公表	広く世間に発ピョウすること。
公言	広く世間に発ゲンすること。
公認会計士	コウニンカイケイシ。
公転	コウテン。「地球は太陽の周りを○○している」
公選法違反	コウセンホウイハン。
公開	広く一般にカイ放すること。
六十分	一時間は何プンか。
六十秒	一分は何ビョウか。
六年生	ロクネンセイ。
六年間	ロクネンカン。
六日	ムイカ。
六月	祝日のないツキ。
六角形	ロッ個の辺で囲まれた図形。
六角柱	底面がロッカッ形の角チュウ。
共同	一つの目的のために複数の人が力を合わせること。「○○作業」
共同体	キョウドウタイ。
共同作業	キョウドウサギョウ。
共同出資	キョウドウシュッシ。
共同声明	キョウドウセイメイ。
共同生活	キョウドウセイカツ。
共同研究者	キョウドウケンキュウシャ。
共同訓練	キョウドウクンレン。
共同運営	キョウドウウンエイ。
共同開発	キョウドウカイハツ。
共和国	キョウワコク。
共存	二つ以上のものが一緒に生ゾンしたりソン在したりすること。
共学	男子と女子が区別なく同じ教室でガク習すること。
共感	他者とカン情を共有すること。
共有	シェアすること。
共有財産	キョウユウザイサン。
共犯	二人以上の者が一つの犯罪に関与すること。
共産主義	キョウサンシュギ。
共通	キョウツウ。
共通化	キョウツウカ。
共通点	キョウツウテン。
共通語	キョウツウゴ。
兵力	ヘイリョク。
兵器	敵を殺傷・破壊する為の道具。
兵士	戦闘組織の構成員。ヘイシ。
兵庫県	ケン庁所在地が神戸市のケン。
兵役	軍務に服すること。ヘイエキ。
兵隊	ヘイ士をタイに編制した集団。軍タイ。
具体的	グタイテキ。例を挙げて詳しく。
具体策	グタイサク。
具合	活動や機能からみた物事の状態。「○○が悪い」
典型的	テンケイテキ。
兼任	一人で二つ以上の職務をカネること。ケン務。
兼務	一人で二つ以上の職ムをカネること。ケン任。
兼業	本業のかたわら他の仕事や営業を行うこと。
兼用	一つの物を二つ以上のヨウ途にあてること。
内出血	ナイシュッケツ。
内定者	ナイテイシャ。
内定辞退	ナイテイジタイ。
内容	ナイヨウ。
内容量	ナイヨウリョウ。
内密	ナイ緒・秘ミツにすること。「○○にする」
内幕	外からはわからないナイ部の事情。
内心	三角形のナイ接円の中シン。
内政干渉	ナイセイカンショウ。
内服薬	ナイフクヤク。
内気	人前ではきはきしない、キの弱い性質。
内申書	ナイシンショ。
内科	臓器を対象とし、手術によらない医学の一分野。
内職	本ショクとは別に、家の中で収入を得るためにする仕事。
内臓	ナイゾウ。「○○破裂」
内臓破裂	ナイゾウハレツ。
内蔵	周辺機器がコンピューターナイ部に格納されていること。
内訳	合計額に対して、その内容を項目ごとに分けたもの。明細。
内部	ナイブ。
内部告発	ナイブコクハツ。
内部告発者	ナイブコクハツシャ。
内部崩壊	ナイブホウカイ。
内部文書	ナイブブンショ。
内部犯行	ナイブハンコウ。
内閣	行政権を担当する合議制の機関。
内閣不信任	ナイカクフシンニン。
内閣府	ナイカクフ。
内閣支持率	ナイカクシジリツ。
内閣改造	ナイカクカイゾウ。
内閣発足	ナイカクホッソク。
内閣総理大臣	首相のこと。
円卓	まるいテーブル。
円周	エンのマワり。
円周率	π。
円安	エンヤス。
円形	エンケイ。丸いカタチ。
円柱	丸いハシラ。
円満	ミち足りていて、不満や争いのないこと。
円滑	言行が角立たず，なめらかなさま。
円相場	エンソウバ。
円筒形	エントウケイ。
円運動	エンウンドウ。
円高	エンダカ。
冊子	書いたものや印刷したものをとじたもの。サッシ。
再三再四	何度も何度も。
再交付	サイコウフ。
再会	フタタびアうこと。
再入力	サイニュウリョク。
再契約	サイケイヤク。
再度	二度。フタタび。
再建	失われていたケン造物をフタタびタてること。
再挑戦	サイチョウセン。
再来	フタタびクること。
再来月	次の次のツキ。
再燃	一度消えた火がまたモえ出すこと。
再現	フタタびアラワすこと。
再生	リサイクル。
再生医療	サイセイイリョウ。
再生可能	サイセイカノウ。
再生紙	リサイクルペーパー。
再発	同じ病気や事故などがもう一度起こること。 
再発見	サイハッケン。
再発防止	サイハツボウシ。
再発防止策	サイハツボウシサク。
再稼動	サイカドウ。
再稼動反対	サイカドウハンタイ。
再考	同じ問題・課題などをもう一度カンガえなおすこと。
再起不能	サイキフノウ。
再選	サイ度エラばれること。
再開	いったんやめていた物事を再びハジめること。
再開発	サイカイハツ。
冒険	危ケンを伴うことをあえてすること。
冒険家	ボウケンカ。
写実	物事をありのままに文章や絵などに描くこと。
写生	実際の景色や物をありのままにウツしとること。
写真	シャシン。
写真代	シャシンダイ。
写真機	カメラ。
冬場	フユバ。
冬季	フユのキ節。トウキ。
冬将軍	フユショウグン。
冬眠	動物が活動力を低くした状態で越トウする現象。
冬至	北半球において日照時間が最も短くなる日。
冷凍	カチンカチンにコオらせること。
冷凍保管	レイトウホカン。
冷凍室	レイトウシツ。
冷凍庫	レイトウコ。
冷凍食品	レイトウショクヒン。
冷却	ツメたくすること。「○○スプレー」
冷害	例年よりもツメたい日が続く自然災ガイ。
冷戦	武力を用いない政治集団間の抗争。
冷戦時代	レイセンジダイ。
冷戦期	レイセンキ。
冷房	空間を適当な温度にヒヤやすこと。またはその装置。
冷気	ツメたい空キ。
冷水	ツメたいミズ。
冷蔵庫	レイゾウコ。
冷静	感情的にならずに、落ち着いているさま。
凍死	寒さに耐えられず、コオってシぬこと。
処分	不要な物などを捨てたり，他に売り払ったりすること。
処理	物事をさばいて始末をつけること。しまつ。
処理速度	ショリソクド。
処置	けがや病気の治療・手当てをすること。「応急○○」
凶器	人に危害を与え、殺害や傷害のために用いられる道具。
凶悪	性質が残忍で、ひどい行為をすること。「○○犯」
凶悪犯	キョウアクハン。
凶悪犯罪	キョウアクハンザイ。
凶暴	性質が残忍で非常に乱ボウなこと。「○○な犯人」
出世	シュッセ。
出世魚	シュッセウオ。
出入口	デイリグチ。
出刃包丁	デバボウチョウ。
出前	デマエ。
出力	処理結果を他の機器などに送信すること。
出動	活動するために出かけること。シュツドウ。
出勤	ツトめにでること。キン務先へデかけること。
出口	デグチ。
出口調査	デグチチョウサ。
出品	作ヒンなどをダすこと。 
出国	クニをデること。
出場	演技・競技などをするために，そのバ所へデること。 
出場停止	シュツジョウテイシ。
出家	家庭生活を捨てて仏門に入ること。
出席	会合に参加すること。学校の授業にデること。
出席者	シュッセキシャ。
出店	新たにミセをダすこと。
出張	業務のため、普通の勤務地とは違う場所に一日以上滞在すること。
出張中	シュッチョウチュウ。
出張日	シュッチョウビ。
出所	デドコロ。
出来事	イベント。
出来高	デキダカ。
出欠	シュッ席とケッ席、あるいはシュッ勤とケッ勤。
出没	「熊が○○しています。注意して下さい」
出港	船がミナトの外にデること。
出演	舞台・映画・放送などにデること。「○○者」
出演者	アクター。
出火	カ事をダすこと。カ災が起こること。
出版	印刷物を発行し、読者に販売・提供すること。
出版業界	シュッパンギョウカイ。
出版物	シュッパンブツ。
出版社	シュッパンシャ。
出版禁止	シュッパンキンシ。
出現	アラワれデること。
出生	ウまれること。シュッセイ。
出生届	シュッセイトドケ。
出生率	シュッセイリツ。
出産	ウむこと。シュッサン。
出産報告	シュッサンホウコク。
出産日	シュッサンビ。
出発	目的地へ向かってデかけること。
出発日	シュッパツビ。
出荷	ニを積みダすこと。
出荷時期	シュッカジキ。
出血	チがデること。「○○多量」
出血多量	シュッケツタリョウ。
出血熱	「エボラ○○○」
出費	シュッピ。
出身	出生地、卒業した学校、勤務先など。「広島○○」
出身地	シュッシンチ。
出頭	当人が役所や警察などにデ向くこと。「裁判所に○○する」
出題	問ダイをダすこと。
出題者	シュツダイシャ。
出馬	ウマに乗ってデかけること。
刃物	ハモノ。
分別	「ゴミを捨てる前にきちんと○○しよう」
分割	いくつかにワけること。「○○払い」
分子	ブン数の横線の上の部分。
分子生物学	ブンシセイブツガク。
分布	ブンプ。
分度器	角ドを測るためのキ具。
分担	「役割○○」
分数	ブン子とブン母を組み合わせたカズ。
分業	役割をブン担して作ギョウを行うこと。
分解	一つに結合しているものを、要素や部分にワけること。「空中○○」
分身	一人の忍者が二人、三人に。
分身術	一人の忍者が二人、三人に。
分野	ブンヤ。
分量	ブンリョウ。
分銅	天秤と一緒に使う、金属製のおもり。
分類	同ルイのものをまとめ、いくつかの集まりに区ブンすること。ルイ別。
切傷	キりキズ。
切口	キりクチ。
切実	身にしみて感じるさま。「○○な問題」
切手	キッテ。「郵便○○」
切捨	キりスて。
切断	物をタちキること。キり離すこと。
切札	キりフダ。
切株	キりカブ。
切腹	セップク。
切迫	さしせまっていること。「○○した問題」
切開	治療の目的で体の一部を切り開くこと。「帝王○○」
切除	病巣などをキって取りノゾくこと。
刑事	ケイジ。
刑事事件	ケイジジケン。
刑事告訴	ケイジコクソ。
刑事訴訟	ケイジソショウ。
刑務所	ケイムショ。
刑法	犯罪とケイ罰に関する法。
刑罰	犯罪者に対して、国家が科する制裁。
列島	レツ状に連なっているシマ。「日本○○」
列挙	一つ一つ数えあげること。並べたてること。 
初優勝	ハツユウショウ。
初回購入者	ショカイコウニュウシャ。
初回限定	ショカイゲンテイ。
初場所	ハツバショ。
初夏	５月中旬から梅雨入りするまで。
初夢	新年の夜に見る夢。
初対面	ハツタイメン。
初心	「○○忘れるべからず」「○○に帰る」
初心者	ショシンシャ。
初志	思い立ったときの，最ショの気持ち。「○○を貫徹する」
初恋	ハツコイ。
初日	ショニチ。
初期	ショキ。
初期投資	ショキトウシ。
初歩	学びはじめの段階。「○○からやり直す」「○○的な間違い」
初演	ある作品が公の前でハジめて披露されること。
初版	出パンされた書物の最ショのハン。
初級	ショキュウ。
初耳	ハツミミ。
初雪	ハツユキ。
判定	物事を見きわめて決テイすること。
判断	物事を見きわめ、それについて自分の考えを定めること。
判断材料	ハンダンザイリョウ。
判明	アキらかになること。 「身元が○○する」「事実が○○する」
判決	裁バン所が下す最終的なハン断。
判決内容	ハンケツナイヨウ。
判決文	ハンケツブン。
別人	ベツジン。
別便	ベツビン。
別居	同キョせず、よそで暮らすこと。「家庭内○○」
利便性	リベンセイ。
利口	頭がよいこと。賢いこと。「お○○さん」「○○な犬」
利子	リシ。
利害関係	リガイカンケイ。
利害関係者	リガイカンケイシャ。
利息	リソク。
利点	メリット。
利用	リヨウ。「○○者」「○○価値」
利用価値	リヨウカチ。
利用促進	リヨウソクシン。
利用可能	リヨウカノウ。
利用者	リヨウシャ。
利益	リエキ。
到着	目的とする地点に行きツくこと。
到着駅	トウチャクエキ。
到達	トウタツ。
到達点	トウタツテン。
制圧	力ずくで押さえつけて支配下におくこと。
制定	法律・規則などをサダめること。
制度	社会を統治・運営するための決まり。「封建○○」「貨幣○○」
制度化	セイドカ。
制御	コントロール。
制服	ユニホーム。
制服組	セイフクグミ。
制約	セイ限や条件をつけて、自由に活動させないこと。
制裁	規範に背いた者に対するこらしめや罰。「北朝鮮への経済○○」
制裁金	セイサイキン。
制限	物事の限界を定めること。
制限時間	セイゲンジカン。
刺殺	サしコロすこと。
刺身	サシミ。
刻印	シルシを彫って作ること。またはそのシルシ。
削減	サクゲン。
削減目標	サクゲンモクヒョウ。
削除	サクジョ。
前世	ゼンセ。
前代未聞	今までキいたことがないようなめずらしいこと。
前例	過去の同様の事レイ。「○○がない」
前兆	何かが起こる前に現れるしるし。マエぶれ。
前兆現象	ゼンチョウゲンショウ。
前半	ゼン後二つに分けたうちのマエのハン分。
前半戦	ゼンハンセン。
前向	マエムき。
前回	マエのカイ。
前夜	マエのヨル。
前年	マエのトシ。
前後	マエとウシロ。
前後賞	ゼンゴショウ。
前提	ある事が成り立つためのもとになる条件。
前提条件	ある事が成り立つためのもとになるジョウケン。
前方	マエのホウ。
前方確認	ゼンポウカクニン。
前日	マエのヒ。
前歯	マエのハ。
前略	ゼンリャク。
前科	過去に懲役・禁錮・罰金の刑罰を受けたことがある経歴。
前線	気温が大きく変化するような境界セン。「梅雨○○」
前編	ゼンペン。
前足	マエアシ。
前輪	マエの車リン。
前進	マエにススむこと。
前頭葉	ゼントウヨウ。
前髪	マエガミ。
剣道	ケンドウ。
副作用	フクサヨウ。
副業	フクギョウ。
副産物	フクサンブツ。
副題	サブタイトル。
割合	ワリアイ。
割安	ワリヤス。
割安感	ワリヤスカン。
割引	ワリビキ。
割当	ワリアテ。
割愛	惜しいと思いつつも、思いきって捨てたり省略すること。
割算	ワりザン。
割高	ワリダカ。
割高感	ワリダカカン。
創作	ソウサク。
創作活動	ソウサクカツドウ。
創作物	ソウサクブツ。
創刊	定期カン行物を新しくカン行すること。
創刊号	ソウカンゴウ。
創始者	ソウシシャ。
創意工夫	ソウイクフウ。
創立	会社・学校などを初めてツクること。設立。
創立記念	ソウリツキネン。
創造	それまでなかったものを初めてツクり出すこと。
劇団	ゲキダン。
劇場	芸能を観客に見せるための施設。「オペラ○○」
劇痛	はげしいイタみ。
劇的	ドラマチック。
劇薬	きわめて危険性が高い医ヤク品。
力不足	チカラブソク。
力仕事	チカラシゴト。
力作	リキサク。
力投	リキトウ。
力点	てこの原理において、チカラを加える場所。
力説	熱心にトくこと。チカラをこめて述べ立てること。
功労	コウ績とそれに伴うロウ苦。手柄。
功労者	コウロウシャ。
功名	手柄を立てて名誉を手に入れること。「けがの○○」
功績	すぐれた成果。立派な働き。手柄。
功罪	てがらとあやまち。
加入	団体・組織などの一員としてその中に加わること。
加入条件	カニュウジョウケン。
加入者	カニュシャ。
加勢	力を貸して助けること。「弱い方に○○する」
加害	他にガイをクワえること。
加害者	カガイシャ。
加工	原料や素材に手をクワえて新しい物を作ること。
加工乳	カコウニュウ。
加工貿易	カコウボウエキ。
加工食品	カコウショクヒン。
加減	カゲン。
加湿器	カシツキ。
加熱	ネツをクワえること。
加盟	団体・組織などに一員として加わること。「○○店」
加盟国	カメイコク。
加盟店	カメイテン。
加速	ソク度をクワえること。
加速度	カソクド。
劣勢	レッセイ。
助力	チカラを貸して助けること。手ダスけ。
助動詞	ジョドウシ。
助太刀	スケダチ。
助手	ジョシュ。
助手席	ジョシュセキ。
助言	アドバイス。
努力	ドリョク。
努力家	ドリョクカ。
努力義務	ドリョクギム。
労使交渉	ロウシコウショウ。
労働	ロウドウ。
労働三権	ロウドウサンケン。
労働保険	ロウドウホケン。
労働力	ロウドウリョク。
労働問題	ロウドウモンダイ。
労働基準法	ロウドウキジュンホウ。
労働市場	ロウドウシジョウ。
労働条件	ロウドウジョウケン。
労働災害	ロウドウサイガイ。
労働環境	ロウドウカンキョウ。
労働組合	ロウドウクミアイ。
労働者	ロウドウシャ。
労働者派遣法	ロウドウシャハケンホウ。
労働運動	ロウドウウンドウ。
労力	ロウリョク。
労災認定	ロウサイニンテイ。
効力	コウリョク。
効果	ききめ。望ましい結果。「逆○○」
効果音	コウカオン。
効率	少ない時間、少ない労力でどれだけ作業を進められるか。
効能	キき目。コウ用。「温泉の○○」
勇姿	イサましいスガタ。
勇気	イサましい心。「○○ある行動」
勇者	ユウ気のある人。ユウシャ。
勇足	イサみアシ。
勉強	ベンキョウ。
勉強不足	ベンキョウがタりないこと。
勉強会	ベンキョウカイ。
勉強家	よくベンキョウする人。
勉強方法	ベンキョウホウホウ。
勉強机	ベンキョウに使うツクエ。
勉強法	ベンキョウホウ。
動作	体や機械などをウゴかして働かせること。
動作環境	ソフトウェアがドウサできる条件のこと。
動力	機械等を動かすのに必要となるエネルギーのこと。
動向	事態のウゴいていく方コウ。
動植物	ドウブツとショクブツ。
動機	人の行動を決める直接の理由。「犯行の○○」
動物	人間以外のけもの。
動物園	ドウブツエン。
動画	ウゴきのあるガ像。
動脈	心臓から血液を各部に送りだす血管。
動脈硬化	ドウミャクがカタくなる現象。
動詞	ドウ作や作用を表す品シ。
動転	非常に驚いて平静を失うこと。「気が○○した」
勝利	戦いにカつこと。
勝因	ショウ利した要イン。
勝手	カッテ。
勝手口	カッテグチ。
勝敗	カつことと負けること。ショウ負。
勝目	カちメ。
勝者	ショウ利したモノ。
勝負	カつこととマけること。ショウ敗。
勝負事	ショウブゴト。
募金	寄付キンや義捐キンをツノること。「○○箱」
募集	ボシュウ。
勢力	社会的な集団がもつ、他の集団をおさえるチカラ。
勤労	11月23日は、「○○感謝の日」
勤労感謝	11月23日は「○○○○の日」
勤勉	 一生懸命に精を出して励むさま。
勤務	会社・官庁などにツトめて，仕事をすること。
勤務時間	キンムジカン。
勤務経験	キンムケイケン。
包丁	ホウチョウ。
包囲	取りカコむこと。
包囲網	ホウイモウ。
包帯	出血を止めたり清潔を保つための布。「傷口に○○を巻く」
包装	ある物を外からツツむこと。「過剰○○」
包装紙	ホウソウシ。
化合物	カ学反応により二種類以上の元素が結びついたブッ質。
化学	バケガク。
化学兵器	カガクヘイキ。
化学反応式	カガクハンノウシキ。
化学変化	カガクヘンカ。
化学肥料	カガクヒリョウ。
化学薬品	カガクヤクヒン。
化学調味料	カガクチョウミリョウ。
化物	バけモノ。
化石	カセキ。
北上	キタを向かって行くこと。「台風が○○する」
北半球	キタハンキュウ。
北国	キタグニ。
北方領土	ホッポウリョウド。
北朝鮮	キタチョウセン。
北朝鮮人権問題	キタチョウセンジンケンモンダイ。
北朝鮮核問題	キタチョウセンカクモンダイ。
北極	ホッキョク。
北極星	ホッキョクセイ。
北極海	ホッキョクカイ。
北極点	ホッキョクテン。
北海道	日本の北部に位置する大きな島。
北海道地方	ホッカイドウチホウ。
北米	キタアメリカ。
北部	その地域のキタよりのブ分。
北陸	新潟県、富山県、石川県、福井県がある地域。
北陸地方	ホクリクチホウ。
北風	キタカゼ。
区分線	クブンセン。
区切	クギり。
区別	クベツ。
区域	クイキ。
区役所	クヤクショ。
区画	クカク。「○○整理」
区間	クカン。
医学	イガク。
医師	おイ者さん。
医師不足	イシブソク。
医師団	イ者の集ダン。
医療情報	イリョウジョウホウ。
医療技術	イリョウギジュツ。
医療機関	イリョウキカン。
医者	おイシャさん。
医薬品	イヤクヒン。
医薬部外品	イヤクブガイヒン。
医院	小規模の病イン。診療所。
十一月	七五三のあるツキ。
十二支	１２種類の動物で暦や方角を表す体系。
十二月	クリスマスのあるツキ。
十八番	オハコ。
十字路	ジュウジロ。
十日	トオカ。
十月	体育の日のあるツキ。
十進法	0～9までの数字を各位に並べて表す数の表し方。
千円札	夏目漱石の描かれたお札。
千差万別	いろいろなちがいがあること。
千葉県	東京都の東方に位置するケン。
千載一遇	1000年にイチ度しかないような機会。
千里眼	その場にいながらセンリ先をも見通せる超能力。
午前	A.M.
午後	P.M.
半信半疑	本当かどうか、迷うこと。
半値	ハン分のネ段。
半分	ハンブン。
半導体	電子機器に使われるシリコン・炭素・金属の酸化物など。
半導体技術	ハンドウタイギジュツ。
半島	海に向かって長く突き出た陸地。「朝鮮○○」
半径	直ケイのハン分。
半数	ハン分のカズ。
半減	ハン分にヘらす。
半濁音	「パ」や「ぷ」などの右上の「゜」。
半熟	中程度、加熱して熟した卵。
半熟卵	中程度、加熱して熟した卵。
半生	ある時まで送ってきた生涯。「○○を振り返る」
半紙	縦24cm×横34cmくらいの、習字でよく使う薄いカミ。
半額	ハン分の金ガク。
卒業	学校で教育課程を学び終えること。
卒業予定	ソツギョウヨテイ。
卒業予定者	ソツギョウヨテイシャ。
卒業写真	ソツギョウのときに撮ったシャシン。
卒業式	学校で教育課程を学び終えたときに行う行事。
卒業生	学校で教育課程を学び終えたセイ徒。
卒業論文	ソツギョウロンブン。
卒論	ソツ業ロン文の略。
卓球	テーブルテニス。
協力	仕事などを手伝うこと。
協力者	仕事などを手伝う人。
協同	複数の人または団体が、力を合わせて物事を行うこと。共ドウ。
協同組合	キョウドウクミアイ。
協定	当事者間においるなんらかの合意。
協調	力を合わせて事をなすこと。キョウチョウ。
協調性	キョウチョウセイ。
協議	話し合って決めること。
南下	ミナミの方へ進むこと。
南下政策	ナンカセイサク。
南北	ミナミとキタ。
南半球	地キュウのミナミハン分。
南国	ミナミのクニ。
南極	地球のミナミ端の周辺。
南極大陸	地球のミナミ端にあるタイリク。
南極海	ナンキョクのウミ。
南極点	地球のミナミ端の地テン。
南極観測隊	ナンキョクカンソクタイ。
南部	ミナミの方のブ分。
単位	長さ、重さ、量などの基準となるもの。
単価	単位あたりのカ格。
単元	特定の主題の学習活動のひとまとまり。
単刀直入	前おきのことばなどをはぶいて、さっさと話の中心にはいること。
単独	ただ一人または一つであること。
単独犯	一人だけのハン罪。
単純	シンプル。
単細胞	一つのサイボウでできていること。
単細胞生物	一つのサイボウでできているセイブツ。
単行本	タンコウボン。
単語	ただ一つのゴ。ワード。
単身	一人ミ。「○○赴任」
博士	ハカセ。
博士号	ハクシゴウ。
博士論文	ハクシロンブン。
博学	広い分野にわたって豊富な知識をもっていること。
博愛	すべての人を平等に愛すること。「○○の精神」
博愛主義	ハクアイシュギ。
博愛主義者	ハクアイシュギシャ。
博物館	ハクブツカン。
占領	一国の領域が、その国の正当な権力以外の軍事力のもとに入ること。
占領軍	センリョウグン。
印刷	プリント。
印刷会社	インサツガイシャ。
印刷機	インサツするキ械。プリンター。
印刷物	プリント。
印刷用紙	インサツヨウシ。
印刷速度	インサツソクド。
印象	人間の心に対象が与える直接的な感じ。
印象派	19世紀後半のフランスに発した絵画を中心とした芸術運動。
印象的	インショウテキ。
印鑑証明書	インカンショウメイショ。
危害	生命・身体などを損なうようなキ険なこと。「○○を及ぼす」
危機	悪い結果が予測されるキ険な時・状況。
危機一髪	大変なところまで、キ険がせまっている状態。
危機感	キキカン。
危機管理	キキカンリ。
危険	アブないこと。
危険人物	キケンジンブツ。
危険物	キケンブツ。
即位	前の君主の跡を継いで、その君主位に就くこと。
即席	すぐにできること。○○ラーメン。
即死	すぐにシぬこと。
即決	すぐにケッ定すること。
即答	すぐにコタえること。
卵焼	タマゴをヤいたもの。○○き。
卵白	タマゴのシロ身。
卵黄	タマゴのキ身。
厚地	布ジのアツいこと。
厚手	布・紙・陶器などの地のアツいさま。
厚生労働省	コウセイロウドウショウ。
厚生年金	コウセイネンキン。
厚着	衣類を何枚も重ねてキること。重ねギ。
厚紙	ぶアツいカミ。
原付	ゲンツキ。
原住民	ゲンジュウミン。
原作	元となったサク品。
原作者	元となったサク品のサクシャ。
原価	商品やサービスの生産にかかった元々の金額。
原則	ゲンソク。
原則禁止	ゲンソクキンシ。
原動力	ゲンドウリョク。
原因	ある物事や状態を引き起こした元になった事・出来事。
原因不明	ゲンインがよくわからないこと。
原因究明	ゲンインを突き止めてアキらかにすること。
原始人	ゲンシ時代のヒト。
原始時代	文化的ではなかった昔の時代。
原子	物質の最小単位。アトム。
原子力	ゲンシリョク。
原子力政策	ゲンシリョクセイサク。
原子力発電	ゲンシ核のエネルギーによるハツデン。
原子力発電所	ゲンシリョクハツデンショ。
原子力規制委員会	ゲンシリョクキセイイインカイ。
原子核	ゲンシの中央にあるカク。
原子番号	ゲンシ核中の陽子数。元素に付けられたバンゴウ。
原寸	実際の大きさ。
原文	元のブン章。
原料	元になる材リョウ。
原材料	元になるザイリョウ。
原材料価格	ゲンザイリョウカカク。
原材料費	ゲンザイリョウヒ。
原油	ユ田から採取したままの石ユ。
原油価格	ゲンユのカカク。
原油生産量	ゲンユセイサンリョウ。
原油相場	ゲンユソウバ。
原点	座標ゼロの場所。座標軸が重なる場所。
原理	「てこの○○」「○○ゲン則」
原理主義	ゲンリシュギ。
原発事故	ゲンパツジコ。
原発再稼動	ゲンパツサイカドウ。
原発問題	ゲンパツモンダイ。
原発建設	ゲンパツケンセツ。
原発推進	ゲンパツスイシン。
原発推進派	ゲンパツスイシンハ。
原発政策	ゲンパツセイサク。
原発論争	ゲンパツロンソウ。
原石	ゲン料となる岩セキ。加工していないイシ。
原稿	印刷・講演などの元にするために作成した下書き。ゲンコウ。
原稿料	ゲンコウリョウ。
原稿用紙	ゲンコウヨウシ。
原色	混じりけのないイロの成分。
厳守	「秘密○○」「時間○○」
厳密	細かいところまで注意が行き届いているさま。「○○には」
厳戒態勢	ゲンカイタイセイ。
厳格	不正やごまかしを全く許さないキビしい態度。「○○に行う」
厳正	規準にゲン格に従って，公セイに取り扱うこと。
厳禁	キビしくキンじること。「火気○○」
厳選	キビしい基準でエラび出すこと。「原料を○○する」
厳重	キビしく事に当たるさま。「○○に抗議する」
厳重管理	ゲンジュウカンリ。
去年	キョネン。
参上	目ウエの人の所へ行くこと。
参列	式や行事などにサン加し、レッ席すること。
参加	ある目的をもつ集まりにクワわり、行動をともにすること。
参加国	サンカコク。
参加無料	サンカムリョウ。
参加者	サンカシャ。
参加資格	サンカシカク。
参勤交代	サンキンコウタイ。
参拝	「靖国○○」
参政権	サンセイケン。
参画	「男女共同○○」
参考	カンガえるときに手がかりや助けとすること。「○○文献」
参考人	サンコウニン。
参考書	サンコウショ。
参観	その場所に行って、見ること。「授業を○○する」
参観日	サンカンビ。
参議院	サンギイン。
参院議員	サンインギイン。
参院選	サンインセン。
友人	ユウジン。
友好	仲の良い交際。「○○国」「○○を結ぶ」
友好国	ユウコウコク。
友好都市	ユウコウトシ。
友情	ユウジョウ。
友愛	兄弟またはユウ人間の情アイ。
友達	トモダチ。
双眼鏡	ソウガンキョウ。
反乱	権力や支配者に背いて武力行動を起こすこと。
反乱軍	ハンラングン。
反則	法律や規ソクにハンすること。
反動	ある傾向に対抗して生じるそれと全くハン対の傾向・ウゴき。
反対	物事の位置・順序・方向・状態などが逆の関係にあること。
反対意見	ハンタイイケン。
反対方向	ハンタイホウコウ。
反対派	ハンタイハ。
反対者	ハンタイシャ。
反対語	ハンタイゴ。
反対運動	ハンタイウンドウ。
反射	光線がある物に当たってはね返ること。
反射板	ハンシャバン。
反射率	ハンシャリツ。
反射神経	ハンシャシンケイ。
反射鏡	ハンシャキョウ。
反復	何度も繰り返すこと。「○○横跳び」
反応	刺激にもとづいて起こる運動や現象。
反応速度	ハンノウソクド。
反感	ハン抗的なカン情。
反戦	セン争にハン対すること。
反戦運動	セン争にハン対するウンドウ。
反政府勢力	ハンセイフセイリョク。
反政府武装勢力	ハンセイフブソウセイリョク。
反比例	ハンピレイ。
反発	ハンパツ。
反省	ハンセイ。
反論	相手の意見や批判にハン対の意見を述べること。
反逆	権威・権力などにサカらうこと。
反逆者	ハンギャクシャ。
収入	シュウニュウ。
収入印紙	シュウニュウインシ。
収容	人や品物を一定の場所や施設に入れること。 
収容人数	シュウヨウニンズウ。
収容所	囚人や捕虜を強制的に入れる施設。
収拾	穏やかな状態に整えること。「○○がつかない」
収支報告書	シュウシホウコクショ。
収益	シュウエキ。
収益力	シュウエキリョク。
収益源	シュウエキゲン。
収益金	シュウエキキン。
収納	中に入れて、しまっておくこと。「○○ボックス」
収縮	 しまりチヂまること。「筋肉が○○する」
収録	シュウロク。
収録時間	シュウロクジカン。
収録曲	シュウロクキョク。
収集	コレクション。
収集品	シュウシュウヒン。
収集家	コレクター。
取引	トリヒキ。
取引価格	トリヒキカカク。
取引先	トリヒキサキ。
取引開始	トリヒキカイシ。
取得	手に入れること。「パスポートを○○する」
取捨選択	シュシャセンタク。
取材	 記事・制作などのザイ料をトり集める。
取材陣	シュザイジン。
取決	トリキメ。
取組	相撲の勝負。
取締役	トリシマリヤク。
取締役社長	トリシマリヤクシャチョウ。
受付	ウケツケ。
受付時間	ウケツケジカン。
受信	ジュシン。
受信料	ジュシンリョウ。
受信機	ジュシンキ。
受取	ウケトリ。
受取人	ウケトリニン。
受注	チュウ文をウけること。
受理	書類などをウけ取って処リすること。
受精卵	ジュセイラン。
受話器	ジュワキ。
受講料	ジュコウリョウ。
受賞	ショウをウけること。
受賞者	ジュショウシャ。
受身	ウけミ。
受難	苦ナン・災ナンをウけること。
受験	試ケンをウけること。
受験勉強	ジュケンベンキョウ。
受験生	ジュケンセイ。
受験票	ジュケンヒョウ。
口下手	クチベタ。
口元	クチモト。
口先	クチサキ。
口実	責任のがれや弁解のための理屈。
口座	「銀行○○」「○○番号」「○○振替」
口数	クチカズ。
口笛	クチブエ。
口紅	クチベニ。
口語	日常的な話し言葉。
口調	クチョウ。
口論	言葉で言い争うこと。
口車	クチ先だけの巧みな言いまわし。「○○に乗せる」
古事記	コジキ。
古今和歌集	コキンワカシュウ。
古今東西	いつでもどこでも。
古代	コダイ。
古代文明	コダイブンメイ。
古傷	フルキズ。
古典	クラシック。
古典落語	コテンラクゴ。
古文書	コモンジョ。
古本	フルホン。
古着	フルギ。
古風	コフウ。
句点	文の最後の「。」
句読点	「、」「。」
可否	カヒ。よいかよくないか。
可決	議案をよいと認めてケッ定すること。
可能	できる。
可能性	できるか。
台帳	ダイチョウ。
台形	一組の対辺が平行な四角ケイ。
台所	ダイドコロ。
台所事情	ダイドコロジジョウ。
台所洗剤	ダイドコロセンザイ。
台所用品	ダイドコロヨウヒン。
台本	シナリオ。脚ホン。
台湾	Taiwan.
台湾人	Taiwanese.
台風	タイフウ。
台風一過	タイフウイッカ。
台風被害	タイフウヒガイ。
史上	歴シジョウ。
史上初	シジョウハツ。
史上最強	シジョウサイキョウ。
右側	ミギガワ。
右往左往	何だかわからなくなって、うろたえること。
右手	ミギテ。
右折	道路などをミギへ曲がること。
右足	ミギアシ。
号令	ゴウレイ。
号外	ゴウガイ。
号泣	ゴウキュウ。
司令官	シレイカン。
司会	カイの進行をツカサドること。
司会者	シカイシャ。
司会進行	シカイシンコウ。
司法	法を適用して争訟を解決する国家作用。
司法判断	シホウハンダン。
司法書士	シホウショシ。
司法試験	シホウシケン。
各人	それぞれのヒト。
各国	それぞれのクニ。
各地	それぞれのチ方。
各自	カクジ。
各階	それぞれのカイ。
合体	ガッタイ。
合同	ゴウドウ。図形の大きさと形がまったく等しい。
合唱	複数人で同時に同じ曲を同じ場所で歌うこと。
合唱曲	ガッショウキョク。
合図	アイズ。
合奏	複数人が同時に演奏を行うこと。
合奏団	ガッソウダン。
合奏曲	ガッソウキョク。
合宿	ガッシュク。
合意	ゴウイ。
合意形成	ゴウイケイセイ。
合意文書	ゴウイブンショ。
合憲	ケン法に違反しないこと。
合成	ゴウセイ。
合戦	カッセン。
合格	ゴウカク。
合格祈願	ゴウカクキガン。
合格者発表	ゴウカクシャハッピョウ。
合法	ホウ律に違反しないこと。
合点	ガッテン。
合理化	ゴウリカ。
合衆国	アメリカ。お台場。
合言葉	アイコトバ。
合計	ゴウケイ。
合金	キン属を溶けアわせたもの。
合間	アイマ。
同一	ドウイツ。
同乗者	一緒にノる人。
同好会	ドウコウカイ。
同封	手紙と一緒にフウ筒に入れること。「写真を○○する」
同居	オナじ建物でキョ住すること。
同居人	ドウキョニン。
同情	他人の境遇をかわいそうに思うこと。
同意	ドウイ。
同感	ドウカン。
同時	オナじジ間に。
同時多発	9.11はアメリカ○○○○テロ。
同業者	ドウギョウシャ。
同様	オナじヨウに。
同盟	日本と米国は「○○国」であり絆がある。
同盟国	ドウメイコク。
同盟強化	ドウメイキョウカ。
同盟関係	ドウメイカンケイ。
同窓会	ドウソウカイ。
同等	トウ級・程度がオナじであること。
同級生	ドウキュウセイ。
同義語	ドウギゴ。
名人	メイジン。
名作	優れたサク品。
名作映画	メイサクエイガ。
名刀	優れたカタナ。
名刺	メイシ。
名前	ナマエ。ネーム。
名医	優れたイ者。
名古屋場所	ナゴヤバショ。
名句	優れた俳ク。
名器	優れた楽キ。
名声	良い評判。ほまれ。「○○を得る」
名実	評判と実際。「○○ともに優れた作家」
名所	有メイな場ショ。
名手	優れた技術を持つ人。メイシュ。
名指	ナザし。
名曲	優れた楽キョク。
名札	ナフダ。
名案	優れたアイデア。
名残	ナゴリ。
名物	「大阪○○第１位のたこ焼き」
名画	優れた絵ガ。
名監督	優れたカントク。
名称	メイショウ。ナ前。
名簿	メイボ。
名義	メイギ。
名義人	メイギニン。
名著	優れたチョ作。
名詞	具体的な対象を指示する品詞の一つ。
名選手	優れたセンシュ。
名門	メイモン。
向上	能力・性質などがより良くなること。「学力○○」
向上心	コウジョウシン。
君主	クンシュ。
君臨	クンリン。「王が○○する」
否定	そうではないと打ち消し、認めないこと。
否定形	ヒテイケイ。
否定文	ヒテイブン。
否決	議案の拒ヒをケッ定すること。
否認	ヒ定し、ミトめないこと。
吸入	気体などをスい込むこと。
吸収	外部にあるものを内部に取り込むこと。
吸物	おスいモノ。
吸血鬼	ドラキュラ。
吹奏楽	スイソウガク。
吹雪	フブキ。
告口	ツげグチ。
告発	悪事や不正を明らかにし、知らせること。「内部○○」
告発者	コクハツシャ。
告白	コクハク。
周囲	シュウイ。
周期	繰り返し起こる現象や動作が、ひと回りして前と同じ状態になるまでの時間・期間。
周波数	シュウハスウ。
周知	広く知らせること。「○○の事実」
周辺	シュウヘン。
周辺事態	シュウヘンジタイ。
周辺地域	シュウヘンチイキ。
味付	アジツけ。
味方	「正義の○○」
味見	アジミ。
味覚	アジを感じる感カク。
味覚障害	ミカクショウガイ。
呼吸	息をすること。
呼吸器	コキュウキ。
呼吸困難	コキュウコンナン。
呼捨	名前の後に「さん」「くん」などを付けないこと。
命中	メイチュウ。当たること。
命令	行うよう言いつけること。「○○文」
命令文	メイレイブン。
命名	ナ前を付けること。
命拾	イノチビロい。
命日	ある人が死亡したヒ。
命綱	イノチヅナ。
和室	日本風の部屋。
和平	戦いをやめ、仲直りすること。「○○工作」
和平協議	ワヘイキョウギ。
和平工作	ワヘイコウサク。
和式	日本の様シキ。
和服	日本風のフク装。
和歌	日本固有の詩カ。
和歌山県	紀伊半島の西側に位置するケン。
和牛	ワギュウ。
和紙	日本古来の製法によるカミ。
和英辞書	ワエイジショ。
和菓子	ワガシ。
和解	裁判によらない、当事者の話し合いによる解決。
和解内容	ワカイナイヨウ。
和訳	日本語ヤク。
和音	オトのハーモニー。
和風	日本フウの。
品切	シナギれ。
品定	シナサダめ。
品格	ヒンカク。気高さや上ヒンさ。ヒン位。
品物	シナモノ。
品種	ヒンシュ。「○○改良」
品種改良	ヒンシュカイリョウ。
品詞	単語を文法的な機能や形態などによって分類したもの。
品質	クオリティ。
品質保証	ヒンシツホショウ。
品質管理	ヒンシツカンリ。
商人	アキンド。
商品	ショウヒン。
商品到着	ショウヒントウチャク。
商品券	ショウヒンケン。
商品化	ショウヒンカ。
商品名	ショウヒンメイ。
商品未開封	ショウヒンミカイフウ。
商品番号	ショウヒンバンゴウ。
商品開封	ショウヒンカイフウ。
商品開発	ショウヒンカイハツ。
商売	ショウバイ。
商売人	ショウバイニン。
商売敵	ショウバイガタキ。
商工会議所	ショウコウカイギショ。
商店	ショウ品やサービスを提供するミセ。
商店街	ショウテンガイ。
商業	ショウギョウ。「○○高校」
商業地	ショウギョウチ。
商業施設	ショウギョウシセツ。
商業高校	ショウギョウコウコウ。
商標	トレードマーク。
商標権	ショウヒョウケン。
商談	アキナいバナシ。
問屋	トンヤ。「そうは○○が卸さない」
問答	トいとコタえ。
問題	モンダイ。
問題文	モンダイブン。
問題点	モンダイテン。
問題用紙	モンダイヨウシ。
問題視	モンダイシ。
問題解決	モンダイカイケツ。
問題集	モンダイシュウ。
善人	ゼン良なヒト。おこないの正しいヒト。
善悪	良いこととワルいこと。
善意	相手に良い結果を導こうとする気持ち。
喜劇	「吉本新○○」
喜怒哀楽	ヨロコび・イカり・カナしみ・タノしみ。
喜色満面	うれしい気持ちが顔いっぱいにひろがっていること。
営利	経済的利エキを追求すること。「○○目的」
営利目的	エイリモクテキ。
営業	エイギョウ。
営業中	エイギョウチュウ。
営業利益	エイギョウリエキ。
営業成績	エイギョウセイセキ。
営業日	エイギョウビ。
営業職	エイギョウショク。
営業部門	エイギョウブモン。
営業開始	エイギョウカイシ。
器具	簡単な構造の機キや道グ。「照明○○」
器官	多細胞生物の体を形作る、独立した単位。
器用	キヨウ。
四国	徳島県、香川県、愛媛県、高知県。
四国地方	シコクチホウ。
四字熟語	ヨジジュクゴ。
四季	ヨッつのキ節。
四年生	ヨネンセイ。
四択問題	ヨンタクモンダイ。
四捨五入	シシャゴニュウ。
四方八方	シホウハッポウ。
四日	ヨッカ。
四月	エイプリルフールのあるツキ。
四苦八苦	ひじょうに悩みクルしむこと。
四角	ヨッつのカドがある図形。
四角形	ヨッつのカドがある図ケイ。
回収	一度配った物や使った物などを、また集めること。
回復	悪い状態になったものが、もとの状態に戻ること。
回想	かつて経験したことを思いめぐらすこと。
回数	カイスウ。「○○券」
回数券	カイスウケン。
回答	質問・要求などにコタえること。返トウ。
回答率	カイトウリツ。
回覧	カイラン。「○○板」
回覧板	カイランバン。
回路	サーキット。
回転	くるくるマワること。
回転寿司	カイテンズシ。
回転数	カイテンスウ。
回転運動	カイテンウンドウ。
因果	原インと結カ。「○○関係」
因果関係	インガカンケイ。
団体	ダンタイ。「○○旅行」
団体交渉権	ダンタイコウショウケン。
団体競技	ダンタイキョウギ。
団地	ダンチ。「工業○○」
団子	ダンゴ。「○○三兄弟」
団結	目的を達成するため、多数の人々が集団をケッ成すること。
団長	ダンのオサ。
困惑	どうしてよいかわからなくて、とマドうこと。
困難	コンナン。
図工	ズコウ。
図形	ズケイ。
図星	人の指摘などが、まさにそのとおりであること。
図書	トショ。
図書券	トショケン。
図書室	トショシツ。
図書館	トショカン。
図案	ズアン。
図画	ズガ。
図画工作	ズガコウサク。
図表	ズとヒョウ。
図解	物事をズをかいてカイ説すること。
図鑑	ズカン。
図面	ズメン。
固体	物質が一定の体積と形をもつ状態。
固定	ある位置にとめて、動かないようにすること。
固定観念	コテイカンネン。
固定資産税	コテイシサンゼイ。
固定電話	コテイデンワ。
固形	「○○石鹸」「○○燃料」「○○スープ」
固形燃料	コケイネンリョウ。
固形物	コケイブツ。
固有	「竹島は、日本○○の領土」
固有名詞	コユウメイシ。
国交	二コク間の外コウ関係のこと。
国交正常化	コッコウセイジョウカ。
国交正常化交渉	コッコウセイジョウカコウショウ。
国会図書館	コッカイトショカン。
国会議事堂	コッカイギジドウ。
国会議員	コッカイギイン。
国会運営	コッカイウンエイ。
国債依存度	コクサイイゾンド。
国債発行残高	コクサイハッコウザンダカ。
国債発行額	コクサイハッコウガク。
国内	一コクの領土ナイ。
国内工場	コクナイコウジョウ。
国内市場	コクナイシジョウ。
国内生産	コクナイセイサン。
国内産業	コクナイサンギョウ。
国内需要	コクナイジュヨウ。
国勢調査	コクセイチョウサ。
国土	クニの領ド。
国土交通省	コクドコウツウショウ。
国土地理院	コクドチリイン。
国境	クニのサカイ。「○○なき医師団」
国境線	コッキョウセン。
国外	クニのソト。「○○追放」
国宝	クニのタカラ。
国家	コッカ。「○○公務員」「法治○○」
国家主席	コッカシュセキ。
国家公務員	コッカコウムイン。
国家公務員宿舎	コッカコウムインシュクシャ。
国家公務員法	コッカコウムインホウ。
国家安全保障会議	コッカアンゼンホショウカイギ。
国家安全保障戦略	コッカアンゼンホショウセンリャク。
国家戦略特区	コッカセンリャクトック。
国家犯罪	コッカハンザイ。
国技	クニが代表する競ギ。
国政運営	コクセイウンエイ。
国政選挙	コクセイセンキョ。
国旗	クニのハタ。
国有	クニがマルするもの。
国有企業	コクユウキギョウ。
国有化	コクユウカ。
国歌	クニのウタ。「○○斉唱」
国民	コクミン。
国民主権	コクミンシュケン。
国民健康保険	コクミンケンコウホケン。
国民健康保険税	コクミンケンコウホケンゼイ。
国民審査	コクミンシンサ。
国民年金	コクミンネンキン。
国民生活	コクミンセイカツ。
国民総生産	コクミンソウセイサン。
国民負担	コクミンフタン。
国王	クニのオウ様。
国産	そのクニで生サン・サン出すること。
国産丸太	コクサンマルタ。
国産和牛	コクサンワギュウ。
国産小麦	コクサンコムギ。
国益	コクエキ。
国益重視	コクエキジュウシ。
国税庁	コクゼイチョウ。
国立公園	コクリツコウエン。
国立劇場	コクリツゲキジョウ。
国立病院	コクリツビョウイン。
国立競技場	コクリツキョウギジョウ。
国語	コクゴ。
国語辞典	コクゴジテン。
国連	The United Nations.
国連児童基金	ユニセフ。ＵＮＩＣＥＦ。
国連安全保障理事会	コクレンアンゼンホショウリジカイ。
国連憲章	コクレンケンショウ。
国連教育科学文化機関	ユネスコ。ＵＮＥＳＣＯ。
国道	クニが建設・管理するドウ路。
国鉄	「ＪＲは昔、○○だった」
国際	インターナショナル。
国際交流	コクサイコウリュウ。
国際会議	コクサイカイギ
国際価格	コクサイカカク。
国際刑事裁判所	コクサイケイジサイバンショ。
国際化	コクサイカ。
国際協調主義	コクサイキョウチョウシュギ。
国際原子力機関	コクサイゲンシリョクキカン。ＩＡＥＡ。
国際問題	コクサイモンダイ。
国際大会	コクサイタイカイ。
国際情勢	コクサイジョウセイ。
国際手配	コクサイテハイ。
国際条約	コクサイジョウヤク。
国際機関	コクサイキカン。
国際法	コクサイホウ。
国際犯罪	コクサイハンザイ。
国際社会	コクサイシャカイ。
国際空港	コクサイクウコウ。
国際競争	コクサイキョウソウ。
国際紛争	コクサイフンソウ。
国際結婚	コクサイケッコン。
国際線	コクナイセン。
国際連合	コクサイレンゴウ。
国際都市	コクサイトシ。
園児	幼稚エンの子ども。
園芸	果物・野菜・観賞用植物などを栽培すること。
園芸家	エンゲイカ。
園長	幼稚エンのチョウ。
土下座	ドゲザ。
土俵	ドヒョウ。
土器	ツチを焼き固めたウツワ。「縄文○○」「弥生○○」
土地	トチ。
土地代	トチダイ。
土地価格	トチカカク。
土地柄	トチガラ。
土手	ドテ。
土日	ド曜日とニチ曜日。
土星	太陽系の中では木セイに次いで２番目に大きな惑セイ。
土曜	サタデー。
土曜日	サタデー。
土木	ドボク。
土木工事	ドボクコウジ。
土産	ミヤゲ。
土産話	ミヤゲバナシ。
土砂	ドシャ。
土砂災害	ドシャサイガイ。
土管	陶器やコンクリートなどでできた筒状の管。
土足	ドソク。
土足厳禁	ドソクゲンキン。
圧倒	アットウ。
圧倒的多数	アットウテキタスウ。
圧力	アツリョク。
圧力団体	アツリョクダンタイ。
圧力計	アツリョクケイ。
圧勝	アッショウ。
圧政	権力などで人民を押さえつけるセイ治。
圧縮	物質にアツ力を加えて容積をシュク小すること。
圧縮機	アッシュクキ。
圧縮空気	アッシュククウキ。
圧迫	アッパク。
圧迫感	アッパクカン。
在学	ザイガク。
在学証明書	ザイガクショウメイショ。
在宅	ザイタク。「○○勤務」
在宅介護	ザイタクカイゴ。
在宅勤務	ザイタクキンム。
在宅起訴	ザイタクキソ。
在庫	ザイコ。
在庫管理	ザイコカンリ。
在校生	ザイコウセイ。
地上	ジ面のウエ。
地下	ジ面のシタ。
地下室	チカシツ。
地下水	チカスイ。
地下街	チカガイ。
地下資源	チカシゲン。
地下鉄	チカテツ。
地中海	チチュウカイ。
地位	社会における身分や立場など。「日米○○協定」
地位向上	チイコウジョウ。
地元	ジモト。
地元企業	ジモトキギョウ。
地動説	チドウセツ。
地名	土チのナ前。
地味	ジミ。
地図	マップ。
地図記号	チズキゴウ。
地域	チイキ。
地域再生	チイキサイセイ。
地域安定	チイキアンテイ。
地域密着型	チイキミッチャクガタ。
地域振興	チイキシンコウ。
地域格差	チイキカクサ。
地域活性化	チイキカッセイカ。
地域社会	チイキシャカイ。
地域経済	チイキケイザイ。
地場産業	ジバサンギョウ。
地声	元のコエ。
地層	チソウ。
地帯	チタイ。「安全○○」
地平線	チヘイセン。
地底	大チのソコ。チ下深いところ。
地形	チケイ。
地方	ローカル。
地方交付税	チホウコウフキン。
地方交付税交付金	チホウコウフゼイコウフキン。
地方公務員	チホウコウムイン。
地方創生	チホウソウセイ。
地方気象台	チホウキショウダイ。
地方税	チホウゼイ。
地方紙	チホウシ。
地方自治体	チホウジチタイ。
地方都市	チホウトシ。
地熱	ジ面のネツ。「○○発電」
地熱発電	チネツハツデン。
地球	チキュウ。
地球儀	チキュウギ。
地球温暖化	チキュウオンダンカ。
地球温暖化対策	チキュウオンダンカタイサク。
地球環境	チキュウカンキョウ。
地球規模	チキュウキボ。
地理	チ域における現在の自然と社会の様子。
地産地消	チサンチショウ。
地蔵	おジゾウさん。
地表	チ球のヒョウ面。
地裁	チ方サイ判所。
地道	ジミチ。
地雷	ジ面に埋め込まれた爆弾。
地震	大チが揺れること。
地震計	ジシンケイ。
地面	大チの表メン。
坂道	サカミチ。
均一	「百円○○」
均整	全体的につりあいがとれてトトノっていること。
均等	二つ以上のものの間に差が全くなくヒトしいさま。
垂幕	タれマク。
垂直	スイチョク。
垂線	直センなどに対して９０度で交わるセン。
型破	カタヤブり。
型紙	カタガミ。
城下町	ジョウカマチ。
基地	活動の拠点となる場所。「秘密○○」「米軍○○」
基地問題	キチモンダイ。
基幹産業	キカンサンギョウ。
基本	キホン。
基本問題	キホンモンダイ。
基本料金	キホンリョウキン。
基本方針	キホンホウシン。
基本構造	キホンコウゾウ。
基本機能	キホンキノウ。
基本法	キホンホウ。
基本的人権	キホンテキジンケン。
基準	行動や判断の拠り所となる物や数値。
基準時	ヒョウジュンジ。
埼玉県	東京都の北に位置するケン。
報告	レポート。
報告書	レポート。
報告義務	ホウコクギム。
報復	仕返しをすること。
報道	ニュース。
報道機関	ホウドウキカン。
報道関係者	ホウドウカンケイシャ。
報道陣	ホウドウジン。
場内	ある会ジョウの中。ジョウ外の反対。
場合	バアイ。
場外	ある会ジョウのソト。「○○乱闘」
場所	バショ。
場数	バカズ。
場面	シーン。
塩分	エンブン。
塩加減	シオカゲン。
塩気	シオケ。
塩水	シオミズ。
塩田	海水の水分を蒸発させ、シオをとる設備。
塩素	元素記号Cl。有毒ガス。
塩酸	胃サンの主成分。
境内	ケイダイ。
境地	キョウチ。
境界	ボーダー。
境界線	ボーダーライン。
境目	サカイメ。
墓前	ボゼン。
墓地	ボチ。
墓場	ハカバ。
墓石	ハカイシ。
墓穴	ボケツ。「○○を掘る」
増刊	定期的なカン行物で，定期以外にカン行すること。
増刊号	ゾウカンゴウ。
増加	フエえてクワわること。
増加傾向	ゾウカケイコウ。
増大	フエえてオオきくなること。
増水	ミズがフえること。
増減	フエえることとヘること。
増産	生産量をフやすこと。
増益効果	ゾウエキコウカ。
増税	ゼイ金をフやすこと。
増築	ゾウチク。
増進	力や勢いをマすこと。「健康○○」
増額	金ガクをフやすこと。
士気	戦いに臨む、兵シの意キ込み。「○○の低下」
士農工商	シノウコウショウ。
声優	コエの俳ユウ。
声帯	コエを出すときに振るえる場所。
声援	コエの応エン。
声明	意見や意思を世間に発表すること。「犯行○○」
声色	コワイロ。
声高	コワダカ。
売上	ウリアゲ。
売上高	ウリアゲダカ。
売値	ウリネ。
売切御免	ウリキレゴメン。
売名行為	バイメイコウイ。
売場	ウリバ。
売店	バイテン。
売手	ウりテ。
売買	ウることとカうこと。
売買価格	バイバイカカク。
売買契約	バイバイケイヤク。
変人	ヘンなヒト。
変化	チェンジ。
変化球	ヘンカキュウ。
変圧器	ヘンアツキ。
変形	カタチがカわること。
変形性関節症	ヘンケイセイカンセツショウ。
変態	昆虫などが形タイをカえること。
変換	ある状態から他の状態へカえること。ヘンカン。
変更	決められた物事をカえること。「○○を加える」
変更届	ヘンコウトドケ。
変死体	ヘンシタイ。
変温動物	ヘンオンドウブツ。
変色	イロがカわること。
変装	容姿・服ソウなどを別人のようにカえること。
変身	姿をカえること。ヘンシン。
夏季	ナツのキ節。
夏至	最も昼間が長い日。
夕刊	ユウ方に発行する新聞。
夕方	ユウガタ。
夕日	ユウヒ。
夕暮	ユウグれ。
夕焼	ユウヤけ。
夕食	ユウ方や晩にタべるショク事のこと。
夕飯	ユウ方や晩に食べるメシのこと。
外交	対ガイ政策や国家間のコウ渉など。
外交使節団	ガイコウシセツダン。
外交官	ガイコウカン。
外交政策	ガイコウセイサク。
外人	ガイジン。
外側	ソトガワ。
外出	家からソトにデること。
外務省	ガイムショウ。
外務省関係者	ガイムショウカンケイシャ。
外国	ガイコク。
外国人	ガイコクジン。
外国人労働者	ガイコクジンロウドウシャ。
外国人投資家	ガイコクジントウシカ。
外国人株主	ガイコクジンカブヌシ。
外国人観光客	ガイコクジンカンコウキャク。
外国人選手	ガイコクジンセンシュ。
外国旅行	ガイコクリョコウ。
外国為替	ガイコクカワセ。
外国為替取引	ガイコクカワセトリヒキ。
外国為替市場	ガイコクカワセシジョウ。
外国語	ガイコクゴ。
外来	ガイライ。
外来患者	ガイライカンジャ。
外来語	ガイライゴ。
外的要因	ガイテキヨウイン。
外科	手術による治療を扱う医学の一分野。
外見	ガイケン。
外資系	ガイシケイ。
外資系企業	ガイシケイキギョウ。
外部	物のソト側。ガイブ。
外部業者	ガイブギョウシャ。
外部評価委員会	ガイブヒョウカイインカイ。
外食産業	ガイショクサンギョウ。
多事多難	ジ件が続いておこり、苦しんでいること。
多分	おそらく。
多国籍企業	タコクセキキギョウ。
多少	オオかれスクなかれ。
多才	サイ能がオオいこと。
多数	カズがオオい。
多数決	タスウケツ。
多数確認	タスウカクニン。
多様化	タヨウカ。
多様性	タヨウセイ。
多発	何度も起こること。「交通事故が○○する」
多角形	タカッケイ。
多重人格	タジュウジンカク。
多量	リョウがオオいこと。
多額	金ガクがオオいこと。
夜中	ヨナカ。
夜明	ヨアけ。
夜景	ヤケイ。
夜空	ヨゾラ。
夜間	ヨルのアイダ。
夜間営業	ヤカンエイギョウ。
夢中	ユメのナカ。我を忘れること。「○○になる」
大丈夫	ダイジョウブ。
大事	オオゴト。
大人	オトナ。
大人気	ダイニンキ。
大仏	ダイブツ。
大企業	ダイキギョウ。
大会	タイカイ。
大会記録	タイカイキロク。
大体	あらまし。おおよそ。
大作	オオきなサク品。
大使	外交シ節の最上位の階級。
大使館	タイシカン。
大便	うんち。
大分県	九州地方東部にあるケン。別府温泉がある。
大切	タイセツ。オオ事。
大動脈	ダイドウミャク。
大勢	たくさんの人。オオゼイ。
大半	ハン分以上。タイハン。
大卒	ダイ学をソツ業していること。
大同小異	ほとんど差のないこと。
大名	ダイミョウ。
大名行列	ダイミョウギョウレツ。
大和絵	ヤマトエ。
大和言葉	ヤマトコトバ。
大器晩成	すぐれた才能を持っている人は、年をとってからオオ物になるということ。
大国	オオきなクニ。
大地	ダイチ。
大型施設	オオガタシセツ。
大型自動車	オオガタジドウシャ。
大声	オオゴエ。
大変	タイヘン。すごく。
大多数	ダイタスウ。
大天使	ダイテンシ。
大失敗	ダイシッパイ。
大学	ダイガク。
大学入試	ダイガクニュウシ。
大学卒業	ダイガクソツギョウ。
大学教育	ダイガクキョウイク。
大学生	ダイガクセイ。
大学祭	ダイガクサイ。
大学進学	ダイガクシンガク。
大学院	ダイガクイン。
大学院生	ダイガクインセイ。
大将	「あんたがタイショウ」
大小	オオきいこととチイさいこと。
大工	ダイク。
大工道具	ダイクドウグ。
大差	オオきな違い。「○○ない」
大役	オオきなヤク割り。
大往生	ダイオウジョウ。
大志	「少年よ、○○を抱け」
大成功	ダイセイコウ。
大打撃	オオきな損害・痛手。
大文字	オオモジ。
大日本帝国	ダイニッポンテイコク。
大星雲	ダイセイウン。
大木	タイボク。
大東亜戦争	ダイトウアセンソウ。
大根	ダイコン。
大正	明治と昭和の間にある日本の元号。
大気	惑星を取り巻くキ体の総称。
大気中	タイキチュウ。
大河小説	ダイガショウセツ。
大波	オオナミ。
大流行	ダイリュウコウ。
大浴場	ダイヨクジョウ。
大漁	魚などがたくさんとれること。
大物	オオモノ。
大理石	ダイリセキ。
大男	オオオトコ。
大発見	ダイハッケン。
大目	不正・不備などをあまりとがめない。「○○に見る」
大目玉	オオメダマ。
大筋	オオスジ。
大筋合意	オオスジゴウイ。
大箱	オオきなハコ。
大統領	ダイトウリョウ。
大群	オオきなムれ。「ハチの○○」
大義名分	すじの通った理由。
大胆	思い切りよくやってのけること。
大胆不敵	何者もおそれない態度。
大脳	ノウのなかで最もオオきな部分。
大腸	ダイチョウ。「○○菌」
大臣	ダイジン。相。
大自然	ダイシゼン。
大英帝国	ダイエイテイコク。
大西洋	タイセイヨウ。
大規模	ダイキボ。
大豆	ダイズ。
大豆油	ダイズアブラ。
大道具	オオドオグ。
大部分	ダイブブン。
大都会	ダイトカイ。
大酒	オオザケ。
大量消費	タイリョウショウヒ。
大量生産	タイリョウセイサン。
大量絶滅	タイリョウゼツメツ。
大関	大相撲において「横綱」に次ぐ地位。
大阪	関西の経済・文化の中心地。
大阪地方裁判所	オオサカチホウサイバンショ。
大阪地裁	オオサカチサイ。
大阪府	日本第3位の人口を持つ、近畿地方の都道府県。
大阪都構想	オオサカトコウソウ。
大陸	タイリク。
大陸移動説	タイリクイドウセツ。
大雨	オオアメ。
大雪	オオユキ。
大韓民国	ダイカンミンコク。カンコクの正式名称。
大願成就	大きな願いがかなうこと。
大黒柱	ダイコクバシラ。
天下	テンが覆っている全世界。
天下統一	テンカトウイツ。
天丼	テンドン。
天井	テンジョウ。
天体	宇宙にある観測できる物タイ。
天体望遠鏡	テンタイボウエンキョウ。
天体観測	テンタイカンソク。
天使	エンジェル。
天候	数日から数か月ぐらいの期間の大気の状態。
天候不順	テンコウフジュン。
天動説	テンドウセツ。
天命	テンから与えられたメイ令。「○○を知る」
天国	テンゴク。
天変地異	テンペンチイ。
天女	テンニョ。
天守閣	テンシュカク。
天安門事件	テンアンモンジケン。
天川	アマのガワ。
天才	テンから与えられたような、すばらしいサイ能。
天敵	特定生物の死亡要因となる生物種。
天文台	テンモンダイ。
天気	「○○予報」
天気予報	テンキヨホウ。
天気図	テンキズ。
天災	テンのワザワい。
天然	自ゼンに生み出されたもの。
天然成分	テンネンセイブン。
天然記念物	テンネンキネンブツ。
天然資源	テンネンシゲン。
天王星	テンオウセイ。
天皇	テンノウ。
天皇制	テンノウセイ。
天皇杯	テンノウハイ。
天皇誕生日	テンノウタンジョウビ。
天皇賞	テンノウショウ。
天皇陛下	テンノウヘイカ。
天罰	テンバツ。
太刀	刃長が約60cm以上の日本トウ。タチ。
太平洋	タイヘイヨウ。
太平洋戦争	タイヘイヨウセンソウ。
太腹	フトっパラ。
太陽	昼間の空で一番輝いている天体。
太陽光	タイヨウコウ。
太陽光発電	タイヨウコウハツデン。
太陽暦	タイヨウレキ。
太陽系	タイヨウケイ。
太陽電池	タイヨウデンチ。
夫人	他ニンの妻を敬っていう語。
夫妻	オットとツマ。
夫婦	フウフ。
夫婦仲	フウフナカ。
夫婦円満	フウフエンマン。
夫婦愛	フウフアイ。
失敗	シッパイ。
失敗作	シッパイサク。
失明	目が見えなくなること。
失望	期待はずれでがっかりすること。
失格	資カクをウシナうこと。
失業	仕事をウシナうこと。
失業保険	シツギョウホケン。
失業手当	ザンギョウテアテ。
失業率	シツギョウリツ。
失業者	シツギョウシャ。
失礼	シツレイ。
失神	気をウシナうこと。
失言	言うべきではないことをうっかり言うこと。
奇想天外	ふつうでは考えられないようなびっくりするようなこと。
奇数	２で割ると１余るカズ。
奇跡	ミラクル。
奈良	日本国の発祥とされる歴史的地名。「○○県」
奈良時代	ナラジダイ。
奈良県	紀伊半島内陸部に位置するケン。
契約	互いの意思表示による法律上のヤク束。
契約書	ケイヤクショ。
契約期間	ケイヤクキカン。
契約社員	ケイヤクシャイン。
契約農家	ケイヤクノウカ。
奥様	オクサマ。
奥歯	オクバ。
女優	ジョ性の俳ユウ。
女児	オンナの子。
女医	オンナのおイ者さん。
女子	ジョシ。「○○更衣室」
女子会	ジョシカイ。
女子大生	ジョシダイセイ。
女子生徒	ジョシセイト。
女子高生	ジョシコウセイ。
女性	ジョセイ。オンナであること。
女性作家	ジョセイサッカ。
女性店員	ジョセイテンイン。
女性歌手	ジョセイカシュ。
女性比率	ジョセイヒリツ。
女性登用	ジョセイトウヨウ。
女性社員	ジョセイシャイン。
女性管理職	ジョセイカンリショク
女性芸能人	ジョセイゲイノウジン。
女王	ジョオウ。オンナのオウ様。
女神	メガミ。
女風呂	オンナブロ。
好奇心	コウキシン。
好意	相手をコノましいと思う気持ち。
好感度	コノましいと感じる度合い。コウカンド。
好条件	コウジョウケン。
好機	チャンス。「今が○○」
好物	スきな飲みモノや食べモノ。
好評	ヒョウ判がいい。
好評発売中	コウヒョウハツバイチュウ。
好調	チョウ子がいい。
好都合	コウツゴウ。
妨害	じゃまをすること。
妻子	ツマとコ。
姉妹	アネとイモウト。
姉妹品	シマイヒン。
始末	シマツ。
始末書	シマツショ。
始業式	シギョウシキ。
始球式	シキュウシキ。
始発	乗り物が一日のうちで最初に出パツすること。
始発電車	シハツデンシャ。
始発駅	シハツエキ。
始終	ハジめからオわりまで。「一部○○」
委任状	イニンジョウ。
委員	イイン。
委員会	イインカイ。
委員長	イインチョウ。
姿勢	体の構え。態度。「○○が悪い」
威力	相手を圧倒する強いチカラ。
威力業務妨害	イリョクを用いて人のギョウムをボウガイすること。
威圧感	イアツされるようなカン覚。
威圧的	イアツなどで相手を押さえつけようとするさま。
婚約	コンヤク。
婚約指輪	コンヤクユビワ。
婚約破棄	コンヤクハキ。
婚約者	コンヤクシャ。
婦人	成ジンした女のヒト。
婦人服	フジンフク。
婦人用	フジンヨウ。
婦女暴行	フジョボウコウ。
子会社	コガイシャ。
子供	コドモ。
子分	「親分と○○」
子午線	シゴセン。
子孫	血統を受け継いで生まれてきた者。コとマゴ。
子守	コモリ。
子宝	コダカラ。
子犬	コイヌ。
子音	母イン以外のオト。
字幕	ジマク。
存亡	ソン続するか、ほろぶか。「国の○○に関わる」
存分	思いどおりにすること。十分なさま。「○○に発揮する」
存在	ソンザイ。
存在価値	ソンザイカチ。
存在意義	ソンザイイギ。
存在感	ソンザイカン。
存在理由	ソンザイリユウ。
存続	引きツヅきソン在すること。
孝行	父母によく仕える行為。子の親に対する道徳。
季節	キセツ。
季節感	キセツカン。
季節風	キセツフウ。
季語	俳句に用いられるキ節を表す言葉。
孤児	保護者のいない未成年者。
孤島	他の陸地から離れて、海上にぽつんとあるシマ。
孤独	他の人々と関係がない状態。
孤立	他から離れて一つだけタっていること。
孤立無援	仲間や、助けてくれる人がいないこと。
孤立状態	コリツジョウタイ。
学会	ガッカイ。
学力	ガクリョク。
学問	理論に基づいて体系づけられた知識と研究方法。
学園	ガクエン。
学園祭	ガクエンサイ。
学年	ガクネン。
学期	ガッ校の一ガク年間を区切った一定のキ間。
学期末	ガッキマツ。
学校	ガッコウ。
学校卒業	ガッコウソツギョウ。
学校教育法	ガッコウキョウイクホウ。
学校生活	ガッコウセイカツ。
学校給食	ガッコウキュウショク。
学業	ガクギョウ。
学歴	ガクレキ。
学生	ガクセイ。
学生団体	ガクセイダンタイ。
学生気分	ガクセイキブン。
学生食堂	ガクセイショクドウ。
学科	ガク部をさらに分割した組織。
学級会	ガッキュウカイ。
学級委員	ガッキュウイイン。
学級新聞	ガッキュウシンブン。
学習	ガクシュウ。
学習帳	ガクシュウチョウ。
学習意欲	ガクシュウイヨク。
学習指導要領	ガクシュウシドウヨウリョウ。
学習時間	ガクシュウジカン。
学者	ガクシャ。
学芸会	ガクゲイカイ。
学術	ガクジュツ。
学説	ガク問上のセツ。
学識	ガク問と知シキ。
学費	教育を受けるためにかかる費用。
学部	ガッ校の内部で専攻分野ごとに分類した組織。
孫手	マゴのテ。
宅配便	タクハイビン。
宅配業者	タクハイギョウシャ。
宇宙	地球から見て、地球以外の空間のこと。
宇宙旅行	ウチュウリョコウ。
宇宙服	ウチュウフク。
宇宙生命体	ウチュウセイメイタイ。
宇宙空間	ウチュウクウカン。
宇宙船	ウチュウセン。
宇宙開発	ウチュウカイハツ。
宇宙飛行士	ウチュウヒコウシ。
宇宙食	ウチュウショク。
守備	敵の攻撃にソナえてマモること。
守神	マモりガミ。
守秘義務	シュヒギム。
安住	アン心し落ち着いてスむこと。「○○の地」
安価	カ格がヤスいこと。
安保理	アンポリ。
安値	ネ段がヤスいこと。
安全	危険がないこと。
安全保障	アンゼンホショウ。
安全地帯	アンゼンチタイ。
安全確保	アンゼンカクホ。
安全確認	アンゼンカクニン。
安全第一	アンゼンダイイチ。
安全策	アンゼンサク。
安全管理	アンゼンカンリ。
安全管理体制	アンゼンカンリタイセイ。
安全装置	アンゼンソウチ。
安全資産	アンゼンシサン。
安全通貨	アンゼンツウカ。
安否	無事かどうかということ。「○○を尋ねる」
安否不明	アンピフメイ。
安否情報	アンピジョウホウ。
安否確認	アンピカクニン。
安定	落ち着いていて変動の少ないさま。
安定供給	アンテイキョウキュウ。
安定感	アンテイカン。
安定財源	アンテイザイゲン。
安心	シン配・不安がなくて、ココロがヤスらぐこと
安心感	アンシンカン。
安打	野球におけるヒット。
安易	深く考えないさま。いいかげんなこと。
安月給	ヤスゲッキュウ。
安楽死	アンラクシ。
安物	ヤスモノ。
安産	苦しまないで出サンすること。
安眠	ヤスらかにネムること。
安静	心身を休めてシズかにしていること。「絶対○○」
完了	カン全に終わること。「準備○○」
完備	すべてがソナわっていること。「上下水道○○」
完全	パーフェクト。
完全個室	カンゼンコシツ。
完全子会社	カンゼンコガイシャ。
完全民営化	カンゼンミンエイカ。
完全犯罪	カンゼンハンザイ。
完全試合	カンゼンシアイ。
完成	カン全にナしおえること。
完成予定図	カンセイヨテイズ。
完成予想図	カンセイヨソウズ。
完成品	カンセイヒン。
完成度	カンセイド。
完敗	すべて負けること。
完結	しめくくりがついて，すべて終わること。
完結編	カンケツヘン。
完走	最後までハシり尽くすこと。
宗教	人間や自然の力を超えた存在を中心とする観念やオシえ。
宗教家	シュウキョウカ。
宗教改革	シュウキョウカイカク。
宗教法人	シュウキョウホウジン。
宗教画	シュウキョウガ。
宗教警察	シュウキョウケイサツ。
宗教音楽	シュウキョウオンガク。
官公庁	カンコウチョウ。
宙返	チュウガエり。
定休日	テイキュウビ。
定住	決まった場所にジュウ居を構え、スみ着くこと。
定例会見	テイレイカイケン。
定価	商品の、決まっている値段。
定刻	決まった時コク。
定員	乗り物に安全に収容し得る人数。
定年	従業員が一テイのネン齢に達したこと。
定年退職	テイネンタイショク。
定数	決まったカズ。
定数削減	テイスウサクゲン。
定期	キ間・キ限が決まっていること。
定期便	テイキビン。
定期券	テイキケン。
定期報告	テイキホウコク。
定期検診	テイキケンシン。
定期点検	テイキテンケン。
定期預金	テイキヨキン。
定番	テイバン。
定番商品	テイバンショウヒン。
定着	テイチャク。
定義	物事の意味・内容を言葉で明確に限テイすること。
定規	直線や曲線を引くときに用いる器具。「三角○○」
定評	広く一般に認められているヒョウ判・ヒョウ価。
宝島	タカラジマ。
宝庫	タカラ物を入れておく蔵・倉コ。
宝探	タカラサガし。
宝物	タカラモノ。
宝石	ホウセキ。
宝船	タカラブネ。
実体	本当の姿。正タイ。「○○のない想像上の人物」
実体経済	ジッタイケイザイ。
実体験	ジッタイケン。
実力	ジツリョク。
実力者	ジツリョクシャ。
実力行使	ジツリョクコウシ。
実名	本当のナ前。
実在	ジッ際に存ザイすること。
実家	自分の生まれたイエ。生カ。
実感	ジッ際に物事に直面したとき受けるカンじ。
実態	ジッ際のありさま。ありのままの状タイ。ジツ情。
実態調査	ジッタイチョウサ。
実戦	ジッ際のタタカい。
実業家	ジツギョウカ。
実権	ジッ際のケン力。
実況	ジッ際の状キョウ。「○○中継」
実演	ジッ際にエンじること。
実物	ジッ際のモノ。
実物大	ジツブツダイ。
実現	事ジツとなってアラワれること。現ジツ化すること。 
実現可能	ジツゲンカノウ。
実用	ジッ際に役に立つこと。
実用化	ジツヨウカ。
実用化試験	ジツヨウカシケン。
実用新案	ジツヨウシンアン。
実用的	ジツヨウテキ。
実線	切れ目なしにつながっているセン。
実績	ジッ際にやり遂げた成果・業セキ。
実習	ジッ際にやってナラうこと。
実行	ジッ際にオコナうこと。「計画を○○に移す」
実行力	ジッコウリョク。
実行委員会	ジッコウイインカイ。
実証	事ジツによってショウ明すること。
実話	本当のハナシ。
実費	ジッ際に必要とするヒ用。
実質	ジッ際に事物に備わっている内容や性シツ。「○○が伴わない」
実質成長率	ジッシツセイチョウリツ。
実質賃金	ジッシツチンギン。
実際	物事のあるがままの様子。本当の姿。 
実験	物事を確かめるためにジッ際にやってみること。
実験台	ジッケンダイ
実験材料	ジッケンザイリョウ。
客室	来キャクが滞在する部屋。「○○乗務員」
客席	キャクが座るための座セキ。
客観的	キャッカンテキ。
客観的事実	キャッカンテキジジツ。
客足	キャクアシ。
客間	来キャクを通す部屋。キャク室。
宣伝	多くの人に理解させるために広く情報を伝えること。
宣伝効果	センデンコウカ。
宣告	その人にとって重大な事柄を告げ知らせること。
宣戦布告	セン争行為を開始する意思を表明するセン言。
宣教師	センキョウシ。
宣言	状態・意見・方針などを外部に表明すること。
室内	部屋の中。
室内競技	シツナイキョウギ。
室町幕府	足利尊氏が京都において創始した武家政権。
室町時代	足利尊氏が京都室町に幕府を開いていた時代。
宮内庁	クナイチョウ。
宮城県	山形ケンの東に位置するケン。仙台市がある。
宮崎牛	ミヤザキギュウ。
宮崎県	九州南東部に位置するケン。キャンプ地として有名。
宮殿	権力者の大規模で豪華な建物。
害悪	他に災いを与えるような、よくない事。
害虫	人間にとって悪い影響を与えるムシ。
害虫駆除	ガイチュウクジョ。
家事	カ庭生活を円滑に営んでいくうえに必要な作業。
家具	イエにある、生活に使用する比較的大きい道グ類。
家内	イエのなか。カ族。自分の妻。「○○安全」
家出	イエデ。
家宝	イエのタカラ。
家庭	カ族の集まり、またはカ族が生活する場所。
家庭内暴力	カテイナイボウリョク。ＤＶ。
家庭内離婚	カテイナイリコン。
家庭教師	カテイキョウシ。
家庭料理	カテイリョウリ。
家庭科	カテイカ。
家庭菜園	カテイサイエン。
家庭裁判所	カテイサイバンショ。
家庭訪問	カテイホウモン。
家政婦	カセイフ。
家族	夫婦を中核とした近親者の集まり。
家族会議	カゾクカイギ。
家族全員	カゾクゼンイン。
家族旅行	カゾクリョコウ。
家族計画	カゾクケイカク。
家族関係	カゾクカンケイ。
家来	ケライ。
家系図	カケイズ。
家計	一カの経済生活のやりくり。
家計簿	カケイボ。
家訓	カクン。
家財道具	カザイドウグ。
家賃	ヤチン。
家電量販店	カデンリョウハンテン。
容体	病気のぐあい。病状。「ご○○が落ち着く」
容器	入れ物。
容姿	顔かたちと体つき。スガタかたち。「○○端麗」
容易	たやすくできるさま。簡単にできるさま。
容疑	罪を犯したのではないかというウタガい。ヨウギ。
容疑者	ヨウギシャ。
容積	ヨウ器の中に入り得る分量。
宿命	シュクメイ。
宿敵	シュクテキ。
宿木	ヤドりギ。
宿泊客	シュクハクキャク。
宿題	シュクダイ。
寄付	金品を贈ること。
寄付金	キフキン。
寄港	ミナトにヨること。
寄生	ある種のセイ物が特定の生物に依存してセイ活すること。
寄道	ヨりミチ。
密入国	ミツニュウコク。
密告	ミッコク。
密告者	ミッキョクシャ。
密室	ミッ閉された部屋。「○○殺人」
密度	物質の単位体積あたりの質量。
密接	すきまのないほどぴったりとくっついていること。
密林	樹木が隙間なく生い茂っているハヤシ。
密漁	ルールを犯して魚介類をとること。
密漁船	ミツリョウセン。
密約	ヒソかにヤク束を結ぶこと。
密輸	正規の手続きによらない物品の輸出入。
密閉	すき間のないようにトじ込めること。
密閉容器	ミッペイヨウキ。
密集	すき間なくびっしりとアツまること。
富国強兵	フコクキョウヘイ。
富士山	日本で一番高いヤマ。
富山県	新潟ケンと福井ケンの間にあり、太平洋側にあるケン。
寒冷前線	カンレイゼンセン。
寒天	カンテン。
寒暖	サムさとアタタかさ。
寒気	サムケ。
寒波	気温よりずっと低温な空気が押し寄せてくる現象。「○○到来」
寒流	周りの海水より水温の低い海リュウ。
寒空	いかにもサムそうな冬のソラ。
察知	サッチ。
審判員	シンパンイン。
寸分	スンブン。「○○の狂いもなく」
寸前	ほんのわずか手マエ。一瞬マエ。「爆発○○」
寸法	基準となる物の長さ。
寺子屋	読み書き・そろばんなどを教えた、江戸時代の民間教育施設。
寺院	仏像が安置され、出家者が住むところ。
対処	ある事に対して適当なショ置をとること。「○○方法」
対処方法	タイショホウホウ。
対処法	タイショホウ。
対向車線	タイコウシャセン。
対局	将棋・碁などで二人がタイ戦すること。
対岸	向こうギシの。
対応	周囲の状況などに合わせて事をすること。
対応機種	タイオウキシュ。
対戦	敵味方が互いにタタカうこと。「○○成績」
対戦成績	タイセンセイセキ。
対戦相手	タイセンアイテ。
対抗手段	タイコウシュダン。
対日感情	タイニチカンジョウ。
対比	コントラスト。
対決	両者がタイ面して事のケッ着をつけること。
対流	ナガれの中で比較的熱い物が上昇し、冷たい物が下降して入れ替わる現象。
対照	テらし合わせること。「○○表」
対称	点・線・面などについて互いに向き合う位置関係にあること。
対立	二つのものが反対の立場に立つこと。
対等	二つの物事の間に上下・優劣のないさま。
対策	状況にタイ応するための方法・手段。「○○会議」
対策会議	タイサクカイギ。
対角線	多角形上の隣り合わない２頂点同士を結ぶ線分。
対話	二人以上の人物間の思考の交流。
対話集会	タイワシュウカイ。
対談	二人の人が向かい合って話し合うこと。
対象	はたらきかけの目標や目的とするもの。めあて。
対象商品	タイショウショウヒン。
対象者	タイショウシャ。
対象車種	タイショウシャシュ。
対面	メンと向かうこと。
寿司	スシ。
寿命	ジュミョウ。
封建制度	ホウケンセイド。
封建社会	ホウケンシャカイ。
封筒	手紙・文書などをフウをして入れる袋。
専念	ある事に心を集中すること。「研究に○○する」
専用	特定の人や特定のヨウ途だけに使ヨウすること。
専用回線	センヨウカイセン。
専用機	センヨウキ。
専門	限られた分野の学問や職業にもっぱら従事すること。
専門分野	センモンブンヤ。
専門医	センモンイ。
専門学校	センモンガッコウ。
専門家	センモンカ。
専門書	センモンショ。
専門用語	センモンヨウゴ。
射撃	シャゲキ。
射殺	シャサツ。
将来	これからやってくる時。未来。前途。「○○が楽しみ」
将来像	ショウライゾウ。
将来性	ショウライセイ。
将軍	「征夷大○○」
尊厳	ソンゲン。
尊敬	その人の人格をトウトいものと思いウヤマうこと。リスペクト。
尊敬語	ソンケイゴ。
尊重	トウトいものとしてオモんずること。
導体	電気や熱をよく伝える物タイ。
導入	外部からミチビきイれること。「消費税○○」
導火線	ドウカセン。
小中一貫教育	ショウチュウイッカンキョウイク。
小人	コビト。
小便	ショウベン。
小保方晴子	オボカタハルコ。
小児	小さい子。
小児科	ショウニカ。
小児科医	ショウニカイ。
小刀	コガタナ。
小切手	コギッテ。
小判	コバン。
小刻	コキザみ。
小包	コヅツミ。
小型	コガタ。
小型化	コガタカ。
小型自動車	コガタジドウシャ。
小型車	コガタシャ。
小型飛行機	コガタヒコウキ。
小声	チイさなコエ。
小売価格	コウリカカク。
小売店	コウリテン。
小学校	ショウガッコウ。
小学校低学年	ショウガッコウテイガクネン。
小学校高学年	ショウガッコウコウガクネン。
小学生	ショウガクセイ。
小屋	小さくて簡単な作りの建築物。
小川	オガワ。
小惑星	ショウワクセイ。
小指	コユビ。
小数点	ショウスウテン。
小文字	コモジ。
小枝	コエダ。
小柄	コガラ。
小皿	コザラ。
小脳	後頭部の下の方にあるチイさなノウ。
小腸	栄養吸収の主役。大チョウよりも細い。
小規模	ショウキボ。
小言	コゴト。
小説	ショウセツ。
小説家	ショウセツカ。
小豆	アズキ。
小走	コバシり。
小道具	コドウグ。
小選挙区	ショウセンキョク。
小銭	コゼニ。
小雨	コサメ。
小額投資非課税制度	ショウガクトウシヒカゼイセイド。
小骨	コボネ。
小鳥	コトリ。
小麦	コムギ。
小麦粉	コムギコ。
小麦色	コムギの種子のようなイロ。よく日焼けした肌のイロ。
少女	年若いオンナの子。
少子化	ショウシカ。
少子化対策	ショウシカタイサク。
少子高齢化	ショウシコウレイカ。
少年	トシの若い男子。
少年時代	ショウネンジダイ。
少年法	ショウネンホウ。
少年犯罪	ショウネンハンザイ。
少年野球	ショウネンヤキュウ。
少年院	ショウネンイン。
少数	マイノリティ。
少数意見	ショウスウイケン。
少数民族	ショウスウミンゾク。
少数派	ショウスウハ。
少量	スクないリョウ。
少量生産	ショウリョウセイサン。
少額	スクない金ガク。
少食	あまりタべないこと。
就任	ある地位や役職にツくこと。「社長に○○する」
就活	シュウ職カツ動の略。
就活生	シュウカツセイ。
就職	仕事にツくこと。
就職内定率	シュウショクナイテイリツ。
就職志願者	シュウショクシガンシャ。
就職氷河期	シュウショクヒョウガキ。
就職活動	シュウショクカツドウ。
就職率	シュウショクリツ。
就職試験	シュウショクシケン。
就職説明会	シュウショクセツメイカイ。
尺八	シャクハチ。
尺度	長さ。寸法。スケール。
局員	郵便キョクの人。放送キョクの人。
局部	全体のうち、限られたブ分。体の一ブ分。
局長	郵便キョクのオサ。放送キョクのオサ。
局面	碁・将棋などの勝負の形勢。情勢。
居候	イソウロウ。
居場所	イバショ。
居心地	イゴコチ。
居所	イドコロ。
居留守	イルス。
居酒屋	イザカヤ。
居間	リビングルーム。
屈折	光などがオれ曲がって進むこと。
届出	トドケデ。
屋上	オクジョウ。
屋内	家オクのウチ側。「○○プール」
屋台	ヤタイ。
屋台骨	ヤタイボネ。「○○○がゆらぐ」
屋外	家オクのソト側。
屋根	ヤネ。
屋根裏	ヤネウラ。
屋根裏部屋	ヤネウラベヤ。
展望	遠くまで見渡すこと。見晴らし。
展望台	テンボウダイ。
展示	作品などを並べて、多くの人に見せること。 
展示会	テンジカイ。
展示品	テンジヒン。
展示場	テンジジョウ。
展覧会	テンランカイ。
展開	広くひろげること。「○○図」
展開図	テンカイズ。
属国	ゾッコク。
属性	ある事物に属する性質・特徴。ゾクセイ。
山中	ヤマのナカ。
山分	ヤマワけ。
山口県	本州最西端に位置するケン。フグの名産地。
山場	ヤマバ。
山小屋	ヤマゴヤ。
山形県	東北地方南西部に位置するケン。サクランボの名産地。
山村	ヤマのムラ。
山林	ヤマのハヤシ。
山梨県	本州内陸部に位置するケン。ヤマがあるのに…。
山河	「国破れて○○あり」
山火事	ヤマカジ。
山盛	ヤマモり。
山積	ヤマのようにツみ重なっていること。
山紫水明	けしきが清らかで、美しいこと。
山脈	「ヒマラヤ○○」「アルプス○○」
山菜	ヤマに自生している食用の植物。フキノトウ・ゼンマイなど。
山車	ヤマのクルマと書いてダシ。
山道	ヤマミチ。
山里	ヤマザト。
山野	ヤマとノ原。
山間	ヤマとヤマとのアイダ。
山頂	ヤマのてっぺん。
岐阜県	中部地方の内陸部にあり、滋賀県と隣接するケン。
岡山県	中国地方南東部に位置するケン。
岩場	イワの多い所。
岩塩	鉱物として産出されるシオ。
岩山	イワヤマ。
岩手県	東北地方に属するケン。ケン庁所在地は、盛岡市。
岩石	ガンセキ。
岩穴	イワアナ。
岸辺	キシのホトリ。
島国	シマグニ。「○○根性」
島根県	鳥取ケンのすぐ西のケン。
崩壊	ホウカイ。
崩御	ホウギョ。
川下	カワシモ。
川原	カワラ。
川岸	カワギシ。
川底	カワゾコ。
川沿	カワゾい。
巣立	スダち。
巣箱	スバコ。
工事	「土木○○」「公共○○」
工作	ク夫して物をツクること。
工作員	スパイ。「北朝鮮の○○○」
工作機械	コウサクキカイ。
工具	コウ作に用いる道グ。
工場	ファクトリー。「○○見学」
工場排水	コウジョウハイスイ。
工場見学	コウジョウケンガク。
工夫	いろいろと考えて良い手段を見いだすこと。
工期短縮	コウキタンシュク。
工業	原料を加コウし、種々の製品を生産する産ギョウ。
工業団地	コウギョウダンチ。
工業地帯	コウギョウチタイ。
工程	生産・加コウを行うための作業の手順。作業の各段階。
工面	必要な金銭・品物などをやりくりすること。
左利	ヒダリキき。
左右	ヒダリとミギ。
左右対称	サユウタイショウ。
左手	ヒダリテ。
左折	道路などをヒダリへ曲がること。
左足	ヒダリアシ。
巨人	キョジン。
巨体	キョタイ。
巨大	キョダイ。
巨大地震	キョダイジシン。
巨大市場	キョダイシジョウ。
巨額	キョガク。
差別	特定の集団に属する個人に対する不当な扱い。
差別意識	サベツイシキ。
差引	サシヒき。
差額	サガク。
巻尺	マキジャク。メジャー。
巻物	マキモノ。
巻貝	マキガイ。
市場	マーケット。
市場万能主義	シジョウバンノウシュギ。
市場予想	シジョウヨソウ。
市場価格	シジョウカカク。
市場原理	シジョウゲンリ。
市場安定	シジョウアンテイ。
市場競争	シジョウキョウソウ。
市場規模	シジョウキボ。
市場調査	シジョウチョウサ。
市場関係者	シジョウカンケイシャ。
市外局番	シガイキョクバン。
市役所	シヤクショ。
市民	シの住ミン。都シの住ミン。
市民参加	シミンサンカ。
市民団体	シミンダンタイ。
市民団体代表	シミンダンタイダイヒョウ。
市民権	シミンケン。
市民病院	シミンビョウイン。
市民社会	シミンシャカイ。
市民運動	シミンウンドウ。
市民階級	シミンカイキュウ。
市町村	シチョウソン。
市立	シが設立・経営していること。「○○図書館」
市街地	シガイチ。
市販	店で売っていること。
市長	シのオサ。
布団	フトン。
布地	ヌノジ。
布教活動	ある宗キョウを一般に広めるカツドウ。
希少	スクなくてめずらしいこと。
希少価値	キショウカチ。
希望	ホープ。
希望小売価格	キボウコウリカカク。
希望校	キボウコウ。
希望的観測	キボウテキカンソク
希望者	キボウシャ。
希望退職	キボウタイショク。
帝国	広大な領域と多民族を支配する国家。
師弟	シ匠とデ子。
師弟関係	シテイカンケイ。
席順	セキのジュン序。
帯分数	整スウと真ブンスウの和からなるカズ。
帯状	オビのような細長い形・ジョウ態。
帯電	静デン気をオびること。
帰国	クニへカエること。
帰宅	自タクへカエること。
帰省	故郷へカエること。「○○ラッシュ」
帳消	チョウケし。
常夏	トコナツ。
常時	ツネに。いつも。何ドキも。
常温	普通のオン度。
常用漢字	ジョウヨウカンジ。
常緑樹	ジョウリョクジュ。
常識	ジョウシキ。
常連	ジョウレン。
常連客	ジョウレンキャク。
幕府	バクフ。「江戸○○」
干害	日照り続きのために農作物などが受ける被ガイ。
干渉	その国の意思に反して、内政・外交へ介入すること。「内政○○」
干物	ヒモノ。
平仮名	ヒラガナ。
平原	ヘイゲン。
平和	戦争や内戦で、社会が乱れていないこと。
平和主義	ヘイワシュギ。
平和主義者	ヘイワシュギシャ。
平和国家	ヘイワコッカ。
平和憲法	ヘイワケンポウ。
平和賞	ヘイワショウ。
平和賞受賞	ヘイワショウジュショウ。
平地	ヒラたい土チ。
平均	データの中心位置を示す基本統計量。「○○点」
平均価格	ヘイキンカカク。
平均値	ヘイキンチ。
平均台	ヘイキンダイ。
平均寿命	ヘイキンジュミョウ。
平均年齢	ヘイキンネンレイ。
平均所得	ヘイキンショトク。
平均株価	ヘイキンカブカ。
平均点	ヘイキンテン。
平均賃金	ヘイキンチンギン。
平安	無事で穏やかであること。「心の○○」
平安京	「鳴くよウグイス、○○○」
平安時代	平安京に都を移してから約390年間の時代。
平屋	一階建て。ヒラヤ。
平常心	ヘイジョウシン。
平年	いつものトシ。
平成	現在の年号。
平方根	ヘイホウコン。
平日	ヘイジツ。
平時	戦争のないトキ。ヘイ常。
平氏	1185年の壇ノ浦の合戦で滅ぼされた一族。
平気	心に動揺がないこと。なんともないこと。「○○な顔」
平然	周囲の様子に動じないさま。
平熱	健康な人のヘイ常の体オン。
平等	かたよりや差別がなく、みなヒトしいこと。
平行四辺形	二組の対辺がそれぞれヘイコウであるシ角ケイ。
平行棒	２本のバーを使う体操競技の男子種目の一つ。
平身低頭	身をかがめ、頭を下にしてあやまること。
平野	タイらな広い地形。「関東○○」「越後○○」
平面	でこぼこのない、タイらなメン。
平面図	ヘイメンズ。
年上	トシウエ。
年上女性	トシウエジョセイ。
年上男性	トシウエダンセイ。
年下	トシシタ。
年下女性	トシシタジョセイ。
年下男性	トシシタダンセイ。
年中	一ネンジュウ。いつでも。
年功序列	ネンコウジョレツ。
年収	一ネン間のシュウ入。
年号	「平成」「昭和」「大正」
年始	トシのハジめ。
年寄	トシヨり。
年度	４月１日から翌ネン３月３１日までの期間。
年月	ネンゲツ。
年月日	ネンガッピ。
年末	トシのスエ。
年末年始	ネンマツネンシ。
年表	歴史上の出来事をネン代順に記したヒョウ。
年賀状	ネンガジョウ。
年賀葉書	ネンガハガキ。
年輪	木の横断面にみられるほぼ同心円状のワ。
年金	「日本○○機構」「企業○○」「○○手帳」
年金制度	ネンキンセイド。
年間	一ネンのアイダ。
年間売上高	ネンカンウリアゲダカ。
年間指導計画	ネンカンシドウケイカク。
年間消費量	ネンカンショウヒリョウ。
年齢	生まれてから経過したネン数。ヨワイ。
年齢制限	ネンレイセイゲン。
幸福	ハッピー。
幸運	ラッキー。
幹事	会や団体などの世話役。取りまとめる代表。
幹事長	カンジチョウ。
幹線	重要な地域を結ぶ主要なセン。本セン。
幹線道路	カンセンドウロ。
幻影	実際には存在しないのに、存在するかのように見えるもの。
幻想	現実にないことを思い描くこと。
幻覚	現実にないことを見たり聞いたりすること。
幼児	オサナい子ども。
幼児教育	ヨウジキョウイク。
幼児期	ヨウジキ。
幼児語	ヨウジゴ。
幼少期	ヨウショウキ。
幼心	オサナゴコロ。
幼虫	ヨウチュウ。「セミの○○」
広告	ヒロく世間にツげること
広告主	コウコクヌシ。
広告媒体	コウコクバイタイ。
広告掲載	コウコクケイサイ。
広場	ヒロく開けたバ所。
広大	ヒロくオオきいさま。
広島土砂災害	ヒロシマドシャサイガイ。
広島弁	ヒロシマベン。
広島県	原爆ドームのあるケン。
広範囲	コウハンイ。
広葉樹	コウヨウジュ。
広言	大げさなことや偉そうなことをイうこと。
広野	ヒロいノ原。
広間	ヒロマ。
床面積	ユカメンセキ。
序列	ジョレツ。
序口	ジョのクチ。
底力	ソコヂカラ。
底辺	テイヘン。
底面	テイメン。
店員	ミセなどで商品販売に従事する人。
店番	ミセバン。
店頭	ミセ先。テントウ。
店頭価格	テントウカカク。
府知事	フチジ。
度合	ドアい。
度外視	ドガイシ。
度胸	「男は○○、女は愛嬌」
座右	「○○の銘」
座布団	ザブトン。
座席	ザセキ。
座席番号	ザセキバンゴウ。
座席表	ザセキヒョウ。
座視	黙って見ているだけ。「○○できない」
座談会	ザダンカイ。
座高	スワったときの背のタカさ。
庭園	自然の物を美しく取り入れたニワ。「日本○○」
庭石	ニワにあるイシ。
廃品回収	ハイヒンカイシュウ。
延期	決めたキ日・キ限をノばすこと。
延焼	モえ広がること。
延長	ナガさや期間をノばすこと。
延長戦	エンチョウセン。
建前	タテマエ。
建国	新しくコッ家をつくりあげること。
建国記念	2月11日は、○○○○の日。
建物	タテモノ。
建物面積	タテモノメンセキ。
建築	ケンチク。
建築家	ケンチクカ。
建築工事	ケンチクコウジ。
建築業	ケンチクギョウ。
建築物	ケンチクブツ。
建設	ケンセツ。
建設予定地	ケンセツヨテイチ。
建設会社	ケンセツガイシャ。
建設工事	ケンセツコウジ。
建設業	ケンセツギョウ。
建設機械	ケンセツキカイ。
建設的議論	ケンセツテキギロン。
建設計画	ケンセツケイカク。
建設費用	ケンセツヒヨウ。
建造物	ケンゾウブツ。
弁当	ランチボックス。
弁当屋	ベントウヤ。
弁当箱	ベントウバコ。
弁明	事情などを説明してはっきりさせること。
弁解	言いわけをすること。「○○の余地はない」
弁護	その人の利益となることを主張して助けること。
弁護士	ベンゴシ。
式場	シキを行うバ所。「結婚○○」
式辞	儀シキの席で述べるあいさつの言葉。
弓形	ユミのカタチ。
弓矢	ユミヤ。
弓道	ユミを射る術。キュウドウ。
弓道部	キュウドウブ。
引力	ヒき寄せるチカラ。
引火	他のヒや熱によって物が燃え出すこと。
引用	他の人の文章をヒっ張って使うこと。
引退	立場や活動から離れ、以後、活動をしないこと。
引金	ヒきガネ。
弟子	デシ。
弱体化	ジャクタイカ。
弱気	ヨワキ。
弱点	ジャクテン。
弱者	ヨワいモノ。
弱肉強食	ヨワい者は、ツヨい者のえじきになること。
弱虫	ヨワムシ。
弱音	ヨワネ。
張本人	チョウホンニン。
張紙	ハりガミ。
強制	力によって他人を従わせること。
強制労働	キョウセイロウドウ。
強制収容所	アウシュヴィッツや北朝鮮の施設といえば…
強制排除	キョウセイハイジョ。
強力	ツヨいチカラ。
強化	ツヨくすること。
強固	ツヨくカタいこと。
強大	ツヨくオオきいこと。
強度	ツヨさのド合い。
強引	ゴウイン。
強弱	ツヨいこととヨワいこと。
強情	かたくなに意地を張るさま。頑固。
強敵	ツヨいテキ。
強気	ツヨキ。
強盗	脅迫などを行って金品を奪うこと。「コンビニ○○」
強盗事件	ゴウトウジケン。
強盗殺人事件	ゴウトウサツジンジケン。
強行	無理・障害の多いことを思い切ってオコナうこと。 
当事者	トウジシャ。
当分	ここしばらく。「○○の間、だめだね」
当日	トウジツ。
当時	過去の一ジ期を指して言う言葉。
当然	そうなるのが当たり前であること。
当番	仕事をするバンにアたること。
当選	「宝くじに○○しました」
当選番号	トウセンバンゴウ。
当選発表	トウセンハッピョウ。
形勢	情セイ。なりゆき。様子。「○○が逆転する」
形容詞	ケイヨウシ。
形式的	ケイシキテキ。
形状	目に見えるカタチ。ケイジョウ。
形状記憶合金	ケイジョウキオクゴウキン。
形見	死んだ人や別れた人を思い出す頼りとなる品。 
影武者	カゲムシャ。
影絵	カゲエ。
役不足	ヤクブソク。
役人	ヤクニン。
役割	ヤク目をワり当てること。
役割分担	ヤクワリブンタン。
役所	ヤクショ。
役目	ヤクメ。
役者	ヤクシャ。
往復	行ったり来たりすること。「○○切符」
往復切符	オウフクキップ。
往生	死ぬこと。あきらめて、おとなしくすること。
往生際	オウジョウギワ。
征服	武力で敵を負かし、支配下におくこと。
待合室	マチアイシツ。
待望	マちノゾむこと。
待機	時キのくるのをマつこと。
待機児童	タイキジドウ。
後世	ノチのヨ。ノチのヨの人。
後光	背中からの神聖なヒカリ。「大仏に○○が差す」
後半	二つに分けたうちの、ウシロハン分。 
後半戦	コウハンセン。
後味	アトアジ。
後回	アトマワし。
後始末	アトシマツ。
後姿	ウシロスガタ。
後方	ウシロのホウ。
後方確認	コウホウカクニン。
後日	そのヒよりアトのヒ。
後期高齢者	コウキコウレイシャ。
後継者	コウケイシャ。
後足	ウシロアシ。
後退	ウシロへシリゾくこと。
後進国	コウシンコク。
後遺症	コウイショウ。
後頭部	コウトウブ。
徒歩	とぼとぼアルいて。
徒競走	トキョウソウ。
従事	仕ゴトに携わること。ジュウジ。
従来	以前から今まで。これまで。「○○の方式」
従来方式	ジュウライホウシキ。
従業員	ジュウギョウイン。
従順	人の言うことに逆らわず、素直でおとなしいさま。
得体	正タイ。本性。「○○の知れない生き物」
得意	上手にこなせることに自信があるさま。
得意先	トクイサキ。
得意技	トクイワザ。
得点	テンを取ること。
御中	郵便物で団体名の後に添える言葉。オンチュウ。
御利益	ゴリヤク。
御役所仕事	オヤクショシゴト。
御用学者	ゴヨウガクシャ。
御都合主義	ゴツゴウシュギ。
御飯	ゴハン。
復元	モトの状態に戻すこと。
復刻版	フッコクバン。
復旧	前の状態に戻すこと。「○○工事」
復活	生き返ること。
復習	一度ナラったことを繰り返して勉強すること。
復興	一度衰えたものが再び勢いを取り戻すこと。
徳島県	四国の東部に位置するケン。阿波踊りの本場。
徳用	安くて得なこと。
徳用品	トクヨウヒン。
心不全	シンフゼン。
心中	一緒に自殺すること。
心労	ココロの疲れ。
心地	ココチ。
心境	ココロの状態。胸の中。「○○を語る」
心外	思いもよらないこと。「疑われるとは○○だ」
心得	ココロエ。
心情	ココロの中にある思いや感ジョウ。
心構	ココロガマえ。
心機一転	ココロの持ち方をかえて、新しい気持ちで積極的にやること。
心残	ココロノコり。
心理	ココロの働き。ココロの動き。
心理学	シンリガク。
心肺停止	シンパイテイシ。
心臓	血液を全身に送る臓器。
心臓病	シンゾウビョウ。
心臓発作	シンゾウホッサ。
心身	ココロとカラダ。
心配	先行きなどを気にしてココロを悩ますこと。
心配事	シンパイゴト。
心電図	シンデンズ。
必修科目	ヒッシュウカモク。
必勝	カナラずカつこと。
必勝法	ヒッショウホウ。
必死	シに物狂い。一生懸命。全力を尽くすこと。
必然	カナラずそうなること。「なまけたら不合格は○○だ」
必着	郵便物などがカナラずツくこと。
必至	カナラずそれにイタること。「総辞職は○○の状況だ」
必要	カナラず、なくてはならないこと。
必要不可欠	ヒツヨウフカケツ。
必要事項	ヒツヨウジコウ。
必要性	ヒツヨウセイ。
必要条件	ヒツヨウジョウケン。
必読	カナラずヨまなければいけないこと。
必読書	ヒツドクショ。
必需品	ヒツジュヒン。
志望	こうなりたい、こうしたいとノゾむこと。
志願	希望してネガい出ること。「○○兵」
志願者	シガンシャ。
忘却	ワスれ去ること。
忘年会	ボウネンカイ。
忘物	ワスれモノ。
応募	ボ集にオウじること。
応募作品	オウボサクヒン。
応募資格	オウボシカク。
応対	相手に受け答えをすること。「電話の○○」
応戦	敵の攻撃に対してタタカうこと。
応接室	オウセツシツ。
応接間	オウセツマ。
応援	他人の手助けをすること。
応援団	オウエンダン。
応用	理論や知識を他の事柄にあてはめてモチいること。
応用問題	オウヨウモンダイ。
応用科学	オウヨウカガク。
応答	受けコタえ。「○○せよ」
忠告	心をこめて、過ちや欠点を直すように言うこと。
忠実	少しの誤りやいつわりもなく正確であるさま。
忠誠	チュウ義を尽くすこと。
快感	気持ちのいいカンじ。
快挙	すばらしい行動。「○○をなしとげる」
快方	病気や怪我が治ってくること。「病状が○○に向かう」
快晴	空が気持ちよくハれ渡ること。
快楽	こころよくタノしいこと。
快調	チョウ子がよくて気持ちいいこと。
快速	気持ちのいいほど、ハヤいこと。
快適	不快に感じられるところがなく気持ちがいいこと。
念仏	ネンブツ。
念入	ネンイり。
念頭	心のうち。頭の中。「○○に置く」
念願	かねてからのネガい。「○○がかなう」
思出	オモいデ。
思想	政治や社会についてのまとまった考え・意見。
思想家	シソウカ。
思想統制	シソウトウセイ。
思案	心配。物思い。「引っ込み○○」
思考	オモいカンガえること。
思考停止	シコウテイシ。
急停車	キュウテイシャ。
急務	イソいですべき仕事や任ム。
急増	キュウにフえること。
急所	生命にかかわる大事なトコロ。
急死	キュウにシぬこと。
急流	速い流れ。
急激	変化や動きなどがキュウでハゲしいさま。
急病	キュウに起こるビョウ気。
急足	イソぎアシ。
急速	変わり方が非常にハヤいさま。「○○に普及する」
急降下	キュウコウカ。
性別	男と女の区ベツ。
性同一性障害	セイドウイツセイショウガイ。
性格	生まれつきの品セイ。人柄。
性格診断	セイカクシンダン。
性犯罪	セイハンザイ。
性能	機械などが仕事をなしえるノウ力。パフォーマンス。
性質	その物に本来、備わっている特徴。「燃えやすい○○」
怪我	ケガ。
怪談	アヤしい話。奇カイな話。
恋人	コイビト。
恋愛	レンアイ。
恋愛小説	レンアイショウセツ。
恋愛映画	レンアイエイガ。
恩人	助けてくれたヒト。「命の○○」
恩師	助けてくれた先生。教えてもらった先生。
恩返	オンガエし。
息切	イキギれ。
息子	ムスコ。
息子夫婦	ムスコフウフ。
患者	病人やけが人。「外来○○」「入院○○」
悪事	アクジ。
悪人	アクニン。
悪党	ワル者の仲間。
悪化	ワルくなること。
悪口	ワルグチ。
悪夢	ワルいユメ。
悪天候	アクテンコウ。
悪寒	全身がぞくぞくとする不快なサムけ。
悪徳	道徳に反する行為または精神。「○○弁護士」
悪意	ワルいイ図。
悪戦苦闘	ひじょうに苦しい戦いをしていること。
悪材料	アクザイリョウ。
悪気	ワルギ。
悪玉	アクダマ。
悪用	ワルいことにモチいること。
悪知恵	ワルヂエ。
悪者	ワルモノ。
悪質	シツがワルいこと。「○○ドライバー」
悪運	アクウン。
悲劇	主人公が不幸な結末に至るゲキ。「○○のヒロイン」
悲報	カナしいシラせ。
悲観	悪い結果を予想して気を落とすこと。
悲観的	ヒカンテキ。
悲運	カナしいウン命。
悲願	強くネガうこと。ヒガン。
悲鳴	高い叫び声。「きゃあという○○」
情勢	状況の流れや方向。「国際○○」
情報	インフォメーション。
情報不足	ジョウホウブソク。
情報交換	ジョウホウコウカン。
情報公開	ジョウホウコウカイ。
情報公開請求	ジョウホウコウカイセイキュウ。
情報共有	ジョウホウキョウユウ。
情報処理	ジョウホウショリ。
情報化社会	ジョウホウカシャカイ。
情報収集	ジョウホウシュウシュウ。
情報技術	ジョウホウギジュツ。IT。
情報提供	ジョウホウテイキョウ。
情報機器	ジョウホウキキ。
情報機関	ジョウホウキカン。
情報流出	ジョウホウリュウシュツ。
情報源	ジョウホウゲン。
情報発信	ジョウホウハッシン。
情報管理	ジョウホウカンリ。
情報管理体制	ジョウホウカンリタイセイ。
情報通信技術	ジョウホウツウシンギジュツ。
情報連絡室	ジョウホウレンラクシツ。
情報開示	ジョウホウカイジ。
情景	ある種の感ジョウを起こさせる光ケイ。
情熱	激しく高まった気持ち。「○○の赤いバラ」
情緒	「異国○○」「○○不安定」
情緒不安定	ジョウチョフアンテイ。
惑星	「地球は水の○○である」
想像	現実には存在しないことを思い描くこと。
想像力	ソウゾウリョク。
想定	状況などを仮に決めること。「地震を○○する」
想定内	事前に予ソウした範囲の内に収まっていること。
想定外	事前に予ソウした範囲からハズれること。
意向	どうするつもりかという考え。「相手の○○を確かめる」
意味	事柄や表現に対する役割や情報。
意味深長	フカいイミがあること。
意図	何かをしようとすること。
意地	自分の考えを通そうと思う気持ち。「男の○○」
意地悪	イジワル。
意外	わりと。思ったよりも。案ガイ。
意志	目標を達成しようとする自発的な思考。
意思決定	イシケッテイ。
意思表示	イシヒョウジ。
意欲	進んで何かをしようと思うこと。「創作○○」
意気地	「これしきで弱音をはくとは○○○い」
意義	その事柄が持つ価値・重要性。「活動に○○がある」
意表	思いも及ばないこと。「○○を突く」
意見	あることに対する主張・考え。
意見交換	イケンコウカン。
意見書	イケンショ。
意見集約	イケンシュウヤク。
意識	自律的な心の働き。イシキ。
意識改革	イシキカイカク。
意識調査	イシキチョウサ。
愛国心	アイコクシン。
愛好	ある事を好み楽しむこと。「音楽○○家」
愛好家	アイコウカ。
愛媛県	四国地方の北西部から北中部に位置するケン。
愛情	心から大切に思うあたたかい気持ち。「○○を注ぐ」
愛想	人に接するときの態度。「○○笑い」
愛煙者	タバコを吸う人。アイエンカ。
愛犬	好きなイヌ。
愛用	好んで使うこと。
愛用者	アイヨウシャ。
愛着	慣れ親しんだ物事に心を引かれ、離れがたく感じること。
愛知県	名古屋市のある、太平洋に面するケン。
愛称	親しみをこめて呼ぶ呼び名。ニックネーム。
愛読	好んでヨむこと。
愛読書	アイドクショ。
感動	すばらしく心動かされること。
感度	光などの外部刺激に対する敏カンさの尺度。
感心	すぐれたものとしてココロ動かされること。
感情	物事や人間などに対して抱く気持ち。カンジョウ。
感情移入	カンジョウイニュウ。
感想	カンじたり、思ったりしたこと。
感想文	カンソウブン。
感染	病原菌が一個体に寄生すること。「○○経路」
感染拡大	カンセンカクダイ。
感染源	カンセンゲン。
感染確認	カンセンカクニン。
感染経路	カンセンケイロ。
感激	すばらしさに心を打たれ、カン情が高まること。
感覚	身体の内外から受けた刺激を感じ取る働き。
感触	サワったカンじ。
感謝	ありがたさをカンじてシャ意を表すること。
感謝状	カンシャジョウ。
感電	デン気が流れて衝撃を受けること。デン気ショック。
感電死	カンデンシ。
態度	事に臨むときの心構え。
慣例	習カンのようになったやり方。
慣用句	カンヨウク。
憲法	国の統治の基本原理を定めた法。
憲法改正	ケンポウカイセイ。
憲法解釈	ケンポウカイシャク。
憲法解釈変更	ケンポウカイシャクヘンコウ。
憲法記念日	ケンポウキネンビ。
憲法違反	ケンポウイハン。
成人	おとナにナったヒト。
成人式	セイジンシキ。
成仏	ホトケにナること。
成分	ある物を構成する要素・物質。「○○分析」「○○表」
成功	サクセス。
成功体験	セイコウタイケン。
成功例	セイコウレイ。
成果	ナしとげた結カ。
成果主義	セイカシュギ。
成田空港	ナリタクウコウ。
成立	物事がナりタつこと。「法律が○○する」
成績	事業・仕事・学業などのできぐあい。
成績優秀	セイセキユウシュウ。
成績表	セイセキヒョウ。
成虫	「さなぎから○○になる」
成金	ナリキン。
成長	動物が大きさ・重量を増していく現象。
成長分野	セイチョウブンヤ。
成長戦略	セイチョウセンリャク。
成長物語	セイチョウモノガタリ。
成長率目標	セイチョウリツモクヒョウ。
成長産業	セイチョウサンギョウ。
我慢	ガマン。
我流	自分勝手なやり方。自己リュウ。
我田引水	自分の都合の良いように行動すること。
戦乱	イクサによる世のミダれ。
戦争	軍事的な力によって行われる政治集団間のアラソい。
戦争犯罪	センソウハンザイ。
戦力	タタカうチカラ。
戦国時代	センゴクジダイ。
戦場	イクサの現バ。
戦後	セン争のアト。
戦後日本	センゴニッポン。
戦後民主主義	センゴミンシュシュギ。
戦時	セン争をしているトキ。
戦死者	センシシャ。
戦略家	センリャクカ。
戦術	イクサをするスベ。
戦車	セン闘用・セン争用のクルマ。
戸別訪問	コベツホウモン。
戸口	玄関。トグチ。
戸籍	人の出生から死亡までの出来事を記録した文書。
所在	存ザイする場ショ。
所在地	ショザイチ。
所属	ショゾク。「芸能事務所○○」
所帯	一家を構えて独立した生計を営むこと。「○○持ち」
所得	トクをすること。もうけること。「○○税」
所得倍増計画	ショトクバイゾウケイカク。
所得制限	ショトクセイゲン。
所得格差	ショトクカクサ。
所得税	ショトクゼイ。
所持	持ち歩くこと。携帯すること。「拳銃を○○する」
所持品	ショジヒン。
所持金	ショジキン。
所有権	ショユウケン。
所有物	ショユウブツ。
所有者	ショユウシャ。
所長	事務ジョ・研究ジョ・出張ジョなどのオサ。
扇風機	センプウキ。
手下	テシタ。
手伝	テツダい。
手作業	テサギョウ。
手元	テモト。
手先	テサキ。
手加減	テカゲン。
手助	テダスけ。
手動	テでウゴかすこと。
手口	悪事などを行なった方法。「巧妙な○○」
手品	テジナ。
手土産	テミヤゲ。
手帳	携帯して心覚えを記入する小形のチョウ面。「健康○○」
手当	テアて。
手形	テガタ。
手招	テマネき。
手探	テサグり。
手数	テスウ。
手数料	テスウリョウ。
手料理	テリョウリ。
手旗信号	テバタシンゴウ。
手本	見習うべき物事。模範。「お○○となる人」
手段	目的をとげるのに必要な方法。「最後の○○」
手相	手の平に刻まれた線などの状態。「○○占い」
手相占	テソウウラナい。
手短	テミジカ。
手紙	テガミ。
手続	テツヅき。
手羽先	テバサキ。
手芸	裁縫（さいほう）、刺繍（ししゅう）、編み物など。
手荷物	テニモツ。
手術	身体を切り開いて行われる治療行為。オペ。
手術台	シュジュツダイ。
手術室	シュジュツシツ。
手製	自分で作ること。作ったもの。
手足	テとアシ。
手軽	テガル。
手配	必要な物や人の準備・連絡など。「指名○○」
手鏡	テカガミ。
手間	テマ。「二度○○」
手際	テギワ。
手順	テジュン。
手首	テクビ。
才能	物事をうまくなしとげるすぐれた能力。
才色兼備	美人で頭の良い女性をほめる言葉。
打切	ウちキり。
打撃	強くウつこと。損害・痛手など。
打楽器	ダガッキ
打消	ウちケし。
打球	バットでウったタマ。タマをウつこと。
打破	ウちヤブること。
打者	バッター。
打開	行き詰まった点を切りヒラくこと。「○○策」
打開策	ダカイサク。
打順	バッターになるジュン番。
批判	善悪をハン断して、悪い所を指摘すること。
批評	是非・善悪などを指摘し、自分のヒョウ価を述べること。
批評家	ヒヒョウカ。
承知	事情などをシること。「無理を○○でお願いする」
承認	事柄が正当であると判断すること。「理事会が○○した事項」
技能	人間がもつワザに関するノウ力。
技術	テクニック。
技術情報	ギジュツジョウホウ。
技術者	ギジュツシャ。
技術開発	ギジュツカイハツ。
技術面	ギジュツメン。
技術革新	ギジュツカクシン。
抑止力	ヨクシリョク。
抑止力維持	ヨクシリョクイジ。
投下	高い所から物をナげ落とすこと。「ヘリから物資を○○する」
投入	物をナげイれること。ナげ込むこと。
投手	ピッチャー。
投球	野球のピッチ。タマをナげること。
投票	選挙で候補を選んでヒョウを入れること。
投票所	トウヒョウジョ。
投票日	トウヒョウビ。
投票権	トウヒョウケン。
投票率	トウヒョウリツ。
投票用紙	トウヒョウヨウシ。
投票箱	トウヒョウバコ。
投稿	原コウ・文章を送ること。トウコウ。
投資	収益を期待してシ金を支出すること。
投資家	トウシカ。
投資家心理	トウシカシンリ。
投資資金	トウシシキン。
投身自殺	トウシンジサツ。
抗生物質	コウセイブッシツ。
抗議	相手の行動や処置などに反対の意見を伝えること。
折紙	オりガミ。
抵抗勢力	テイコウセイリョク。
担任	一定のニン務をタン当すること。「クラスの○○」
担保	将来起こりうる不利益に対してそれを補うことを保証する物。
担当	事にアたること。引き受けること。「営業○○の佐藤です」
担当者	タントウシャ。
拍手	ハクシュ。
拒否	コバみ、断ること。
拒否権	キョヒケン。
招待	客をマネいてもてなすこと。
招待券	ショウタイケン。
招待客	ショウタイキャク。
招待状	ショウタイジョウ。
拝借	「お手を○○いたします」
拝見	見ることをへりくだっていう語。
拡声器	カクセイキ。
拡大	広げてオオきくすること。←→縮小
拡大鏡	カクダイキョウ。
拡張	範囲を広げて大きくすること。「軍備○○」
拾得物	ヒロったモノ。シュウトクブツ。
拾物	ヒロいモノ。
拾読	ヒロいヨみ。
持久力	ジキュウリョク。
持久戦	ジキュウセン。
持参	モって行くこと。モって来ること。
持参金	ジサンキン。
持味	モちアジ。
持病	ジビョウ。
持続	ある状態がそのままツヅくこと。「効果が○○する」
指人形	ユビニンギョウ。
指令	コマンド。
指先	ユビサキ。
指切	ユビキり。
指名	ナを挙げて特定の人をサすこと。
指名手配	シメイテハイ。
指名競争入札	シメイキョウソウニュウサツ。
指図	サシズ。
指圧	シアツ。
指定	いくつかの中からこれと決めてサダめること。
指定席	シテイセキ。
指定廃棄物	シテイハイキブツ。
指定暴力団	シテイボウリョクダン。
指導	ある目的・方向に向かって教えミチビくこと。
指導者	シドウシャ。
指導要領	シドウヨウリョウ。
指揮	多くの人をサシズして、従わせること。
指揮官	シキカン。
指揮棒	シキボウ。
指揮者	シキシャ。
指示	物事をそれとサしシメすこと。
指輪	ユビワ。
挑戦者	チョウセンシャ。
挙動不審	キョドウフシン。
挙式	シキ、特に結婚シキをアげること。
挙手	テをアげること。
振動	フルえてウゴくこと。
振替休日	フリカエキュウジツ。
振込手数料	フリコミテスウリョウ。
捨石	スてイシ。
捨身	スてミ。
授乳	乳を与えること。
授乳期	ジュニュウキ。
授業	教師が生徒に知識や技能を習得させる活動。
授業中	ジュギョウチュウ。
授業料	ジュギョウリョウ。
授業日数	ジュギョウニッスウ。
授業時間	ジュギョウジカン。
授賞	ショウをサズけること。
授賞式	ジュショウシキ。
排他的経済水域	ハイタテキケイザイスイイキ。
排出量	ハイシュツリョウ。
排気	ハイ出されるキ体。「車の○○ガス」
排除	押し出してそこから取りノゾくこと。
採取	必要なものを選びトること。「指紋を○○する」
採決	会議としての賛否を求め、議案の可否をケッ定すること。
採点	テストなどに得テンをつけること。
採用	適当と思われるものを、トり上げてモチいること。
採用基準	サイヨウキジュン。
採用者数	サイヨウシャスウ。
採用試験	サイヨウシケン。
採用通知書	サイヨウツウチショ。
採算	商売での収入と支出のつりあい。「○○が取れない」
採血	ケツ液をトること。
採集	標本や資料にするため、トってアツめること。
探偵	他人の秘密をひそかに調査する仕事。
探検	危険を冒して未知の地域に入り、実地に調べること。
探検家	ボウケンカ。
探検隊	ボウケンタイ。
接待	企業が取引先を飲食店などでもてなすこと。
接点	曲線または曲面と直線などがセッするテン。
接着	くっつけること。「○○剤」
接着剤	セッチャクザイ。
接着力	セッチャクリョク。
接続	二つ以上のものがつながること。
接続詞	「そして」「だから」「すると」
接触	フれ合うこと。 関係を持つこと。
接近	チカ寄ること。チカづくこと。
接骨医	セッコツイ。
推定	あることから他のことをスイ測・認テイすること。
推察	他人の事情や心中を思いやること。
推測	ある情報に基づいて、オしハカって考えること。
推理	事実を元にして、未知の事柄をオしはかること。
推理小説	スイリショウセツ。
推移	物事の状態の移り変わり。「事件の○○を見守る」
推論	既知の事実を元にして未知のことについてロンじること。
推進	物を前へオしススめること。
推進力	スイシンリョク。
掲示板	ケイジバン。
掲載	新聞・雑誌などに文章や写真をノせること。
提供	相手に役立ててもらうために金品などを差し出すこと。
提供者	テイキョウシャ。
提出	文書などをある場所に差しダすこと。 
提出日	テイシュツビ。
提出物	テイシュツブツ。
提唱	意見・主張などをトナえ、発表すること。
提案	アイデアなどを出すこと。
提案者	テイアンシャ。
提示	資料などを差し出してシメすこと。テイジ。
提言	考え・意見を皆の前に示すこと。テイゲン。
換気	空キを入れカえること。
換気扇	カンキセン。
換算	ある数値をほかの単位にカえて計サンすること。
揮発	常温で液体が気体になること。
揮発性	キハツセイ。
援助	困っている人に力を貸すこと。「資金を○○する」
援助交際	未成年の学生が金銭目的で成人男性と交際すること。
損傷	人や物などがソコなわれキズつくこと。
損失	ソコないウシナうこと。
損害	事故や災害による金銭・物質上の不利益。「○○賠償」
損得	ソンとトク。ソン益。
損益	ソン失と利エキ。ソン得。
携帯	身につけたり、手に持ったりすること。
携帯電話	ケイタイデンワ。
携帯電話中継基地局	ケイタイデンワチュウケイキチキョク。
撃退	ゲキタイ。
撮影	サツエイ。
操作	機械・器具などを動かして、サ業させること。
操縦	飛行機などをソウ作して移動させること。
操縦士	ソウジュウシ。
操縦席	ソウジュウセキ。
支出	シシュツ。
支出額	シシュツガク。
支店	本テン以外の営業所。
支度	シタク。
支持	サポーター。
支持団体	シジダンタイ。
支持層	シジソウ。
支持拡大	シジカクダイ。
支持政党	シジセイトウ。
支持率	シジリツ。
支持者	シジシャ。
支援	労力や金銭面でササえ助けること。
支援事業	シエンジギョウ。
支援制度	シエンセイド。
支柱	物が倒れないようにササえるハシラ。
支点	てこの原理において、てこのササえとなるテン。
支給	金銭・物品を払い渡すこと。「ボーナスを○○する」
支配	他者を自分の意のままに動かせる状態にすること。
支配人	シハイニン。
支配者	シハイシャ。
支障	差しツカえ。差しサワり。「○○をきたす」
支離滅裂	めちゃくちゃで筋が通っていないこと。
改修	カイシュウ。リフォーム。
改修工事	カイシュウコウジ。
改名	ナ前をアラタめる。
改善	物事をヨい方にアラタめること。カイゼン。
改善命令	カイゼンメイレイ。
改心	これまでを反省して、ココロをアラタめること。
改悪	物事をワルい方にアラタめること。
改憲	ケン法を変えること。
改札	駅で客の乗車券類を検査する場所。
改札機	カイサツキ。
改正	物事をタダしい方にアラタめること。
改正案	カイセイアン。
改築	カイチク。リフォーム。
改良	物事をヨい方にアラタめること。カイリョウ。
改良点	カイリョウテン。
改行	ギョウをアラタめること。
改装	外観や内ソウなどを新しく変えること。
改造	建物・機械・組織などをツクり直すこと。
改造車	カイゾウシャ。
改革	カイカク。
改革断行	カイカクダンコウ。
改革開放	カイカクカイホウ。
攻撃	アタック。
攻撃対象	コウゲキタイショウ。
攻防	コウ撃とボウ御。
攻防戦	コウボウセン。
放出	あふれダすこと。「熱を○○する」
放射冷却	ホウシャレイキャク。
放射性廃棄物	ホウシャセイハイキブツ。
放射性物質	ホウシャセイブッシツ。
放射線	ホウシャセン。
放射線測定	ホウシャセンソクテイ。
放射能	ホウシャノウ。
放水	ミズを勢いよく出すこと。
放水管	ホウスイカン。
放水車	ホウスイシャ。
放流	稚魚や水などを川や海などにハナつこと。
放火	カ事を起こす目的でヒをつけること。
放火罪	ホウカザイ。
放牧	家畜をボク場・ボク野に放って飼育すること。
放物線	ホウブツセン。
放置	ほうったままにすること。「○○自転車」
放置自転車	ホウチジテンシャ。
放課後	アフタースクール。
放送	公衆の受信者に向けて映像や音声などを送信すること。
放送中	オンエア。
放送事故	ホウソウジコ。
放送室	ホウソウシツ。
放送局	ホウソウキョク。
放送技術	ホウソウギジュツ。
放送時間	ホウソウジカン。
放送番組	ホウソウバングミ。
放送禁止	ホウソウキンシ。
放電	蓄えていた電気をハナつこと。
政党	セイ治的主義・主張をもってセイ権獲得をめざす集団。
政党交付金	セイトウコウフキン。
政党支持率	セイトウシジリツ。
政務活動費	セイムカツドウヒ。
政局	セイ治の動向。セイ界の状況。
政府	セイ治を行う機関。
政府主導	セイフシュドウ。
政府専用機	セイフセンヨウキ。
政府系企業	セイフケイキギョウ。
政府軍	セイフグン。
政府関係者	セイフカンケイシャ。
政権	国のセイ治機構を動かすセイ治ケン力。
政権交代	セイケンコウタイ。
政権公約	セイケンコウヤク。マニフェスト。
政権合意	セイケンゴウイ。
政権批判	セイケンヒハン。
政権支持率	セイケンシジリツ。
政権運営	セイケンウンエイ。
政治	国家権力の統チにかかわる活動。
政治不信	セイジフシン。
政治力学	セイジリキガク。
政治圧力	セイジアツリョク。
政治姿勢	セイジシセイ。
政治学者	セイジガクシャ。
政治家	セイジカ。
政治情勢	セイジジョウセイ。
政治決着	セイジケッチャク。
政治活動	セイジカツドウ。
政治的中立性	セイジテキチュウリツセイ。
政治的要求	セイジテキヨウキュウ。
政治経済	セイジケイザイ。
政治結社	セイジケッシャ。
政治資金収支報告書	セイジシキンシュウシホウコクショ。
政治資金規正法	セイジシキンキセイホウ。
政界再編	セイカイサイヘン。
政界引退	セイカイインタイ。
政策	施セイ上の方針や方サク。
政策課題	セイサクカダイ。
政策転換	セイサクテンカン。
故人	亡くなったヒト。コジン。
故意	わざとすること。コイ。
故郷	生まれ育った土地。古里。
故障	機械や身体などに不調が生じ、正常に働かなくなること。
故障中	コショウチュウ。
救世主	キュウセイシュ。
救出	スクいダすこと。
救出作業	キュウシュツサギョウ。
救助	災難や危険にある人をスクいタスけること。 
救助犬	キュウジョケン。
救助隊	キュウジョタイ。
救命具	キュウメイグ。
救命救急士	キュウメイキュウキュウシ
救命胴衣	キュウメイドウイ。
救急	処置がイソがれる急病人や負傷者をスクうこと。
救急医療	キュウキュウイリョウ。
救急車	キュウキュウシャ。
救援活動	キュウエンカツドウ。
救援物資	キュウエンブッシ。
救済	苦しむ人をスクい助けること。
敗北	戦いに負けること。
敗北感	ハイボクカン。
敗因	負けた原イン。
敗戦	負けたタタカい。
敗者	負けた人。「○○復活戦」
敗者復活戦	ハイシャフッカツセン。
教会	共通の信仰によって形成される社会とその建物。
教員免許	キョウインメンキョ。
教室	クラスルーム。
教師	先生。教員。キョウシ。
教授	研究・教育職の最高位。「大学○○」
教材	オシえるザイ料。
教科書	キョウカショ。
教科書検定	キョウカショケンテイ。
教育	指導を通じて知識・技能を身に付けさせること。
教育上	キョウイクジョウ。
教育制度	キョウイクセイド。
教育問題	キョウイクモンダイ。
教育委員会	キョウイクイインカイ。
教育機関	キョウイクキカン。
教育現場	キョウイクゲンバ。
教育評論家	キョウイクヒョウロンカ。
教訓	オシえさとすこと。「○○を得る」
教養	個人の人格に結びついた知識や行い。「この人は○○がある」
散乱	ばらばらにチること。チらばること。
散布	まきチらすこと。「農薬を○○する」
散歩	目的なく、気の向くままに歩くこと。サン策。
散歩道	サンポドウ。
散財	金銭を無駄に使うこと。
散髪	カミを刈り、形を整えること。調ハツ。
敬具	手紙の最後に添える言葉。「拝啓」と対となる。
敬意	相手に対する尊ケイの気持ち。
敬愛	尊ケイと親しみの気持ちを持つこと。
敬礼	相手にケイ意を表し、レイをすること。
敬称	名前の下に付けて、その人への敬意を表す語。
敬語	尊ケイゴ、謙譲語、丁寧語など。
数値	アタイとしてあてはまる具体的なカズ。
数値目標	スウチモクヒョウ。
数字	カズを表すための文ジ。
数字選択式	スウジセンタクシキ。
数学	カズおよび図形などに関するガク問。
数式	スウ学的な意味を持つシキ。
数量	カズとリョウ。
整備	調子や状態をトトノえること。
整備工場	セイビコウジョウ。
整列	レツをトトノえて並ぶこと。
整数	…, -2, -1, 0, 1, 2, …
整然	規則正しくトトノっているさま。
整理	乱れているものをそろえ、オトノえること。 
整理券	セイリケン。
敵地	テキの領チ。
敵対	テキとして立ち向かうこと。
敵意	テキ対しようとする心。
敵視	テキとみなすこと。
敵軍	テキのグン隊・グン勢。
敵陣	テキのジン地。
文例	ブンやブン章の実レイ。
文化	カルチャー。
文化大革命	ブンカダイカクメイ。
文化祭	ブンカサイ。
文化財	ブンカザイ。
文化財保護法	ブンカザイホゴホウ。
文化遺産	ブンカイサン。
文句	相手への抗議を言うこと。
文字	かなや英数字などのこと。
文学	言語の表現による芸術一般。
文学賞	ブンガクショウ。
文房具	ブンボウグ。
文明	「メソポタミア○○」「○○開化」
文明開化	ブンメイカイカ。
文末	ブンの最後の方。
文法	ブン章を構成する決まりや規範。
文章	ブンを並べた言語表現。
文節	文を区切った際の最小の言語単位。
文脈	語または文の間の論理的な関係。
文通	手紙をやり取りすること。「○○がある」
文部科学大臣	モンブカガクダイジン。
文部科学省	モンブカガクショウ。
文集	詩歌や文章を集めて１冊にまとめたもの。
料理	食材に手を加え、食べ物をこしらえること。
料理人	リョウリニン。
料理屋	リョウリヤ。
料理教室	リョウリキョウシツ。
料理研究家	リョウリケンキュウカ。
料理長	リョウリチョウ。
料金	物の利用・使用などに対して支払う金。
料金箱	リョウキンバコ。
料金表	リョウキンヒョウ。
料金設定	リョウキンセッテイ。
斜線	ナナめのセン。
斜面	ナナめになったメン。
断固反対	ダンコハンタイ。
断定	はっきりと判ダンを下すこと。
断念	きっぱりあきらめること。「登頂を○○する」
断水	何らかの原因で水の配給が止まること。
断然	態度のきっぱりとしているさま。
断熱性	ダンネツセイ。
断片	細かくちぎれた一ペン。
断行	無理や困難を押して物事を行うこと。
断言	はっきりと言い切ること。明言すること。
断面	物を線で切ダンした切り口のメン。
断食	一定期間ショク事を意図的に絶つ行為。
新世界	シンセカイ。
新人	アタラしいヒト。
新人王	シンジンオウ。
新企画	シンキカク。
新体制	シンタイセイ。
新作	アタラしいサク品。
新入	アタラしくその組織の一員となること。
新入生	シンニュウセイ。
新入社員	シンユウシャイン。
新制度	シンセイド。
新卒採用	シンソツサイヨウ。
新台入替	パチンコの四字熟語と言えば…
新品	アタラしいシナ。
新商品	シンショウヒン。
新型	従来のものとは違う、アタラしいカタ。
新型車	シンガタシャ。
新大陸	シンタイリク。
新天地	シンテンチ。
新婚	結コンしたばかり。
新婚旅行	シンコンリョコウ。
新学期	シンガッキ。
新学習指導要領	シンガクシュウシドウヨウリョウ。
新居	アタラしい住キョ。
新年	アタラしいトシ。
新幹線	シンカンセン。
新感覚	シンカンカク。
新手	アタラしい方法やシュ段。「○○の詐欺」
新技術	シンギジュツ。
新春	アタラしいハル。
新曲	アタラしいキョク。
新月	地球と太陽の中間に月が位置すること。
新潟県	「魚沼産コシヒカリ」が生産されるケン。
新番組	シンバングミ。
新発売	シンハツバイ。
新登場	シントウジョウ。
新種	今までにない、アタラしいシュ。
新築	完成後１年未満で、未入居の物件。
新米	アタラしいコメ。
新約聖書	シンヤクセイショ。
新素材	シンソザイ。
新緑	草木が芽吹き、ミドリが映えるころ。
新聞	ニュースペーパー。
新聞広告	シンブンコウコク。
新聞折込広告	シンブンオリコミコウコク。
新聞社	シンブンシャ。
新聞記事	シンブンキジ。
新聞記者	シンブンキシャ。
新聞購読	シンブンコウドク。
新興国	シンコウコク。
新芽	アタラしく出てきた草木のメ。
新規事業	シンキジギョウ。
新規出店	シンキシュッテン。
新規参入	シンキサンニュウ。
新規株式公開	シンキカブシキコウカイ。
新規登録	シンキトウロク。
新記録	シンキロク。
新設	アタラしくモウけること。
新調	アタラしくこしらえること。「背広を○○する」
新車販売	シンシャハンバイ。
新郎	シンロウ。
新顔	アタラしいカオ。
新館	アタラしいヤカタ。
新鮮	食材などがアタラしくて生き生きしていること。
方位磁石	ホウイジシャク。
方位磁針	ホウイジシン。
方便	「ウソも○○」
方向	ムき。ホウ角。
方向指示器	ホウコウシジキ。
方向転換	ホウコウテンカン。
方法	ある目的を達するためのやりカタ。手段。
方法論	ホウホウロン。
方眼紙	ホウガンシ。
方程式	ホウテイシキ。
方言	地域に定着する、標準的ではないコト葉。
方針	めざすホウ向。ポリシー。
施政方針演説	シセイホウシンエンゼツ。
旅人	タビするヒト。
旅先	タビをしている土地。
旅券	パスポート。
旅客機	リョカクキ。
旅支度	タビジタク。
旅立	タビダち。
旅行	トラベル。「○○会社」
旅行先	リョコウサキ。
旅行者	リョコウシャ。
旅費	リョ行のヒ用。
旅路	タビをして行く道筋。
旅館	リョカン。
旗印	ハタジルシ。
旗手	ハタを持つ役目の人。
既得権益	キトクケンエキ。
日中	ニ本とチュウ国。
日中友好	ニッチュウユウコウ。
日中戦争	ニッチュウセンソウ。
日中関係	ニッチュウカンケイ。
日中首脳会談	ニッチュウシュノウカイダン。
日付	ヒヅケ。
日光	太陽からのヒカリ。
日光東照宮	栃木県の日光市にある有名な神社。
日光浴	ニッコウヨク。
日光消毒	ニッコウショウドク。
日刊紙	ニッカンシ。
日和	何かをするのに、ちょうどよい天気。
日和見主義	ヒヨリミシュギ。
日夜	昼とヨル。昼ヤ。「○○努力する」
日常	ツネヒごろ。普段。
日常生活	ニチジョウセイカツ。
日常英会話	ニチジョウエイカイワ。
日常茶飯事	ニチジョウサハンジ。
日数	経過したヒのカズ。
日時	ヒ付とジ刻。
日時計	ヒドケイ。
日暮	ヒグレ。
日曜	サンデー。
日曜参観日	ニチヨウサンカンビ。
日曜大工	ニチヨウダイク。
日曜日	サンデー。
日本	ジャパン。
日本一	ニホンイチ。
日本人	ニホンジン。
日本代表	ニホンダイヒョウ。
日本代表団	ニンホンダイヒョウダン。
日本企業	ニホンキギョウ。
日本全国	ニホンゼンコク。
日本再生	ニホンサイセイ。
日本刀	ニホントウ。
日本列島	ニホンレットウ。
日本労働組合総連合会	レンゴウ。
日本史	ニホンシ。
日本商工会議所	ニホンショウコウカイギショ。
日本国	ニホンコク。
日本国憲法	ニホンコクケンポウ。
日本地図	ニホンチズ。
日本大使館	ニホンタイシカン。
日本工業規格	ＪＩＳ。
日本放送協会	ＮＨＫ。
日本政府	ニホンセイフ。
日本文学	ニホンブンガク。
日本料理	ニホンリョウリ。
日本新記録	ニホンシンキロク。
日本旅行	ニホンリョコウ。
日本旅行業協会	ニホンリョコウギョウキョウカイ。
日本時間	ニホンジカン。
日本書紀	ニホンショキ。
日本最大級	ニホンサイダイキュウ。
日本株	ニホンカブ。
日本標準時	ニホンヒョウジュンジ。
日本法人	ニホンホウジン。
日本海	ニホンカイ。
日本漢字能力検定協会	ニホンカンジノウリョクケンテイキョウカイ。
日本画	ニホンガ。
日本神話	ニホンシンワ。
日本経済	ニホンケイザイ。
日本製	Made in Japan.
日本製品	ニホンセイヒン。
日本語	ニホンゴ。
日本語字幕	ニホンゴジマク。
日本語教師	ニホンゴキョウシ。
日本語能力	ニホンゴノウリョク。
日本語訳	ニホンゴヤク。
日本赤十字社	ニホンセキジュウジシャ。
日本農林規格	ＪＡＳ。
日本酒	ニホンシュ。
日本銀行	ニッポンギンコウ。
日本高等学校野球連盟	ニホンコウトウガッコウヤキュウレンメイ。
日清戦争	ニッシンセンソウ。
日焼	ヒヤけ。
日照	ヒデリ。
日用品	ニチヨウヒン。
日直	ニッチョク。
日程	ニッテイ。
日章旗	ニッショウキ。
日米両政府	ニチベイリョウセイフ。
日米友好	ニチベイユウコウ。
日米同盟	ニチベイドウメイ。
日米地位協定	ニチベイチイキョウテイ。	
日系	外国国籍を持つニ本人の子供や孫。
日系企業	ニッケイキギョウ。
日経平均株価	ニッケイヘイキンカブカ。
日記	ダイアリー。
日誌	事務に関する毎ニチの出来事などの記録。
日課	毎ニチ決まってする物事。
日進月歩	どんどん進歩していくこと。
日銀	ニチギン。
日銀総裁	ニチギンソウサイ。
日陰	ヒカゲ。
日露戦争	ニチロセンソウ。
日露関係	ニチロカンケイ。
日韓友好	ニッカンユウコウ。
日韓国交正常化	ニッカンコッコウセイジョウカ。
日韓関係	ニッカンカンケイ。
日食	ニッショク。
旧式	古い形シキ。
旧暦	キュウレキ。
旧石器時代	キュウセッキジダイ。
早口	ハヤクチ。
早口言葉	ハヤクチコトバ。
早合点	ハヤガテン
早急	非常にイソぐこと。至キュウ。
早春	春の初めごろ。ソウシュン。
早朝	アサのハヤいうち。
早期成立	ソウキセイリツ。
早期発見	ソウキハッケン。
早起	ハヤオき。
早足	ハヤアシ。
早退	定刻よりハヤくタイ出すること。
早速	サッソク。
昆布	コンブ。
昆虫	コンチュウ。
昆虫採集	コンチュウサイシュウ。
昇給	キュウ料が上がること。
昇進	上位の職位に任用されること。
明快	はっきりしていて気持ちがよいこと。
明方	アけガタ。
明日	アシタ。
明暗	アカるいこととクラいこと。
明治	大正の前の年号。
明治時代	メイジジダイ。
明治維新	メイジイシン。
明白	アキらかで疑う余地のないさま。
明確	アキらかで疑う点もなくタシかなさま。
明示	はっきりシメすこと。
明細	細かい点まではっきりした詳しい内容。
明細書	メイサイショ。
明言	はっきりイい切ること。
明記	はっきりと書くこと。
昔話	ムカシバナシ。
昔風	コフウ。
星座	星と星を線で結び、その形で何かを見立てたもの。
星形	ホシガタ。
星条旗	アメリカの国キ。
星空	ホシゾラ。
星雲	無数のホシでできたクモのようなもの。
映像	画面にウツし出された画ゾウ。
映写機	エイシャキ。
映画	ムービー。
映画会社	エイガガイシャ。
映画化	エイガカ。
映画産業	エイガサンギョウ。
映画配給	エイガハイキュウ。
映画館	エイガカン。
春一番	ハルイチバン。
春分	昼夜の長さがほぼ等しいハルの日。
春夏秋冬	シュンカシュウトウ。
春雨	ハルサメ。
昨今	サッコン。
昨夜	きのうのヨル。サクヤ。
昨年	サクネン。
昨日	きょうの前のヒ。キノウ。
昨晩	サクバン。
昭和	平成の前の年号。
昭和基地	ショウワキチ。
昼夜	ヒルとヨル。「○○問わず」
昼間	ヒルマ。
昼食	チュウショク。
昼飯	ヒルメシ。
時世	トキと共に移り変わるヨの中。
時事	そのトキそのトキの社会の出来ゴト。
時事問題	ジジモンダイ。
時代	年ダイをその特徴で区分したもの。「○○劇」
時代劇	ジダイゲキ。
時価	そのトキの値段。現在のカ格。
時価総額	ジカソウガク。
時刻	トキの流れにおけるある瞬間。
時刻表	ジコクヒョウ。
時効	一定のジ間の経過による法律コウ果。
時差	地方標準時の示すジ刻のサ。「○○ぼけ」
時折	トキオリ。
時期	事を行うためのキ間。
時機	チャンス。「○○が来たら」
時計	クロック。ウォッチ。
時速	一ジ間当たりに進む距離でハヤさを表すもの。
時間	タイム。
時間差攻撃	ジカンサコウゲキ。
時間帯	ジカンタイ。
晩年	一生の終わりに近い時期。
晩御飯	バンゴハン。
晩秋	アキの終わり頃。
普通選挙	フツウセンキョ。
普通預金	フツウヨキン。
景品	購入者や得点者に与えるおまけ。
景品表示法	ケイヒンヒョウジホウ・
景気	売買や取引などの経済活動全般の動向。
景気動向指数	ケイキドウコウシスウ。
景気回復	ケイキカイフク。
景気対策	ケイキタイサク。
景気減速	ケイキゲンソク。
景色	ケシキ。
景観	視覚で捉えられる町並みの風ケイ。
晴天	「本日は○○なり」
晴姿	ハれスガタ。
晴着	ハれやかな場所にキて行く衣装。
暑中見舞	ショチュウミマい。
暖冬	アタタかいフユ。
暖房	部屋の空気をアタタめる装置。
暖流	アタタかいナガれ。
暗号	秘密通信を行うための方法。
暗号名	コードネーム。
暗号文	アンゴウブン。
暗号解読	アンゴウカイドク。
暗殺	要人に対するサツ人行為。
暗殺者	アンサツシャ。
暗殺計画	アンサツケイカク。
暗算	頭の中で計サンすること。
暗記	すぐ思い出せるようによく覚えること。
暗雲	不穏な気配。うすグラいクモ。
暗黒	真っクロなこと。クラ闇。
暴力	物理的な攻撃や破壊リョク。「○○をふるう」
暴力団	ボウリョクダン。
暴力団排除	ボウリョクダンハイジョ。
暴動	集団的なボウ力活動。
暴落	物価・株価などが急激に下がること。
暴行	乱ボウなオコナい。
暴言	乱ボウなコト葉。
暴走	アバれハシること。
暴走族	ボウソウゾク。
暴露	バクロ。
暴風	ひどいカゼ。ボウフウ。
暴風雨	ボウフウウ。
暴飲暴食	むやみに飲んだり食べたりすること。
曜日	ヨウビ。
曲目	キョクモク。
曲線	マがったセン。
曲芸	キョクゲイ。
更年期障害	コウネンキショウガイ。
更新	最シンの状態にすること。
更衣室	コウイシツ。
書店	本屋さん。
書庫	ショ物を保管する倉コ。
書物	カいてあるモノ。
書画	毛筆でカいた文字と絵ガ。
書留	カキトメ。
書記	カきシルす仕事。
書道	毛筆で文字をカく芸術。
書類	事務や記録などに関する文ショなど。「重要○○」
書類送検	ショルイソウケン。
書類選考	ショルイセンコウ。
最中	サイチュウ。モナカ。
最低	モットもヒクい。
最低気温	サイテイキオン。
最先端技術	サイセンタンギジュツ。
最初	ファースト。
最前線	サイゼンセン。
最古	モットもフルい。
最善	一番良いこと。ベスト。「○○を尽くす」
最大	モットもオオきい。
最大値	サイダイチ。
最大公約数	サイダイコウヤクスウ。
最大瞬間風速	サイダイシュンカンフウソク。
最大限	サイダイゲン。
最小	モットもチイさい。
最小値	サイショウチ。
最小公倍数	サイショウコウバイスウ。
最小単位	サイショウタンイ。
最小限	サイショウゲン。
最年長	サイネンチョウ。
最強	モットもツヨい。
最後	ラスト。サイゴ。
最悪	モットもワルい。
最愛	モットもアイす。
最新	一番アタラしい。
最新技術	サイシンギジュツ。
最期	臨終。人生の末キ。
最短距離	サイタンキョリ。
最終	ラスト。サイシュウ。
最終報告	サイシュウホウコク。
最終段階	サイシュウダンカイ。
最終調整	サイシュウチョウセイ。
最終電車	サイシュウデンシャ。
最良	モットもヨい。
最近	チカ頃は。
最高	モットもタカい。
最高司令官	サイコウシレイカン。
最高指導者	サイコウシドウシャ。
最高気温	サイコウキオン。
最高経営責任者	サイコウケイエイセキニンシャ。ＣＥＯ。
最高裁	サイコウサイ。
最高裁判所	サイコウサイバンショ。
最高責任者	サイコウセキニンシャ。
最高速度	サイコウソクド。
月例報告	ゲツレイホウコク。
月例経済報告	ゲツレイケイザイホウコク。
月光	ツキのヒカリ。
月刊誌	ゲッカンシ。
月収	一ヶゲツあたりのシュウ入。
月夜	ツキヨ。
月日	ツキヒ。
月曜	マンデー。
月曜日	マンデー。
月末	ゲツマツ。
月給	一ヶゲツあたりのキュウ料。
月見団子	ツキミダンゴ。
月額基本料	ゲツガクキホンリョウ。
月食	ゲッショク。
有利	リ益を望めること。他よりも条件がよいさま。
有刺鉄線	ユウシテッセン。
有力	チカラのアる。
有力者	ユウリョクシャ。
有効	キき目のアる。
有効成分	ユウコウセイブン。
有効期間	ユウコウキカン。
有効期限	ユウコウキゲン。
有効求人倍率	ユウコウキュウジンバイリツ。
有名	ナ前の広く知れ渡った。ナ高い。
有名人	ユウメイジン。
有名無実	ナ前ばかりで、中身がナいこと。
有害	ガイがアること。
有害物質	ユウガイブッシツ。
有志	ココロザシのアる。
有志連合	ユウシレンゴウ。
有意義	ユウイギ。
有数	ユウスウ。
有料	リョウ金を徴収する。
有料会員	ユウリョウカイイン。
有望	ノゾみのアる。
有権者	ユウケンシャ。
有機物	ユウキブツ。
有毒	ドクのアる。
有無	アるかナいか。
有田焼	アリタヤキ。
有益	利エキのアる。
有線放送	ユウセンホウソウ。
有罪	ツミがアる。
有罪判決	ユウザイハンケツ。
有能	ノウ力のアる。
有色人種	ユウショクジンシュ。
有識者	ユウシキシャ。
有識者会議	ユウシキシャカイギ。
有限会社	ユウゲンガイシャ。
有限責任	ユウゲンセキニン。
有頂天	ウチョウテン。
服役	懲エキにフクすること。
服従	他の意志や命令にシタガうこと。
服用	薬をのむこと。フク薬。
服装	ファッション。
朗報	ロウホウ。
朗読	ロウドク。
望遠鏡	ボウエンキョウ。
朝刊	朝に発行される新聞。
朝市	アサイチ。
朝方	アサのうち。アサの間。
朝日	アサヒ。
朝晩	アサとバン。
朝礼	チョウレイ。
朝顔	アサガオ。
朝食	アサのショク事。
朝飯	アサメシ。
朝飯前	アサメシマエ。
朝鮮	韓国と北○○。
朝鮮労働党	チョウセンロウドウトウ。
朝鮮半島	チョウセンハントウ。
朝鮮民主主義人民共和国	チョウセンミンシュシュギジンミンキョウワコク。
朝鮮総連	チョウセンソウレン。
期待	当てにして心待ちにすること。
期日前投票	キジツマエトウヒョウ。
期末	キマツ。
期末試験	キマツシケン。
期間	ある時点から他の時点までの継続した時カン。
期間限定	キカンゲンテイ。
期限	決められた一定のキ間。「○○が過ぎる」
木刀	キのカタナ。ボクトウ。
木星	太陽系で大きさ・質量ともに最大の惑星。
木曜	Thursday.
木曜日	Thursday.
木材	モクザイ。
木材加工品	モクザイカコウヒン。
木材工場	モクザイコウジョウ。
木炭	キをむし焼きにして作った燃料。
木片	モクヘン。
木目	モクメ。
木立	コダチ。
木管楽器	モッカンガッキ。
木箱	キバコ。
木綿	モメン。
木製	キでできた。
木製品	モクセイヒン。
木造	キでツクられた。
木造住宅	モクゾウジュウタク。
木造建築	モクゾウケンチク。
木馬	モクバ。
木魚	モクギョ。
未完成	ミカンセイ。
未定	マだサダまっていないこと。
未成年	ミセイネン。
未承認薬	ミショウニンヤク。
未明	マだ明らかでないこと。
未来	ミライ。
未来志向	ミライシコウ。
未満	それより小さいこと。ミマン。
未熟	マだジュクしていないこと。
未知	「○○との遭遇」「○○数」
未知数	ミチスウ。
未確認飛行物体	ＵＦＯ。
未納	税金や年金などをオサめていないこと。
未経験	ミケイケン。
未経験者	ミケイケンシャ。
未練	あきらめ切れないこと。執着。
未解決	ミカイケツ。
未開	文明がマだ十分に発達していないこと。
末代	死んだ後の世。後世。
末子	スエッコ。
末日	スエのヒ。
末期	限られたキ間の終わりごろ。
末路	道の終わり。マツロ。
本人確認	ホンニンカクニン。
本人確認書類	ホンニンカクニンショルイ。
本会議	ホンカイギ。
本体	機械などの中心となる部分。
本名	ホン当のナ前。
本命	一番有力視したり、欲しがっている人・物。
本堂	ホン尊を安置する建物。
本場	ある物の主要な産地。「○○のラーメン」
本家	おおモトとなるイエ。イエ元。
本屋	ホンを売る店。書店。
本州	島国である日本の最大の島。
本店	登記上の会社の本拠。
本当	実際にそうであること。
本心	ホンシン。
本性	ホン来もっているセイ質。
本文	挿し絵や序文を除いた主要な部分のブン章。
本日	きょう。このヒ。
本末転倒	大切な所と、どうでも良い所をとりちがえていること。
本来	元々。ホンライ。
本格的	ホンカクテキ。
本気	真剣なキ持ち。「○○を出す」
本物	ホン当のモノ。偽りでないモノ。
本番	ホンバン。
本番行為	ホンバンコウイ。
本社	経営上の中心となる事業所。
本社機能	ホンシャキノウ。
本職	生計を立てるための主な職業。
本能	動物や人間が、ある行動へと駆り立てる生まれつきの性質。
本能寺	信長が暗殺された「○○○の変」
本質	物事のホン来の性シツや姿。
本音	ホンネ。
本領発揮	ホンリョウハッキ。
札束	サツタバ。
机上	「○○の空論」
材料	ザイリョウ。
材料費	ザイリョウヒ。
材木	ザイモク。
材質	ザイ料の性シツ。
村八分	ムラハチブ。
村民	ムラのタミ。
村落	ソンラク。
村長	ムラのオサ。
条件	ジョウケン。
条件反射	ジョウケンハンシャ。
条例	地方自治体が議決により制定する法規。
条文	法律・ジョウ約などの，箇ジョウ書きのブン。
条約	文書に書き記した国家間の合意。
来場者	ライジョウシャ。
来場者数	ライジョウシャスウ。
来客	ライキャク。
来年度	ライネンド。
来日	ニ本へクること。
来訪者	ライホウシャ。
来週	ツギのシュウ。
東京	日本の首都。
東京一極集中	トウキョウイッキョクシュウチュウ。
東京五輪	トウキョウゴリン。
東京地方裁判所	トウキョウチホウサイバンショ。
東京地裁	トウキョウチサイ。
東京大学	日本で最高の大学。
東京証券取引所	トウキョウショウケントリヒキジョ。
東京都	日本の首都。
東京電力	トウキョウデンリョク。
東京駅	トウキョウエキ。
東北	トウホク。
東北地方	トウホクチホウ。
東大	日本で最高の大学。
東大卒	トウダイソツ。
東大寺	奈良の大仏を本尊とする寺院。
東方見聞録	トウホウケンブンロク。
東日本	ヒガシニホン。
東日本大震災	2011.3.11に起こった災害。
東洋	西ヨウの対立概念。
東洋人	トウヨウジン。
東海道新幹線	トウカイドウシンカンセン。
東西	ヒガシとニシ。
東西南北	トウザイナンボク。
東証株価指数	トウショウカブカシスウ。
東部	その地域のヒガシよりのブ分。
松阪牛	マツサカウシ。
板前	イタマエ。
板間	イタのマ。
林業	リンギョウ。
枚数	マイスウ。
果報	「○○は寝て待て」
果実	種子植物の花の子房が発達・変化したもの。
果樹	食用となるカ実のなる木。
果樹園	カジュエン。
果物	クダモノ。
枝肉	エダニク。
枝葉	エダとハっぱ。
枝豆	エダマメ。
架空	事実に基づかないもの。「○○人物」
架空人物	カクウジンブツ。
架空請求	カクウセイキュウ。
染料	水に溶かして着色に用いる物質。
染物	ソメモノ。
査定	サテイ。
栃木県	日光東照宮のあるケン。
栄光	大きな名誉。輝かしいほまれ。エイコウ。
栄養	生物の成長や活動に役立つ物質。
栄養不足	エイヨウブソク。
栄養価	エイヨウカ。
栄養分	エイヨウブン。
栄養士	エイヨウシ。
栄養学	エイヨウガク。
栄養素	エイヨウソ。
栄養補給	エイヨウホキュウ。
栄養豊富	エイヨウホウフ。
栄養食	エイヨウショク。
校内	学コウナイ。
校内暴力	コウナイボウリョク。
校則	学コウの在コウ生に対する規ソク。
校庭	学コウのニワ。
校旗	学コウのハタ。
校歌	学コウのウタ。
校正	文字・文章を比べ合わせ、誤りをタダすこと。
校舎	学コウの建物。
校長	学校で一番偉い先生。
校長先生	コウチョウセンセイ。
校門	学コウの入り口のモン。
株主	カブヌシ。
株主優待	カブヌシユウタイ。
株主優待券	カブヌシユウタイケン。
株価	カブカ。
株価上昇	カブカジョウショウ。
株取引	カブトリヒキ。
株安傾向	カブヤスケイコウ。
株式	カブシキ。
株式上場	カブシキジョウジョウ。
株式会社	カブシキガイシャ。
株式保有	カブシキホユウ。
株式市場	カブシキシジョウ。
株式投資	カブシキトウシ。
核不拡散条約	カクフカクサンジョウヤク。
核保有国	カクホユウコク。
核兵器	カクヘイキ。
核兵器禁止条約	カクヘイキキンシジョウヤク。
核実験	カクジッケン。
核家族化	カクカゾクカ。
核武装	カクブソウ。
核燃料	カクネンリョウ。
核開発	カクカイハツ。
核開発問題	カクカイハツモンダイ。
根元	ネモト。
根底	「○○に流れる思想」「○○からくつがえす」
根性	苦しさに耐える精神力。コンジョウ。
根拠	コンキョ。
根本	コンポン。
根比	コンクラべ。
根気	長く続けて行うキ力。「○○のいる作業」
根源	物事のミナモトになっているもの。ネ元。
根絶	ネ元から無くし、タやすこと。
格付	カクヅけ。
格好	ルックス。
格安	カクヤス。
格安航空会社	カクヤクコウクウガイシャ（ＬＣＣ）。
格差	カク付け上のサ。
格差是正	カクサゼセイ。
格差社会	カクサシャカイ。
格段	物事の程度の差がはなはだしいさま。
格納庫	カクノウコ。
格言	人生の真理や処世術を表す短いコト葉。金ゲン。
格調	芸術作品の気品やチョウ子。カクチョウ。
格闘家	カクトウカ。
案内	ガイド。
案内人	アンナイニン。
案内図	アンナイズ。
案内所	アンナイジョ。
案内状	アンナイジョウ。
案外	わりと。思ったよりも。意ガイに。
梅干	ウメボし。
梅酒	ウメシュ。
梅雨	バイウ。
梅雨前線	バイウゼンセン。
森林	モリやハヤシ。
森林浴	シンリンヨク。
森林火災	シンリンカサイ。
森林破壊	シンリンハカイ。
森林管理	シンリンカンリ。
植木	ウエキ。
植林	ショクリン。
植樹	ショクジュ。
植民地	ショクミンチ。
植物	ショクブツ。
植物人間	ショクブツニンゲン。
植物工場	ショクブツコウジョウ。
植物性	ショクブツセイ。
植物油	ショクブツアブラ。
植物由来成分	ショクブツユライセイブン。
検出	ケン査して見つけダすこと。
検問所	ケンモンジョ。
検定	ケン査し、等級などを決めること。
検定試験	ケンテイシケン。
検察官	ケンサツカン。
検挙	法令違反を見つけて摘発すること。
検査	基準に照らして状態を調べること。
検査機器	ケンサキキ。
検温	体オンをケン査すること。
検算	試しに再計サンすること。
検討	よく調べ考えること。ケントウ。
検討中	ケントウチュウ。
検証	ケン査して、仮説などをショウ明すること。
検証作業	ケンショウサギョウ。
検証実験	ケンショウジッケン。
業務	ギョウム。
業務上横領罪	ギョウムジョウオウリョウザイ。
業務上過失	ギョウムジョウカシツ。
業務停止	ギョウムテイシ。
業務妨害	ギョウムボウガイ。
業務妨害罪	ギョウムボウガイザイ。
業務拡大	ギョウムカクダイ。
業務改善命令	ギョウムカイゼンメイレイ。
業務連携	ギョウムレンケイ。
業界	ギョウカイ。
業界関係者	ギョウカイカンケイシャ。
業種	事ギョウや営ギョウのシュ類。
業績	ギョウセキ。
業績不振	ギョウセキフシン。
業績予想	ギョウセキヨソウ。
業者	ギョウシャ。
極力	キョクリョク。
極寒	ゴッカン。
極度	キョクド。
極悪	ゴクアク。
極意	ゴクイ。
極楽	ゴクラク。
極秘	ゴクヒ。
極端	キョクタン。
極限	物事のゲン度ぎりぎり。物事の果て。
楽勝	ラクショウ。
楽器	音を鳴らす道具。
楽器店	ガッキテン。
楽団	音ガクを演奏するダン体。「交響○○」
楽園	ラクエン。
楽天的	ラクテンテキ。
楽屋	出演者のための控え室。ガクヤ。
楽市楽座	ラクイチラクザ。
楽曲	ガッキョク。
楽章	ガッ曲を構成する一つ一つの曲。
楽観的	ラッカンテキ。
構内	建物や敷地の中。コウナイ。
構図	絵や写真などの画面の、全体の構成。
構想	実現方法を組み立て、まとめること。「○○を練る」
構成	一つにまとめること。組み立て。
構造	物質や物体、材料の組み合わせ。作りや形。
構造改革	コウゾウカイカク。
様子	外から見てわかる物事のありサマ。
様式	共通している一定の形シキ。スタイル。「生活○○」
標本	生物などを研究資料として保存したもの。「昆虫の○○」
標準	およその目安。目標。普通。「○○語」
標準語	ヒョウジュンゴ。
標的	ターゲット。
標高	ある地点の平均海水面からのタカさ。
模写	ある美術作品を忠実に再現すること。
模型	「何か」の造形を具象化したもの。
模型飛行機	モケイヒコウキ。
模様	パターン。
模索	手さぐりで探し求めること。「解決方法を○○する」
権利	ある物事を行ったり、要求できる資格や能力。
権力	他人を強制し服従させるチカラ。国民に対する強制リョク。
権力闘争	ケンリョクトウソウ。
権威	自発的に同意・服従を促すような能力や関係。
権威主義	ケンイシュギ。
横取	ヨコドり。
横文字	ヨコモジ。
横断	ヨコ切ること。
横断歩道	オウダンホドウ。
横目	ヨコメ。
横着	オウチャク。
横笛	ヨコに構えて演奏するフエ。
横糸	ヨコイト。
横綱	大相撲で力士の最高位。
横行	悪事がしきりにオコナわれること。「汚職が○○する」
横転	ヨコに倒れること。
横道	ヨコミチ。
横領	ネコババ。
横領罪	オウリョウザイ。
横顔	ヨコガオ。
樹令	ジュ木の年レイ。
樹木	地面に生えているキの総称。
樹氷	ムヒョウ。
樹海	富士山の北西にある、非常に広い森林帯。
樹液	ジュ木に含まれるエキ体成分。
樹立	しっかりと打ち立てること。「新記録を○○する」
機会	チャンス。「○○があれば」
機密	政治上・軍事上の重要な秘ミツ。
機密情報	キミツジョウホウ。
機密費	キミツヒ。
機械	マシン。
機械化	キカイカ。
機械油	キカイアブラ。
機織	ハタオリ。
機能	ある物が本来備えている働き。
機能性	キノウセイ。
機長	航空キの最高責任者。
機関投資家	キカントウシカ。
機関誌	キカンシ。
機関車	キカンシャ。
欠勤	給料が支払われない休みのこと。
欠場	出るべきバに出ないこと。
欠席	出るべき会合・授業などに出ないこと。
欠席届	ケッセキトドケ。
欠点	不十分で非難される所。デメリット。
欠航	乗り物の運コウのキャンセル。「嵐で○○する」
次世代	ジセダイ。
次元	３Ｄは「三○○」。
次回	ネクストタイム。
次女	二番目のジョ児。
次男	二番目のダン児。
次第	物事が行われる際の一定の順序。「式の○○」
欧州	ヨーロッパ。
欧州中央銀行	オウシュウチュウオウギンコウ。
欧州経済	オウシュウケイザイ。
欧州連合	オウシュウレンゴウ（ＥＵ）。
欧米	ヨーロッパとアメリカ。
欲張	ヨクバり。
欲望	不足を感じてこれを満たそうと強く望む気持ち。
欲求	強くホしがってモトめること。
欲求不満	ヨッキュウフマン。
歌声	ウタゴエ。
歌手	カシュ。
歌詞	楽曲に乗せる言葉。
歓声	カン迎のコエ。
歓迎	ウェルカムの気持ち。
歓迎会	カンゲイカイ。
止血	チをトめること。
正七角形	各辺の長さがすべて等しいナナカッケイ。
正三角形	各辺の長さがすべて等しいサンカッケイ。
正五角形	各辺の長さがすべて等しいゴカッケイ。
正会員	セイカイイン。
正体	隠したり偽ったりしてよくわからない本当の姿。
正体不明	ショウタイフメイ。
正六角形	各辺の長さがすべて等しいロッカッケイ。
正午	昼12時ちょうど。
正反対	セイハンタイ。
正夢	マサユメ。
正常	特に変わったところがなく、普通であること。
正座	足をくずさず、行儀タダしくスワること。
正式	セイ当な方シキ。本シキ。
正式名称	セイシキメイショウ。
正式発表	セイシキハッピョウ。
正当	道理にあっているさま。
正当防衛	セイトウボウエイ。
正念場	ショウネンバ。
正方形	４辺の長さがすべて等しい四角ケイ。
正月	ショウガツ。
正月気分	ショウガツキブン。
正正堂堂	態度がタダしくりっぱなようす。
正気	キが確かであること。「○○を失う」
正直	うそやごまかしがないこと。
正直者	ショウジキモノ。
正確	タダしくタシかなこと。
正社員	セイシャイン。
正統	タダしい系トウ・血筋。
正義	道理にかなったタダしいこと。「○○の味方」
正義感	セイギカン。
正規	キ則などではっきりキまっていること。
正解	タダしい答え。
正解者	セイカイシャ。
正誤表	セイゴヒョウ。
正論	道理にかなったタダしい議ロン・主張。
正面	物の表側のメン。
正面図	ショウメンズ。
武力	軍隊のチカラ。兵リョク。「○○行使」
武力介入	ブリョクカイニュウ。
武力行使	ブリョクコウシ。
武器	戦いで攻撃に用いるブ具・兵キ。
武器屋	ブキヤ。
武器輸出三原則	ブキユシュツサンゲンソク。
武士	「○○は食わねど高楊枝」
武家	ブ士のイエ柄。
武者	「落ち○○」「○○修行」
武術	ブジュツ。
武装	ブ器や防具を身につけること。
武装勢力	ブソウセイリョク。
武装強盗団	ブソウゴウトウダン。
武装集団	ブソウシュウダン。
歩兵	アルくヘイ士。
歩行	アルいてイくこと。
歩行困難	ホコウコンナン。
歩行者	ホコウシャ。
歩行者天国	ホコウシャテンゴク。
歩行者専用	ホコウシャセンヨウ。
歯医者	ハのおイシャさん。
歯周病	シシュウビョウ。
歯形	ハのかみ合わせのカタチ。
歯止	ハドめ。
歯石	ハの周りにできる、イシのような固まり。
歯科	ハの病院。
歯科医	ハのおイ者さん。
歯車	ギア。
歴代	何ダイも経てきていること。
歴史	ヒストリー。
歴史人物	レキシジンブツ。
歴史問題	レキシモンダイ。
歴史小説	レキシショウセツ。
歴史年表	レキシネンピョウ
歴史教科書	レキシキョウカショ。
歴史認識	レキシニンシキ。
死亡	シぬこと。シボウ。
死亡率	シボウリツ。
死亡者	シんだ人。シボウシャ。
死亡記事	シボウキジ。
死亡通知	シボウツウチ。
死人	シんだヒト。「○○に口なし」
死体	シんだカラダ。
死傷者	シショウシャ。
死刑	罪を犯した者の生命を奪うケイ罰。
死刑判決	シケイハンケツ。
死刑執行	シケイシッコウ。
死刑宣告	シケイセンコク。
死去	シんでこの世をサること。
死因	シんだ原イン。
死後	シんだアト。
死活問題	シカツモンダイ。
残念	ザンネン。
残念無念	期待したようにならないで、とてもくやしい気持ち。
残暑	立秋の後までノコるアツさ。
残暑見舞	ザンショミマイ。
残業	ザンギョウ。
残業代	ザンギョウダイ。
残業手当	ザンギョウテアテ。
残物	ノコりモノ。
残額	ノコった金ガク。
残飯	ノコったメシ。
段取	ダンドり。
段落	ダンラク。
段階	物事の進行で区切られた一つの状態。
殺人	ヒトをコロすこと。
殺人事件	サツジンジケン。
殺人犯	サツジンハン。
殺人現場	サツジンゲンバ。
殺人罪	サツジンザイ。
殺人鬼	サツジンキ。
殺傷	コロしたりキズつけたりすること。
殺傷事件	サッショウジケン。
殺傷能力	サッショウノウリョク。
殺処分	サツショブン。
殺到	多数の人や物が一度にどっと押し寄せること。
殺害	サツガイ。
殺害予告	サツガイヨコク。
殺意	サツイ。
殺気	人をコロそうとするキ迫。
殺菌	キンをコロすこと。
殺虫剤	ムシをやっつける薬ザイ。
殺風景	サップウケイ。
殿様	トノサマ。
母乳	ハハ親のチチ。
母体	ハハ親のカラダ。
母国語	ボコクゴ。
母子健康手帳	ボシケンコウテチョウ。
母子家庭	ボシカテイ。
母屋	オモヤ。
母性愛	ボセイアイ。
母校	出身コウ。
母親	ハハオヤ。
母音	「ア・イ・ウ・エ・オ」の音。
毎回	マイカイ。
毎年	マイネン。
毎度	マイド。
毎日	マイニチ。
毎晩	マイバン。
毎月	ツキごと。ツキヅキ。
毎朝	マイアサ。
毎秒	マイビョウ。
毎週	マイシュウ。
毒味	ドクミ。
毒殺	ドクでコロすこと。
毒消	ドクケし。
毒素	生物が作り出す有ドク物質。
毒舌	ドクゼツ。
毒舌家	ドクゼツカ。
毒草	ドクのクサ。
毒薬	ドクのクスリ。
毒針	ドクバリ。
比例	a : b = c : dという関係。
比例代表	ヒレイダイヒョウ。
比例代表制	ヒレイダイヒョウセイ。
比例区	ヒレイク。
比例定数	ヒレイテイスウ。
比重	ヒジュウ。
毛布	モウフ。
毛皮	ケガワ。
毛筆	モウヒツ。
毛糸	動物のケを紡いでつくったイト。
毛細血管	モウサイケッカン。
毛織物	ケオリモノ。
毛虫	ケや棘が生えたムシ。
毛髪	モウハツ。
氏名	苗字と名前。シメイ。
民主主義	ミンシュシュギ。
民主主義国家	ミンシュシュギコッカ
民主化	ミンシュカ。
民主化運動	ミンシュカウンドウ。
民主国家	ミンシュコッカ。
民事事件	ミンジジケン。
民事訴訟	ミンジソショウ。
民家	一般の人々の住むイエ。
民意	ミンイ。
民族	文化で区分される集団。
民族主義	ミンゾクシュギ。
民族楽器	ミンゾクガッキ。
民族衣装	ミンゾクイショウ。
民族音楽	ミンゾクオンガク。
民業圧迫	ミンギョウアッパク。
民衆	社会を形づくっている一般の人々。
民話	ミン間に口承されてきた説ワ。
民間	一般庶ミンの社会。世ケン。
民間事業	ミンカンジギョウ。
民間事業者	ミンカンジギョウシャ。
民間企業	ミンカンキギョウ。
民間利用	ミンカンリヨウ。
民間団体	ミンカンダンタイ。
民間放送	ミンカンホウソウ。
民間軍事会社	ミンカングンジガイシャ。
民間部門	ミンカンブモン。
民間開放	ミンカンカイホウ。
気体	ガス。
気候	ある地域の長い期間の大キの状態。
気分	「○○転換」「正月○○」
気分転換	キブンテンカン。
気前	金品を出し惜しみしない性質。「○○よくくれた」
気力	キ持ちの張り。キ合。
気化	ガスになること。
気化熱	キカネツ。
気味	「太り○○」「○○が悪い」「いい○○だ」
気品	キ高い趣。上ヒンな感じ。
気圧	キアツ。
気圧配置	キアツハイチ。
気楽	キラク。
気構	キガマえ。
気流	空キのナガれ。
気温	大キのオン度。
気球	人が乗る大きなバルーン。
気管	口と肺をつなぐ一本のクダ。
気管支	キカンシ。
気絶	キを失う。キゼツ。
気苦労	キグロウ。
気象	大キ中に生じる自然現象。
気象台	キショウダイ。
気象庁	キショウチョウ。
気象条件	キショウジョウケン。
気象衛星	キショウエイセイ。
気象観測	キショウカンソク。
気軽	キガル。
気配	ケハイ。
気長	キナガ。
水中	ミズのナカ。
水中撮影	スイチュウサツエイ。
水中眼鏡	スイチュウメガネ。
水仕事	ミズシゴト。
水位	ウォーターレベル。
水分	スイブン。
水分補給	スイブンホキュウ。
水力	ミズのチカラ。
水力発電	スイリョクハツデン。
水力発電所	スイリョクハツデンショ。
水圧	ミズのアツ力。
水増	ミズマし。
水害	スイガイ。
水平	静止したスイ面のようにタイらであるさま。
水平方向	スイヘイホウコウ。
水平線	スイヘイセン。
水彩画	スイサイガ。
水戸黄門	ミトコウモン。
水族館	スイゾクカン。
水星	最も太陽に近い惑セイ。
水曜	Wednesday.
水曜日	Wednesday.
水死	ミズでおぼれてシぬこと。
水気	ミズケ。
水没	スイボツ。
水泳	ミズの中をオヨぐこと。
水泳大会	スイエイタイカイ。
水泳教室	スイエイキョウシツ。
水泳教育	スイエイキョウイク。
水泳選手	スイエイセンシュ。
水洗	ミズでアラうこと。
水洗便所	スイセンベンジョ。
水流	ミズのナガれ。
水浴	ミズアび。
水深	ミズのフカさ。
水温	ミズのオン度。
水温計	スイオンケイ。
水源	川などのミズが流れ出るもと。
水源地	スイゲンチ。
水溶液	スイヨウエキ。
水牛	スイギュウ。
水玉模様	ミズタマモヨウ。
水産加工業者	スイサンカコウギョウシャ。
水産業	スイサンギョウ。
水産物	スイサンブツ。
水田	スイデン。
水着	ミズギ。
水筒	飲料スイ、酒類などの携帯用容器。
水素	元素記号Ｈで原子番号１の元素。
水色	ミズイロ。
水草	ミズクサ。
水蒸気	スイジョウキ。
水蒸気爆発	スイジョウキバクハツ。
水虫	ミズムシ。
水資源	ミズシゲン。
水質	水に含まれている物シツの性シツ。
水質基準	スイシツキジュン。
水質検査	スイシツケンサ。
水路	スイロ。
水車	スイシャ。
水道	生活に必要なミズを供給する施設。
水道局	スイドウキョク。
水銀	液体金属の一種。「○○温度計」
水銀温度計	スイギンオンドケイ。
水銀電池	スイギンデンチ。
水門	ミズの流れの調節のために開閉できるモン・扉。
水面	ミズの表メン。
氷山	ヒョウザン。
氷水	コオリミズ。
氷河	流れ下るコオリの集合体。
氷河時代	ヒョウガジダイ。
氷点下	ヒョウテンカ。
永世中立国	エイセイチュウリツコク。
永久	いつまでも限りなく続くこと。エイキュウ。
永久保存	エイキュウホゾン。
永久凍土	エイキュウトウド。
永久機関	エイキュウキカン。
永久歯	エイキュウシ。
永久磁石	エイキュウジシャク。
永住	ある土地にナガくスむこと。
永住権	エイジュウケン。
永眠	エイ久にネムること。
永遠	いつまでも果てしなく続くこと。エイエン。
求人	雇うヒトをモトめること。
求人件数	キュウジンケンスウ。
求人倍率	キュウジンバイリツ。
求人広告	キュウジンコウコク。
求刑	ケイ罰をモトめること。
求愛	アイをモトめること。
汚名	悪い評判。悪メイ。「○○返上」
汚染	ヨゴれにソまること。
汚染水対策	オセンスイタイサク。
汚染物質	オセンブッシツ。
汚水	ヨゴれたミズ。
汚物	ヨゴれたモノ。
汚職	職務上の地位を悪用した不正行為。
汚職事件	オショクジケン。
江戸	日本の首都東京の旧称。
江戸城	エドジョウ。
江戸幕府	エドバクフ。
江戸時代	エドジダイ。
決別	きっぱりとワカれること。
決勝	最後のショウ負をケッ定すること。
決勝戦	ケッショウセン。
決壊	堤防などが切れて崩れること。
決定	物事をはっきりとキめること。
決心	ココロにキめること。
決意	イ志をはっきりとキめること。ケッ心。
決断	意志をはっきりとケッ定すること。
決着	物事のきまりがつくこと。ケッチャク。
決行	思い切ってオコナうこと。
決裂	意見が一致せず、会談・交渉などが成立しないこと。
決議	ケツギ。
沈没	船などが水中にシズむこと。
沈没船	チンボツセン。
沖縄	日本の最西端に位置するケン。
沖縄地方	オキナワチホウ。
沖縄県	日本の最西端に位置するケン。
河原	水の流れていない、石や砂の多い川辺。カワラ。
河口	カ川が他の水域へ注ぎ込む部分。
河川	大小のカワ。カセン。
河童	キュウリのすきな想像上の生き物。
油断	注意を怠ること。
油断大敵	不注意でいると、思わぬ失敗をすること。
油田	石ユが産出する地域。ユデン。
油紙	アブラガミ。
油絵	アブラエ。
治安	社会の秩序。犯罪率が低いこと。
治安当局	チアントウキョク。
治安維持	チアンイジ。
治安部隊	チアンブタイ。
治水	氾濫などの害を防ぎ、水を統制すること。
治水工事	チスイコウジ。
沿岸	エンガン。
沿線	路センにソった所。 
沿道	ミチにソった場所。
法事	ご先祖様の供養を行う行事。
法人税	ホウジンゼイ。
法令	ホウ律と命レイ。
法制度	ホウセイド。
法則	必ず成立する事物相互の関係。
法務省	ホウムショウ。
法外	ホウからハズれていること。
法定相続人	ホウテイソウゾクニン。
法律	ホウリツ。
法律改正	ホウリツカイセイ。
法改正	ホウカイセイ。
法整備	ホウセイビ。
法案	ホウ律のアン。
法治主義	ホウチシュギ。
法治国家	ホウチコッカ。
法科大学院	ホウカダイガクイン。
法規制	ホウキセイ。
波乱	さわぎ。ごたごた。「○○万丈」
波長	電磁波の隣り合った山の間の長さ。
波間	ナミのうねりとうねりのアイダ。
泣虫	ナきムシ。
泣言	ナきゴト。
泣顔	ナきガオ。
泥仕合	ドロジアイ。
注入	ソソぎイれること。
注射	穴の開いた針を体に刺して薬剤をチュウ入すること。
注射器	チュウシャキ。
注意	気をつけること。
注意事項	チュウイジコウ。
注意人物	チュウイジンブツ。
注意力	チュウイリョク。
注意点	チュウイテン。
注文	物品を依頼すること。オーダー。
注文住宅	チュウモンジュウタク。
注文確認	チュウモンカクニン。
注水	ミズをソソぐこと。
注目	ある物に視線をソソぐこと。
注目株	チュウモクカブ。
注視	チュウ意してよく見ること。
洋室	西ヨウ風の部屋。ヨウ間。
洋式	西ヨウ風のやり方・様シキ。「○○トイレ」
洋服	西ヨウ風のフク装。
洋楽	西ヨウの音ガク。
洋画	西ヨウの映ガ。
洋菓子	ヨウガシ。
洋酒	西ヨウ風のサケ。
洋風	西ヨウフウ。
洋食	西ヨウ風のショク事。
洗剤	アラうために使う薬ザイ。
洗浄	アラって清めること。
洗濯	アラってススぐこと。
洗濯機	センタッキ。
洗濯物	センタクモノ。
洗練	表現を推敲して、より良いものにすること。
洗脳	センノウ。
洗面器	センメンキ。
洗面所	センメンジョ。
洗顔	カオをアラうこと。
津波	ツナミ。
津波対策	ツナミタイサク。
津波注意報	ツナミチュウイホウ。
津軽三味線	ツガルジャミセン。
津軽弁	ツガルベン。
活力	働き動くためのチカラ。生命リョク。
活動	カッ発にウゴいたり働いたりすること。
活動家	カツドウカ。
活動方針	カツドウホウシン。
活動範囲	カツドウハンイ。
活字	カッ版印刷に使う凸型のジ型。
活性化	カッセイカ。
活断層	カツダンソウ。
活気	いきいきとしたカツ動的なキ分。
活用	うまくイかしてモチいること。
活発	元気で勢いのよいさま。
活路	生き残るための道や方法。「○○を開く」
派手	地味の反対。
派遣	ハケン先の企業で業務を行う雇用形態。
派遣労働者	ハケンロウドウシャ。
派遣社員	ハケンシャイン。
流出	ナガれデること。
流出文書	リュウシュツブンショ。
流動食	リュウドウショク。
流域	ナガれる地イキ。
流星	ナガれるホシ。
流星群	リュウセイグン。
流水	ナガれるミズ。
流氷	ナガれるコオリ。
流産	妊娠の早い時期に赤ちゃんが死ぬこと。
流血	チがナガれること。
流行	世間でハヤること。
流行歌	リュウコウカ。
流行語	リュウコウゴ。
流通	消費者へ販売するための物・貨幣などのナガれ。
浄水場	ジョウスイジョウ。
浪人	試験に不合格であぶれた人。
浪費	無駄にツイやすこと。
浮世絵	ウキヨエ。
浮力	ウこうとするチカラ。
浮動票	フドウヒョウ。
浴場	多くの人が入るお風呂の施設。
浴室	ヨク槽のある部屋。
浴衣	ユカた。
海外	カイガイ。
海外事業	カイガイジギョウ。
海外企業	カイガイキギョウ。
海外展開	カイガイテンカイ。
海外投資家	カイガイトウシカ。
海外旅行	カイガイリョコウ。
海外移転	カイガイイテン。
海外資産	カイガイシサン。
海外進出	カイガイシンシュツ。
海女	ウミのアマさん。
海岸	ウミのキシ。
海岸線	カイガンセン。
海底	ウミのソコ。
海底火山	カイテイカザン。
海水	ウミのミズ。
海水浴	カイスイヨク。
海洋投棄	カイヨウトウキ。
海洋深層水	カイヨウシンソウスイ。
海流	ウミのナガれ。
海王星	カイオウセイ。
海産物	カイサンブツ。
海軍	カイグン。
海辺	ウミベ。
海里	海で使われる距離の単位。マイル。1.852km。
海難事故	カイナンジコ。
海面上昇	カイメンジョウショウ。
消化	生物が腸内で食べ物を化学分解する過程。
消化不良	ショウカフリョウ。
消化器官	ショウカキカン。
消化液	ショウカエキ。
消印	ケシイン。
消息	ショウソク。
消極的	ショウキョクテキ。
消毒	ばい菌を減らす処置。
消毒作業	ショウドクサギョウ。
消毒液	ショウドクエキ。
消火	ヒをケすこと。
消火器	ショウカキ。
消灯	アカりをケすこと。
消灯時間	ショウトウジカン。
消石灰	ショウセッカイ。
消費	使ってなくすこと。
消費低迷	ショウヒテイメイ。
消費拡大	ショウヒカクダイ。
消費期限	ショウヒキゲン。
消費生活	ショウヒセイカツ。
消費税	ショウヒゼイ。
消費税率	ショウヒゼイリツ。
消費者	ショウヒシャ。
消費者団体	ショウヒシャダンタイ。
消費者心理	ショウヒシャシンリ。
消費者物価指数	ショウヒシャブッカシスウ。
消費者金融	ショウヒシャキンユウ。
消費電力	ショウヒデンリョク。
消防	災害の予防・鎮圧、人命救助。
消防団員	ショウボウダンイン。
消防士	ショウボウシ。
消防署	ショウボウショ。
消防車	ショウボウシャ。
消音	オトをケすこと。
消音材	ショウオンザイ。
液体	物質の三態のひとつ。水銀は○○金属。
液体燃料	エキタイネンリョウ。
液状化	エキジョウカ。
液状化現象	エキジョウカゲンショウ。
淡水	塩分濃度の低いミズ。
淡水魚	タンスイギョ。
深刻	事態が切実で重大であるさま。シンコク。
深刻化	シンコクカ。
深呼吸	シンコキュウ。
深夜	真ヨ中。ヨ更け。眠りもフカい。
深夜割引	シンヤワリビキ。
深夜営業	シンヤエイギョウ。
深夜番組	シンヤバングミ。
深手	フカい傷。重傷。
深海	フカいウミ。
深海魚	シンカイギョ。
混乱	コン雑してミダれてる様子。秩序がない様子。
混入	マじってハイること。
混合	性質の違う物がマザりアうこと。
混同	区別すべき物をオナじ物として扱うこと。
混戦	敵味方が入り乱れてタタカうこと。
混線	複数の信号・通話が入りマじること。
混血	チがマじること。
混雑	コンザツ。
添付	電子メールにファイルを付け加えること。
清書	下ガきなどを正式にカき改めること。
清水	キヨらかなミズ。
清流	キヨらかなナガれ。
清涼飲料	セイリョウインリョウ。
清涼飲料水	セイリョウインリョウスイ。
清潔	セイケツ。
清酒	にごりがないおサケ。日本シュ。
減少	ヘってスクなくなること。
減少傾向	ゲンショウケイコウ。
減点	テンをヘらすこと。
減税	ゼイ金をヘらすこと。
減速	ソク度をヘらすこと。
減額	金ガクをヘらすこと。
温和	アタタかでナゴやかなさま。
温存	使わないで大事に保存すること。
温室	オンシツ。
温室効果	オンシツコウカ。
温帯低気圧	オンタイテイキアツ。
温帯気候	オンタイキコウ。
温度	物体の持つ、熱さ・冷たさのド合い。
温度上昇	オンドジョウショウ。
温度計	オンドケイ。
温暖	気候などがアタタかなさま。
温暖前線	オンダンゼンセン。
温暖化	オンダンカ。
温暖化対策	オンダンカタイサク。
温水	アタタかいミズ。
温泉	オンセン。
温泉卵	オンセンタマゴ。
温泉施設	オンセンシセツ。
温泉街	オンセンガイ。
温風	オンプウ。
測定	ソクテイ。
測定値	ソクテイチ。
測定器	ソクテイキ。
測定法	ソクテイホウ。
測量	ソクリョウ。
測量士	ソクリョウシ。
港町	ミナトマチ。
湖岸	ミズウミのキシ。
湯上	ユアガり。
湯冷	ユザめ。
湯気	ユゲ。
湯水	ユミズ。「○○のように使う」
湯船	ユブネ。
湿地	シメったチ域。
湿布	シップ。
湿度	シツド。
湿気	シッケ。
満員	定員に達すること。限界の人数であること。
満員電車	マンインデンシャ。
満場一致	マンジョウイッチ。
満月	マンゲツ。
満潮	ミちシオ。
満点	誤りのない、最高のテン数。
満腹	マンプク。
満足	ミちタりた状態。
満足度	マンゾクド。
満足感	マンゾクカン。
満開	花びらなどが、完全にヒラくこと。
源氏物語	ゲンジモノガタリ。
源頼朝	鎌倉幕府を作った初代征夷大将軍。
準備	前もって用意すること。「下○○」
準備不足	ジュンビブソク。
準決勝	ジュンケッショウ。
溶岩	火山の火口から出てくる、トけたイワ。
溶接	２つ以上の部材を溶融・一体化させる作業。
溶液	液体に他の物質を混ぜた、液体状態の混合物。
滅亡	ホロんでナくなること。
滋賀県	琵琶湖があるケン。
滑走路	カッソウロ。
滞在予定	タイザイヨテイ。
滞在期間	タイザイキカン。
滞納	納めるべきものをしぶること。「税金○○」
滞納世帯	タイノウセタイ。
漁師	海に出て、魚介類をとる人。
漁村	ギョソン。
漁業	ギョギョウ。
漁港	ギョコウ。
漁船	リョウをするためのフネ。
漂流	水面や水中を物体がタダヨいナガれること。
漂白剤	ヒョウハクザイ。
演出	エンシュツ。
演劇	舞台の上で観客を前にして表現し、ゲキを見せること。
演奏	音楽を音として響かせる行為。
演奏会	エンソウカイ。
演技	芝居・曲芸・歌舞・ワザを行って見せること。
演習	物事に慣れるため、繰り返してナラうこと。
演芸	観衆を前にしてエンじるゲイ能。
演説	大勢の前で主義・主張を話すこと。スピーチ。
漢和辞典	カンワジテン。
漢字	カン民族で発生した表意文ジの一つ。
漢字字典	カンジジテン。
漢字検定	カンジケンテイ。
漢数字	カンスウジ。
漢文	古代中国の文語体の文章。
漢語	カン字音でよまれるゴ。カン字の熟ゴ。
漬物	ツケモノ。
漬物石	ツケモノイシ。
潔白	無実であること。「身の○○を訴える」
潮時	物事を行うちょうどいいジ期。
潮流	シオのナガれ。チョウリュウ。
潮風	シオカゼ。
激化	ハゲしくなること。ひどくなること。
激増	急ゲキにフえること。
激戦	ハゲしいタタカい。
激流	ハゲしいナガれ。
激痛	ハゲしいイタみ。
濁点	「ば」「ブ」などの「゛」。
濃淡	ノウタン。
瀬戸際	セトギワ。
瀬戸際外交	セトギワガイコウ。
火事	火による災害で、比較的小さいもの。
火事場	カジバ。
火事場泥棒	カジバドロボウ。
火元	ヒモト。
火力	ヒのチカラ。
火力発電	カリョクハツデン。
火口	カ山の噴火コウ。
火山	マグマが噴出するヤマ。
火山地帯	カザンチタイ。
火山岩	カザンガン。
火山性地震	カザンセイジシン。
火山活動	カザンカツドウ。
火山観測	カザンカンソク。
火星	太陽に近い方から４番目の赤い惑セイ。
火曜	チューズデー。
火曜日	チューズデー。
火柱	ヒバシラ。
火気厳禁	カキゲンキン。
火災	ヒによるサイ害。
火災事故	カサイジコ。
火災保険	カサイホケン。
火災報知器	カサイホウチキ。
火炎	燃え上がる激しいホノオ。
火種	ヒダネ。
火花	ヒバナ。
火薬	着カすると爆発する、推進力を与えるためのヤク剤。
灯台	夜、船に場所を知らせるアカりをトモす建造物。
灯油	暖房やランプに用いる石ユ。
灯火	ヒをトモすこと。
灰皿	ハイザラ。
灰色	ハイイロ。
災害	サイガイ。
災害対策基本法	サイガイタイサクキホンホウ。
災害復旧	サイガイフッキュウ。
災害情報	サイガイジョウホウ。
災害救助犬	サイガイキュウジョケン。
災難	サイナン。
炎上	ブログなどでアクセスが殺到すること。
炎天下	エンテンカ。
炎症	体の充血・はれ・発熱・痛みなどのショウ状。
炭化	スミ状になること。
炭化水素	タンカスイソ。
炭水化物	タンスイカブツ。
炭火	スミビ。
炭素	スミやダイヤモンドを構成する元ソ。カーボン。
炭酸	二酸化炭素が水に溶けると…
炭酸水	タンサンスイ。
点呼	一人一人名を呼んで、人員を確かめること。
点在	あちこちに散らばってあること。散ザイ。
点字	視覚障害者が触れて知覚する、でこぼこした文ジ。
点数	得テンのカズ。スコア。
点検	一つ一つケン査すること。
点検商法	テンケンショウホウ。
点滅	光ったり消えたりすること。
点火	ヒをツけること。
点線	テンを並べてセン状にした表示。
為替	カワセ。
為替変動	カワセヘンドウ。
無一文	ムイチモン。
無事	何ゴトもナいこと。
無人	ヒトがいナいこと。
無人島	ムジントウ。
無人機	ムジンキ。
無作法	ブサホウ。
無価値	カチがナいこと。
無傷	キズがナいこと。
無党派層	ムトウハソウ。
無利息	ムリシ。
無制限	ムセイゲン。
無力	事を実現させるチカラがナいこと。
無効	コウ力がナいこと。
無口	ムクチ。
無名	ナ前がナいこと。有メイではないこと。
無味乾燥	内容に少しもおもしろいところがないこと。
無実	事ジツがナいこと。犯行を犯していないこと。
無害	ガイがナいこと。
無差別	ムサベツ。
無差別殺傷事件	ムサベツサッショウジケン。
無差別級	ムサベツキュウ。
無形文化財	ムケイブンカザイ。
無形文化遺産	ムケイブンカイサン。
無念	悔しく思うこと。「残念○○」「○○の涙」
無意味	ナンセンス。
無意識	ムイシキ。
無愛想	ブアイソウ。
無我夢中	われを忘れるほど熱心になること。
無数	カゾえ切れないほど、カズが非常に多いこと。
無敵	向かうところテキナし。
無料	リョウ金がナいこと。
無料公開	ムリョウコウカイ。
無料引換券	ムリョウヒキカエケン。
無断	許しを得ないこと。「○○欠勤」
無断欠勤	ムダンケッキン。
無断欠席	ムダンケッセキ。
無期限	ムキゲン。
無機物	有キブツを除いたすべてのブッ質。
無欲	ヨクがナいこと。
無残	いたましいさま。あわれなさま。
無気力	ムキリョク。
無添加	ムテンカ。
無理	道リに反すること。どうにもできないこと。
無理心中	ムリシンジュウ。
無用	役に立たないこと。いらないこと。
無病息災	病気もせず、わざわいもなく、すごしていくこと。
無益	利エキがナいこと。
無知	知識が足りていないこと。シらないこと。
無礼	ブレイ。
無礼者	ブレイモノ。
無神経	ムシンケイ。
無線	センを使わナい方法。電波で。
無線通信	ムセンツウシン。
無罪	ツミがナいこと。
無罪主張	ムザイシュチョウ。
無罪判決	ムザイハンケツ。
無職	ショクがナいこと。
無能	ノウ力や才ノウがナいこと。役立たず。
無表情	ムヒョウジョウ。
無視	存在を認めないさま。見ないふり。
無言	物をイわナいこと。
無言電話	ムゴンデンワ。
無計画	ムケイカク。
無記名投票	ムキメイトウヒョウ。
無論	言うまでもなく。もちロン。
無責任	ムセキニン。
無農薬	ムノウヤク。
無農薬野菜	ムノウヤクヤサイ。
無邪気	ムジャキ。
無重力	ムジュウリョク。
無関係	ムカンケイ。
無限	カギりがナいこと。
無限大	ムゲンダイ。
無限責任	ムゲンセキニン。
無難	ブナン。
無駄	ムダ。
焼失	ヤけてなくなること。
焼死	ヤけてシぬこと。
焼物	ヤきモノ。
焼石	ヤけイシ。
焼魚	ヤきザカナ。
煙突	エントツ。
照合	テらしアわせること。
照明	部屋をテらしアカるくすること。
照明係	ショウメイガカリ。
照明器具	ショウメイキグ。
煮物	ニモノ。
熊本県	九州地方の中央に位置するケン。くまモンが人気。
熟成	発酵によりジュクしてうまみが増すこと。
熟睡	ぐっすり眠ること。
熟練	十分に経験を積んで、上手なこと。
熟語	ゴを連結して特有の意味を持たせた言葉。「四字○○」
熟読	文章をしっかり味わいながらヨむこと。
熱中	他のことを忘れて一つのことに心を注ぐこと。
熱中症	ネッチュウショウ。
熱帯	年中温暖な地域。
熱帯低気圧	ネッタイテイキアツ。
熱帯夜	ネッタイヤ。
熱帯植物	ネッタイショクブツ。
熱帯気候	ネッタイキコウ。
熱帯魚	ネッタイギョ。
熱心	ココロをこめて一生懸命するさま。
熱意	ネッ心な気持ち。
熱気	高温のキ体。アツく高ぶった雰囲キ。
熱気球	ネツキキュウ。
熱湯	アツいおユ。
熱狂	クルったようにアツいさま。
熱量	物質が持つネツのリョウ。エネルギー。
燃料	ネンリョウ。
燃料価格	ネンリョウカカク。
燃料油	ネンリョウアブラ。
燃料補給	ネンリョウホキュウ。
燃料調達	ネンリョウチョウタツ。
燃料費	ネンリョウヒ。
燃料電池車	ネンリョウデンチシャ。
燃焼	発熱と発光をともなう酸化反応。
燃費向上	ネンピコウジョウ。
父母	フボ。
父親	チチオヤ。
片仮名	カタカナ。
片側	カタ方のガワ。
片手	カタ方のテ。
片手間	カタテマ。
片方	二つあるものの一つ。一ポウ。
片時	カタトキ。
片田舎	カタイナカ。
片言	カタコト。
片足	一方のアシ。
片道	行きか帰りかの一方。
片道切符	カタミチキップ。
片道料金	カタミチリョウキン。
版画	ハンガ。
牛丼	ギュウドン。
牛乳	ギュウニュウ。
牛肉	ギュウニク。
牛舎	ウシを飼う小屋。ウシ小屋。
牛飲馬食	ウシやウマのようにたくさんのものをタべること。
牧場	マキバ。ボクジョウ。
牧師	プロテスタント教会の聖職者。
牧草	家畜の飼育に使用されるクサ。
牧草地	ボクソウチ。
物事	モノゴト。
物件	土地・建モノなどの不動産、ブッ品など。
物体	質量を持って空間に存在しているモノ。
物価	ブッカ。
物価上昇	ブッカジョウショウ。
物価上昇率	ブッカジョウショウリツ。
物価上昇目標	ブッカジョウショウモクヒョウ。
物価変動	ブッカヘンドウ。
物価安定	ブッカアンテイ。
物価目標	ブッカモクヒョウ。
物価高	ブッカダカ。
物品	ブッピン。
物好	モノズき。
物干	モノホし。
物心	モノゴコロ。
物流拠点	ブツリュウキョテン。
物理学	ブツリガク。
物置	モノオキ。
物色	多くの中から適当なモノを探し出すこと。
物語	モノガタリ。
物資	生活の支えとなるモノ。食料や衣料など。
物質	ブッ体を形づくり、固有の性シツをもつ存在。
物静	モノシズか。
物音	モノオト。
特価	トク別カ格。
特典	トク別の待遇。トク別の恩テン。
特別	スペシャル。
特別交付税	トクベツコウフゼイ。
特別企画	トクベツキカク。
特別価格	トクベツカカク。
特別国会	トクベツコッカイ。
特別行政区	トクベツギョウセイク。
特効薬	トッコウヤク。
特売日	トクバイビ。
特大	トク別にオオきいこと。
特定	トクに決まっていること。
特定保健用食品	トクテイホケンヨウショクヒン。トクホ。
特定秘密保護法	トクテイヒミツホゴホウ。
特急	トク別キュウ行。
特技	トクギ。得意ワザ。
特攻隊	トッコウタイ。
特攻隊員	トッコウタイイン。
特有	他にはなく、それだけがトク別に備わっていること。
特権	トク別のケン力。
特殊部隊	トクシュブタイ。
特産物	トクサンブツ。
特筆	特にとりたてて書くこと。「○○すべき美点」
特色	すぐれて目立つ点。「地域の○○を出す」
特許	パテント。
特許庁	トッキョチョウ。
特許権	トッキョケン。
特集	トク定の事件や問題をとりあげること。
特集記事	トクシュウキジ。
特需	経済外的要因によりトクに増大したジュ要。
犬死	イヌジニ。
犯人	ハンニン。
犯罪	刑罰が科せられる行為。社会的に有害な行為。
犯罪歴	ハンザイレキ。
犯罪率	ハンザイリツ。
犯罪者	ハンザイシャ。
犯罪行為	ハンザイコウイ。
犯罪被害者	ハンザイヒガイシャ。
犯行	ハン罪をオコナうこと。ハン罪コウ為。
犯行現場	ハンコウゲンバ。
状態	人や物事の、ある時点でのありさま。
状況	移り変わる物事の、その時々のありさま。
狂気	常軌を逸脱した精神状態。
狂犬病	キョウケンビョウ。
独奏	単一楽器による演ソウ。ソロ。
独学	ドクガク。
独断専行	自分一人の考えて勝手に物事をオコナうこと。
独特	 他になく、それだけにあって際立っているさま。
独立	支援や支配を受けないで、自分の力で行動すること。
独立国家	ドクリツコッカ。
独立宣言	ドクリツセンゲン。
独立戦争	ドクリツセンソウ。
独立独歩	他人の力にたよらず、自分の力だけで行うこと。
独立行政法人	ドクリツギョウセイホウジン。
独立記念日	ドクリツキネンビ。
独自技術	ドクジギジュツ。
独裁	特定の個人・集団が全権力を握り、支配すること。
独裁国家	ドクサイコッカ。
独裁政治	ドクサイセイジ。
独裁者	ドクサイシャ。
独言	ヒトりゴト。
独身	結婚していないこと。シングル。
独身貴族	ドクシンキゾク。
猛吹雪	モウフブキ。
玄米	精白されていない状態のコメ。
玄関	建物の主要な入り口。
率先	ソッセン。
率直	ソッチョク。
玉子焼	タマゴヤき。
玉手箱	タマテバコ。
玉石	直径20cm前後の丸っこい自然石。
玉虫	緑色の金属光沢のある美しい昆虫の一種。
王位	オウのクライ。
王位継承	オウイケイショウ。
王国	コクオウを元首とする君主制のコッ家。
王子	オウ様の男のコ供。プリンス。
王室	オウの宮廷。オウシツ。
王宮	オウのキュウ廷。
王座決定戦	オウザケッテイセン。
王手	将棋で相手のオウ将に直接攻めるテ。
王者	オウである人。最高の地位にある人。
現人神	アラヒトガミ。
現代	ゲン在の時ダイ。今の世。当世。
現代人	ゲンダイジン。
現代文	ゲンダイブン。
現代社会	ゲンダイシャカイ。
現住所	ゲンジュウショ。
現像	写真のゾウを浮かび上がらせる化学的な作業工程。
現在	過去でも未来でもない瞬間。
現在地	ゲンザイチ。
現在進行形	ゲンザイシンコウケイ。…ing。
現地企業	ゲンチキギョウ。
現地協力者	ゲンチキョウリョクシャ。
現地報道	ゲンチホウドウ。
現地指導	ゲンチシドウ。
現地法人	ゲンチホウジン。
現地調査	ゲンチチョウサ。
現地通貨	ゲンチツウカ。
現場	ゲンバ。
現場主義	ゲンバシュギ。
現場作業	ゲンバサギョウ。
現場検証	ゲンバケンショウ。
現場監督	ゲンバカントク。
現実	今、ゲンに事ジツとして存在している事柄・状態。
現役	人がある職に就いている状態。
現役世代	ゲンエキセダイ。
現役引退	ゲンエキインタイ。
現役時代	ゲンエキジダイ。
現段階	ゲンダンカイ。
現物	ゲンにある品モノ。
現状	ゲン在のありさま。
現状維持	ゲンジョウイジ
現象	自然界や人間界に形をとってアラワれる物事。
現金	ゲン在通用している貨幣。キャッシュ。
現金化	ゲンキンカ。
現金書留	ゲンキンカキトメ。
球体	どこから見ても円に見える立タイ。
球団	プロ野キュウのチーム。
球場	野キュウジョウ。
球技	ボールを使う競ギ。
球根	地下部に養分を貯めてふくらんだもの。
理不尽	リフジン。
理事長代行	リジチョウダイコウ。
理化学研究所	リカガクケンキュウジョ。
理性	感情に流されずに物事を考え判断する能力。
理想	そうあってほしいと思う最高の状態。
理想像	リソウゾウ。
理由	リユウ。
理研	リ化学ケン究所。
理科	学校教育で自然界の事物・現象を学ぶ教カ。
理解	物事の理由、原因、意味を正しく知ること。
理解者	リカイシャ。
理論	物事を理解するための体系的知識。セオリー。
理髪店	リハツテン。
琵琶湖	ビワコ。
環境	何かを取り巻き、関係を持つものすべて。
環境保全	カンキョホゼン。
環境問題	カンキョウモンダイ。
環境変化	カンキョウヘンカ。
環境整備	カンキョウセイビ。
環境汚染	カンキョウオセン。
環境省	カンキョウショウ。
環境破壊	カンキョウハカイ。
環太平洋経済連携協定	カンタイヘイヨウケイザイレンケイキョウテイ（ＴＰＰ）。
環状線	カンジョウセン。
甘口	アマクチ。
甘酒	アマザケ。
生中継	ナマチュウケイ。
生体肝移植	セイタイカンイショク。
生半可	ナマハンカ。
生卵	ナマタマゴ。
生命	イき物がイきた状態。
生命保険	セイメイホケン。
生命力	セイメイリョク。
生命科学	セイメイカガク。
生命維持装置	セイメイイジソウチ。
生存	イき残ること。
生存競争	セイゾンキョウソウ。
生存者	セイゾンシャ。
生年月日	セイネンガッピ。
生後	ウまれたアト。
生徒	中学校・高等学校で教育を受ける者。
生徒会	セイトカイ。
生徒会長	セイトカイチョウ。
生息	動物などが生きて生活すること。
生息地	セイソクチ。
生意気	ナマイキ。
生態	生物が自然のもとで生活しているありさま。
生態系	セイタイケイ。
生放送	ナマホウソウ。
生死	イきているかシんでいるか。
生水	ナマミズ。
生活	セイカツ。
生活保護	セイカツホゴ。
生活家電	セイカツカデン。
生活習慣	セイカツシュウカン。
生活習慣病	セイカツシュウカンビョウ。
生活費	セイカツヒ。
生活資金	セイカツシキン。
生物	セイ長・活動し繁殖を営むモノ。
生物兵器	セイブツヘイキ。
生物学	セイブツガク。
生理食塩水	セイリショクエンスイ。
生産	工場などにおいて何かを作り出す行為。
生産効率	セイサンコウリツ。
生産地	セイサンチ。
生産性	セイサンセイ。
生産性向上	セイサンセイコウジョウ。
生産現場	セイサンゲンバ。
生産管理	セイサンカンリ。
生産者	セイサンシャ。
生産能力	セイサンノウリョク。
生産設備	セイサンセツビ。
生産過剰	セイサンカジョウ。
生産量	セイサンリョウ。
生糸	蚕からとったばかりの精練していないイト。
生育	ウまれソダつこと。
生長	植物が大きくなること。
生鮮食品	セイセンショクヒン。
産出	鉱物などがウみダされること。
産卵	タマゴをウむこと。
産地	物が製造・生サンされる土チ。
産声	ウブゴエ。
産婦人科	サンフジンカ。
産業	人間生活のさまざまな経済活動。
産業界	サンギョウカイ。
産業遺産	サンギョウイサン。
産業部門	サンギョウブモン。
産業都市	サンギョウトシ。
産業革命	サンギョウカクメイ。
産毛	ウブゲ。
産油国	サンユコク。
用事	しなければならないコト柄。ヨウ件。
用件	なすべき仕事。ヨウケン。
用地面積	ヨウチメンセキ。
用心	ココロをくばること。注意すること。
用心棒	ヨウジンボウ。
用意	準備。したく。「食事を○○する」
用水路	ヨウスイロ。
用法	使い方。使ヨウ方ホウ。
用紙	サイズや形式の定まったカミ。
用語	ある分野によくモチいられる言葉。
用語集	ヨウゴシュウ。
田園	タと畑。耕作地。デンエン。
田園風景	デンエンフウケイ。
田植	タウえ。
田畑	タハタ。
田舎	イナカ。
由来	ユライ。
申出	モウしデ。
申分	モウしブン。
申訳	モウしワケ。
申込	モウしコみ。
申込書	モウシコミショ。
申込番号	モウシコミバンゴウ。
男優	ダン性の俳ユウ。
男前	オトコマエ。
男女	オトコとオンナ。
男女共同参画	ダンジョキョウドウサンカク。
男女平等	ダンジョビョウドウ。
男女関係	ダンジョカンケイ。
男女雇用均等法	ダンジョコヨウキントウホウ。
男子	オトコのコ。
男子生徒	ダンシセイト。
男性	女じゃない性別。
男風呂	オトコブロ。
町工場	マチコウバ。
町長	マチのチョウ。
画一的	枠にはまっているさま。
画像	ガゾウ。
画家	絵を描く人。
画数	字を組み立てているカクのカズ。
画期的	カッキテキ。
画板	絵を描くために使う、紙の下のイタ。
画用紙	ガヨウシ。
画面	テレビやパソコンなどの映像の一メン。
畑仕事	ハタケシゴト。
畑作	ハタケにサク物をツクること。
留任	やめずにニン務にトドまること。 
留学	外国に行って教育を受けること。
留守	家の人が外出中にその家をマモること。
留守番	ルスバン。
留守番電話	ルスバンデンワ。
留金	トめガネ。
畜産農家	チクサンノウカ。
略図	簡リャクに描いたズ。
略字	点や画を省リャクした文ジ。
略式起訴	リャクシキキソ。
略歴	 おおよその経レキ。
略称	簡リョクにしたナ前。
略語	短く省リャクした言葉。
番人	バンをするヒト。見張りをするヒト。
番付	大相撲における力士の順位表。
番号	ナンバー。「暗証○○」
番地	バンチ。
番犬	バンケン。
番組	テレビ・ラジオのプログラム。
異例	普通と違ったレイ。前レイのないこと。
異口同音	多くの人がクチをそろえてオナじことを言うこと。
異国	風俗・習慣などがコトなるクニ。外コク。
異変	普段は見られないイ常な現象・出来事。ヘン事。
異存	反対の意見。不服なこと。「○○はありません」
異常	普通ではないこと。アブノーマル。
異常事態	イジョウジタイ。
異性	セイ別の違う人。
異様	普通とは変わったヨウ子。
異次元	イジゲン。
異物	本来不必要なのに入ってしまうモノ。
異物混入	イブツコンニュウ。
異色	目立った特ショクのあるさま。
異論	別の意見。コトなったロン。イ議。
異議	反対する意見。「○○申し立て」「○○を唱える」
疑問	ウタガいトうこと。
疑問文	ギモンブン。
疑心暗鬼	何も信じられなくなること。
疑惑	真偽や正・不正についてのウタガい。
病人	ビョウ気にかかっているヒト。
病原菌	ビョウゲンキン。
病名	ビョウ気のナ前。
病室	ビョウ人の寝る部屋。
病弱	ビョウ気がちで身体がヨワいこと。
病死	ビョウ気でシぬこと。
病気	生物の正常な状態がそこなわれること。
病状	ビョウ気のジョウ態。
病院	ビョウ人やけが人に対し医療を提供する施設。
症状	生体が病気にかかったときに認められる変化。
痛切	身にしみて強く感じること。「つらさが○○に感じる」
痛感	心に強くカンずること。「未熟さを○○する」
痛手	イタデ。
痛止	イタみドめ。
発作	ホッサ。
発信	電シン・電波などをハッすること。
発光	ヒカリをハッすること。
発光現象	ハッコウゲンショウ。
発声練習	ハッセイレンシュウ。
発売	ウりに出されること。
発売日	ハツバイビ。
発売禁止	ハツバイキンシ。
発売開始	ハツバイカイシ。
発射	ロケット・ミサイルなどを撃ち出すこと。
発射台	ハッシャダイ。
発展	勢いなどが盛んになり、栄えること。
発展途上国	ハッテントジョウコク。
発掘調査	ハックツチョウサ。
発揮	力などを外に出してうまく働かせること。「本領○○」
発散	外部へ散らばり出すこと。「ストレス○○」
発明	従来なかった物や方法を考え出すこと。
発明家	ハツメイカ。
発泡酒	ハッポウシュ。
発注	品物や仕事のチュウ文をウけること。
発火	連続的な燃焼を始めること。着カ。
発火点	ハッカテン。
発熱	ネツをハッすること。
発狂	精神に異常をきたすこと。
発生	社会や自然である事物がショウじること。
発病	ビョウ気になること。
発着	出パツすることと到チャクすること。
発禁	ハツ売キン止。
発禁本	ハッキンボン。
発育	ソダって大きくなること。「○○がいい」
発芽	草木がメを出すこと。
発行手数料	ハッコウテスウリョウ。
発表	世間へオモテ向きに知らせること。
発表会	ハッピョウカイ。
発見	新しくミつけ出すこと。
発覚	隠していた罪などが人に知られること。
発言	口頭で意見を述べること。
発言機会	ハツゲンキカイ。
発足	ホッソク。
発車	クルマが走り出すこと。
発車時刻	クルマをハッシャするジコク。
発送	物をオクり出すこと。
発送電分離	ハッソウデンブンリ。
発達	成長してより高度になり、大きくなること。
発達障害	ハッタツショウガイ。
発電	デン気を起こすこと。
発電所	ハツデンショ。
発電機	ハツデンキ。
発電設備	ハツデンセツビ。
発電量	ハツデンリョウ。
発音	言葉のオトをハッすること。
発音記号	ハツオンキゴウ。
登場	舞台や小説などに人物が現れること。
登場人物	トウジョウジンブツ。
登山	ヤマにノボること。
登山家	トザンカ。
登山道	トザンドウ。
登庁	役人が官チョウ・役所に出勤すること。
登校	授業や勤務などのために学コウに行くこと。
登校拒否	トウコウキョヒ。
登校日	トウコウビ。
登録	帳簿に記し載せること。
登録商標	トウロクショウヒョウ。
登録数	トウロクスウ。
白人	肌のシロいヒト。
白内障	ハクナイショウ。
白寿	九十九歳。
白星	相撲で勝つこと。
白波	シラナミ。
白熱	物がネッせられてハク色の光を出して輝くこと。
白熱電球	ハクネツデンキュウ。
白物家電	シロモノカデン。
白状	自分の犯した罪や秘密を話すこと。
白米	ハクマイ。
白紙	シロいカミ。何も書いてないカミ。
白組	赤グミに対抗するクミ。
白色	シロいイロ。
白色人種	ハクショクジンシュ。
白菜	野サイのハクサイ。
白血球	ハッケッキュウ。
白血病	ハッケツビョウ。
白衣	シロいイ装。
白身	卵などのシロミ。
白骨	シロいホネ。
白骨化	ハッコツカ。
白髪	シロいカミ。
白鳥	ハクチョウ。
白黒	モノクロ。
白黒写真	シロクロシャシン。
百人一首	ヒャクニンイッシュ。
百分率	パーセントを漢字で。
百点満点	ヒャクテンマンテン。
百発百中	予想がいつでも必ず当たること。
百科事典	ヒャッカジテン。
百貨店	ヒャッカテン。
的中	矢や弾丸などがマトにアタること。
的外	マトハズれ。
的確	マトをはずさない、間違いがないさま。
皇太子	コウタイシ。
皇子	天ノウの男のコ。
皇室	天ノウを中心とする一つの家。コウシツ。
皇居	天ノウの平常時における住キョ。
皇帝	「王」よりも上の、君主の称号。
皇族	天ノウの、天ノウ以外の親ゾク。
皮切	カワキり。
皮肉	カワとニク。意地悪く遠まわしに非難すること。
益虫	人間にとって都合のいいムシ。
盗撮防止	トウサツボウシ。
盗聴器	トウチョウキ。
盗難	金品を盗まれること。「○○届」
盗難保険	トウナンホケン。
盗難届	トウナントドケ。
盗難車	トウナンシャ。
盛土	モりツチ。
盛場	サカりバ。
盛大	集会や儀式が、きわめてサカんなこと。
監督	ディレクター。
監禁	本人の意思に反して特定の場所に閉じ込めること。
監視	警戒して人の動きなどを見張ること。
目上	年齢・地位・階級などが自分より高いこと。
目下	年齢・地位・階級などが自分より低いこと。
目分量	メブンリョウ。
目前	メのマエ。モクゼン。
目印	メジルシ。
目安	メヤス。
目安箱	メヤスバコ。
目星	メ当て。モク標。見当。 「○○をつける」
目標	目指している最終的な結果。
目標達成	モクヒョウタッセイ。
目標額	モクヒョウガク。
目次	書物の内容の見出し書き。モクジ。
目測	モクソク。
目玉	メダマ。
目玉焼	メダマヤキ。
目的	実現または到達しようとしてメ指す事柄。
目的地	モクテキチ。
目的外利用	モクテキガイリヨウ。
目的意識	モクテキイシキ。
目覚	メザめ。
目頭	メガシラ。
直下	「赤道○○」「○○型地震」
直下型地震	チョッカガタジシン。
直列	二つ以上のものが縦一チョク線に並ぶこと。
直前	スぐマエ。
直売所	チョクバイジョ。
直射日光	チョクシャニッコウ。
直径	半ケイの二倍。
直後	スぐアト。
直感	感覚的に物事を瞬時にカンじとること。
直接	ジカにセッすること。
直接対決	チョクセツタイケツ。
直接民主制	チョクセツミンシュセイ。
直方体	すべての面が長ホウ形になっている六面タイ。
直流	時間によって方向が変化しない電流。
直球	まっスぐに進む投キュウ。
直立不動	チョクリツフドウ。
直結	二つの物をチョク接にムスび付けること。
直線	まっスぐしたセン。
直線距離	チョクセンキョリ。
直線道路	チョクセンドウロ。
直行便	チョッコウビン。
直視	目をそらさず、じっと見ること。
直角	９０度。
直角三角形	９０度のカクのあるサンカッケイ。
直訳	翻訳する際に原文の持つ意味を忠実に再現する手法。
直訴	チョク接に請願を行なうこと。
直談判	ジカダンパン。
直進	まっスぐススむこと。
直面	物事にチョク接、対すること。
相互理解	ソウゴリカイ。
相似	ある図形を拡大・縮小すると他の図形に完全に重なること。
相場	競争売買によって決まる商品の値段・価格。
相対性理論	ソウタイセイリロン。
相思相愛	男女がおたがいに好きであること。
相性	二人のそれぞれ持つセイ質やセイ格が合うかどうか。
相手	一緒になって物事をする、別の人。
相手校	アイテコウ。
相棒	アイボウ。
相続	財産などを他の人が承継すること。
相続人	ソウゾクニン。
相続権	ソウゾクケン。
相続税	ソウゾクゼイ。
相談	物事を決めるために、意見を聞いたり話し合うこと。
相談内容	ソウダンナイヨウ。
相談室	ソウダンシツ。
相談相手	ソウダンアイテ。
相談窓口	ソウダンマドグチ。
省略	一部分をハブくこと。 
看守	刑務所や拘置所の職員。
看板	宣伝、広告等のために使われるイタ状の物体。
看病	ビョウ人に付き添って世話をすること。
看護師	カンゴシ。
県内移設	ケンナイイセツ。
県境	ケンザカイ。
県外移設	ケンガイイセツ。
県庁	ケンの行政事務を執り行う役所。
県庁所在地	ケンチョウショザイチ。
県知事	ケンチジ。
県立	ケンが設立・管理していること。「○○図書館」
県道	ケンが設立・管理しているドウ路。
真価	物や人の持つ本当の値打ち。
真先	マっサキ。
真冬	マフユ。
真剣	本物の刀。本気。
真剣勝負	シンケンショウブ。
真夏	マナツ。
真夜中	マヨナカ。
真実	嘘や偽りがない本当のこと。
真心	マゴコロ。
真意	本当のイ味。本当の気持ち。
真昼	マヒル。
真暗	マっクラ。
真正面	マショウメン。
真水	マミズ。
真理	いつどんなときにも変わらないシン実の道リ。
真相	事件などの本当の事情。
真空	空気などの物質がほとんどない空間。
真綿	マワタ。
真赤	マっカ。
真面目	マジメ。
真顔	マガオ。
真骨頂	シンコッチョウ。
眼中	目に映る範囲内。「○○にない」
眼球	目玉。ガンキュウ。
眼科	メに関する診療・予防・研究を行う医学の分カ。
眼科医	ガンカイ。
眼鏡	視力補正などのために目の周りにつける器具。
眼鏡型端末	メガネガタタンマツ。
着実	落ちツいて確ジツに物事を行うこと。
着工	コウ事にチャク手すること。
着席	セキにツくこと。
着心地	キゴコチ。
着想	思いつき。アイデア。「○○を得る」
着手	仕事にテをツけること。とりかかること。
着服	金品をひそかに盗んで自分のものにすること。
着火	ヒをツけること。
着物	キモノ。
着眼	目を付けること。
着眼点	チャクガンテン。
着色	イロをツけること。
着色料	チャクショクリョウ。
着陸	飛行機などが地上に降りること。
睡眠	ネムること。
睡眠時間	スイミンジカン。
瞬間	シュンカン。
矢印	↑↓←→などの記号。
知事	地方行政を統轄する官庁の長。
知事選	チジセン。
知人	シり合い。
知名度	チメイド。
知名度不足	チメイドブソク。
知性	物事をシり、考え、判断する能力。
知恵	物事の道理を判断し処理していく心の働き。「○○を借りる」
知恵袋	チエブクロ。
知的生命体	チテキセイメイタイ。
知的財産	チテキザイサン。
知的財産権	チテキザイサンケン。
知的障害	チテキショウガイ。
知能	物事を理解したり判断したりするノウ力。
知能指数	チノウシスウ。
知識	チシキ。
知識人	チシキジン。
短冊	細長く切った木や紙の小片。七夕で飾る。
短命	イノチがミジカいこと。
短大	タン期ダイ学。
短所	長ショの反対。
短文	ミジカいブン。
短時間	タンジカン。
短時間労働	タンジカンロウドウ。
短期	ミジカいキ間。
短期大学	タンキダイガク。
短歌	５・７・５・７・７の音で詠む詩。
短気	おこりっぽいこと。
短波	ハ長がミジカい電パ。
短編小説	タンペンショウセツ。
短縮	ミジカくチヂめること。
短調	悲しい感じの曲チョウ。
短距離	タンキョリ。
石器	イシを加工して製作した道具・武キなど。
石器時代	セッキジダイ。
石川県	金沢市をケン庁所在地とするケン。
石材	ザイ料とするイシ。
石橋	イシバシ。
石油	セキユ。
石油会社	セキユガイシャ。
石油採取	セキユサイシュ。
石油製品	セキユセイヒン。
石油輸出国機構	セキユユシュツコクキコウ（ＯＰＥＣ）。
石灰	CaOまたはCa(OH)2。漆喰の原材料。
石灰水	二酸化炭素をストローで注入すると白濁。
石炭	「黒いダイヤ」と呼ばれた燃料。
石頭	イシアタマ。
砂利	ジャリ。
砂場	スナバ。
砂時計	スナドケイ。
砂糖	シュガー。
砂糖水	サトウミズ。
砂金	スナのようなキン。
砂鉄	スナのようなテツ。
研修	知識や技能を高めるために行われる講習。
研修医	ケンシュウイ。
研究	考えたり調べたりして物事の真理を明らかにすること。
研究不正	ケンキュウフセイ。
研究成果	ケンキュウセイカ。
研究所	ケンキュウジョ。
研究機関	ケンキュウキカン。
研究結果	ケンキュウケッカ。
研究者	ケンキュウシャ。
研究開発	ケンキュウカイハツ。
破壊	コワすこと。コワれること。
破局	男女の仲が決定的に悪くなり、別れること。
破損	壊れること。いたむこと。
破片	ハヘン。
破産	財サンをすべて失い、借金を帳消しにする手続き。
破産手続	ハサンテツヅキ。
破裂	勢いよくはじけてヤブれること。
硫化水素	火山の臭いの元。
硫酸	H2SO4。無色酸性の液体。
硫黄	元素記号S、原子番号16の元素。
硬貨	コイン。
確保	カク実に手に入れること。
確信	かたくシンじて疑わないこと。
確信犯	カクシンハン。
確固	しっかりして動かないさま。「○○たる信念」
確定	はっきりとサダまること。サダめること。
確定申告	カクテイシンコク。
確実	そうなることがタシかな様子。
確率	事柄の起こりやすさ。カクリツ。
確立	しっかりと打ち立てること。カクリツ。
確認	タシかめること。
確認作業	カクニンサギョウ。
磁力	ジ石の性質によって働くチカラ。
磁力線	ジリョクセン。
磁気	ジ石に特有な物理的性質。
磁石	マグネット。
示談	ジダン。
示談金	ジダンキン。
礼儀	レイギ。
礼儀作法	レイギサホウ。
礼拝	神仏などの信仰対象をオガむこと。
礼拝堂	レイハイドウ。
社交	世間づきあい。「○○ダンス」
社会	世の中・人間の環境・人間の生活。
社会主義	シャカイシュギ。
社会人	シャカイジン。
社会人野球	シャカイジンヤキュウ。
社会保険	シャカイホケン。
社会保険事務所	シャカイホケンジムショ。
社会保険料	シャカイホケンリョウ。
社会保障	シャカイホショウ。
社会保障制度	シャカイホショウセイド。
社会保障費	シャカイホショウヒ。
社会全体	シャカイゼンタイ。
社会制度	シャカイセイド。
社会問題	シャカイモンダイ。
社会基盤	シャカイキバン。
社会復帰	シャカイフッキ。
社会福祉士	シャカイフクシシ。
社会福祉法人	シャカイフクシホウジン。
社会福祉活動	シャカイフクシカツドウ。
社会科	シャカイカ。
社会運動	シャカイウンドウ。
社員	会シャの従業イン。
社員旅行	シャインリョコウ。
社員研修	シャインケンシュウ。
社外取締役	シャガイトリシマリヤク。
社宅	会シャが用意・保有した住タク。
社説	新聞・雑誌などでその会シャの主張として載せる論セツ。
社長	会シャを代表する、会シャで一番偉い人。
祖先	ソセン。
祖国	ソコク。
祖母	ソボ。
祖父	ソフ。
祝日	イワいのヒ。
祝福	シュクフク。
祝辞	イワいの言葉。
神主	ジン社に仕えてカミをまつる人。
神仏	カミ様とホトケ様。
神前結婚式	シンゼンケッコンシキ。
神奈川県	東京都の南に位置するケン。
神戸牛	コウベギュウ。
神業	カミワザ。
神楽	カグラ。
神様	カミサマ。
神殿	「パルテノン○○」
神父	カトリック教会の聖職者。
神社	日本の神道の祭祀施設。入り口に鳥居がある。
神秘	人間の知恵では計り知れない不思議。
神秘的	シンピテキ。
神経	情報伝達を担う、動物に見られる組織。
神経衰弱	シンケイスイジャク。
神経質	シンケイシツ。
神聖	けがれなく尊いこと。
神話	「ローマ○○」「ギリシャ○○」「日本○○」
神通力	ジンツウリキ。
神道	自然を敬い、八百万の神を尊ぶ日本の多神教。
祭典	マツりの儀式。盛大で華やかな行事。
祭日	マツりのヒ。
禁句	タブー。
禁欲	様々なヨッ求・ヨク望を、理性で抑えること。
禁止	してはいけないと命ずること。
禁漁	魚介類をとることをキンずること。
禁煙	タバコを吸うことをキンずること。
禁物	慎んで避けなければならない事柄。「油断は○○」
福井県	眼鏡のフレーム生産量日本一のケン。
福利厚生費	フクリコウセイヒ。
福岡県	九州地方北部にあるケン。
福島原発事故	フクシマゲンパツジコ。
福島県	大きな震災と原発事故があったケン。
福島第一原子力発電所	フクシマダイイチゲンシリョクハツデンショ。
福島第一原発	フクシマダイイチゲンパツ。
福引	フクビキ。
福引券	フクビキケン。
福祉施設	フクシシセツ。
秀才	学問・サイ能の優れた人。
私利私欲	シリシヨク。
私営鉄道	シエイテツドウ。
私学	シ立のガク校。
私書箱	シショバコ。
私有地	シユウチ。
私服	普段着。
私物	個人の所有ブツ。
私用	自分のことに使うこと。自分のヨウ事。
私立	個人や法人が設立し経営していること。
私立中学校	シリツチュウガッコウ。
私語	場の流れを乱す会話。
私財	個人の所有するザイ産。
私鉄	シ企業のみにより運営されるテツ道。
秋分	アキに昼と夜の長さがほぼ等しくなる日。
秋晴	アキバれ。
秋田県	青森の北、山形の南にあるケン。
秋祭	アキマツり。
秋風	アキカゼ。
科学	サイエンス。
科学技術	カガクギジュツ。
科学者	サイエンティスト。
科目	学校で授業を分野別に分類したもの。カモク。
秒読	ビョウヨみ。
秒速	一ビョウあたりに進む距離で表したハヤさ。
秒針	ビョウを表す時計のハリ。
秘伝	ヒ密にして、特別の人にだけデン授すること。
秘境	まだ一般によく知られていない地域。
秘密	シークレット。
秘密厳守	ヒミツゲンシュ。
秘密指定	ヒミツシテイ。
秘書	組織や上司の書類面における仕事を請け負う職務。
秘蔵	非常に大切なものを他人にほとんど見せないで保管すること。
移住	スむ場所をウツすこと。
移動	位置を他の場所にウツすこと。
移動制限区域	イドウセイゲンクイキ。
移動手段	イドウシュダン。
移植	プログラムを他の機種でも動くように変更すること。
移植手術	イショクシュジュツ。
移民	異なる国へウツり住む人々のこと。
移転	位置・住所などを変えること。「事務所を○○する」
移転先	イテンサキ。
程度	他と比べたときの、高低・強弱・優劣などのド合い。
程遠	ホドトオい。
税制改正	ゼイセイカイセイ。
税制調査会	ゼイセイチョウサカイ。
税務署	ゼイムショ。
税込価格	ゼイコミカカク。
税金	ゼイキン。
税関	ゼイカン。
税額	ゼイ金の金ガク。
種子	タネ。
種子島	鉄砲伝来の島。
種族	共通の特徴を持った生物の集団。
種目	シュ類別に分けた項モク。
種類	共通の性質で分けたそれぞれのグループ。
積乱雲	セキランウン。
積木	ツみキ。
積極的	セッキョクテキ。
積極的平和主義	セッキョクテキヘイワシュギ。
積荷	ツミニ。
積雪	セキセツ。
空中	クウチュウ。
空中分解	クウチュウブンカイ。
空回	カラマワり。
空巣	アきス。
空席	クウセキ。
空想	クウソウ。
空手	カラテ。
空手道場	カラテドウジョウ。
空模様	ソラモヨウ。
空母	クウボ。
空気	エア。
空気清浄器	クウキセイジョウキ。
空海	真言宗の開祖。弘法大師。
空港	公共用飛行場。
空白	クウハク。
空白期	クウハクキ。
空耳	ソラミミ。
空腹	おナカがスいた。
空路	飛行機の飛ぶコース。
空軍	クウグン。
空輸	航クウ機で人や荷物をユ送すること。
空間	アき。スペース。
突拍子	トッピョウシ。
突然	だしぬけに。いきなり。トツゼン。
突破	障害や困難を突き破って通り抜けること。 
突進	ツきススむこと。
突風	トップウ。
窓口	マドグチ。
窓辺	マドベ。
立体	リッタイ。
立体駐車場	リッタイチュウシャジョウ。
立候補	リッコウホ。
立冬	フユの始まり。11月7日ごろ。
立地条件	リッチジョウケン。
立場	タチバ。
立方体	同じ大きさの正ホウ形で囲まれたリッタイ。
立春	ハルの始まり。2月4日ごろ。
立案	アンを作ること。計画をタてること。
立派	非常に素晴らしいさま。
立看板	タてカンバン。
立秋	アキの始まり。8月7日ごろ。
立腹	ハラをタてること。
童心	子どもゴコロ。
童話	大人が読み聞かせる、子ども向けのハナシ。
童顔	子どもっぽいカオ立ち。
端数	ハスウ。
端末	操作できる機器。「タブレット○○」
競争	同じことを行って勝敗・優劣をキソい合うこと。
競争入札	キョウソウニュウサツ。
競争力	キョウソウリョク。
競争力強化	キョウソウリョクキョウカ。
競争原理	キョウソウゲンリ。
競争激化	キョウソウゲキカ。
競争相手	キョウソウアイテ。
競売	オークション。キョウバイ。
競技	ワザをキソうこと。
競技人口	キョウギジンコウ。
競技場	キョウギジョウ。
競泳	オヨぎをキソうこと。
競走	ハシりをキソうこと。
競走馬	キョウソウバ。
競輪	自転車を用いて争うキョウ技。
競馬	ウマを走らせてキソうキョウ技。
競馬場	ケイバジョウ。
竹刀	剣道で用いられる、竹で作られた刀。
竹細工	タケザイク。
竹輪	チクワ。
竹馬	タケウマ。
笑声	ワラいゴエ。
笑話	ワラいバナシ。
笑顔	エガオ。
第一印象	ダイイチインショウ。
第一次世界大戦	ダイイチジセカイタイセン。
第一次産業	ダイイチジサンギョウ
第三国	ダイサンゴク。
第三者	ダイサンシャ。
第二次世界大戦	ダイニジセカイタイセン。
筆算	紙に書いて行う計サン。
筆者	作品を書いた人。
筆記	書きシルすこと。フデで書くこと。
筆記試験	ヒッキシケン。
筆跡	書いた文字の特徴。
筆跡鑑定	ヒッセキカンテイ。
等分	ヒトしくワけること。
等号	「＝」
等身大	トウシンダイ。
等高線	トウコウセン。
筋肉	キンニク。
筋肉痛	キンニクツウ。
筋金	スジガネ。
答弁	トウベン。
答案	トウアン。
答案用紙	トウアンヨウシ。
策略	サクリャク。
算出	計サンして数値をダすこと。
算数	小学校で習う、カズや図形に関する教科。
算用数字	サンヨウスウジ。
管楽器	カンガッキ。
管理	マネジメント。
管理体制	カンリタイセイ。
管理栄養士	カンリエイヨウシ。
管理者	カンリシャ。
管理職	カンリショク。
管理責任者	セキニンカンリシャ。
管理部門	カンリブモン。
節分	二月に豆まきを行う行事。
節水	ミズをセツ約すること。
節穴	フシアナ。
節約	無駄づかいをなるべくなくすように努めること。
節電	デン気をセツ約すること。
範囲	ある一定の限られた広がり。ある区域。
簡単	大ざっぱでタン純なこと。手間がかからないこと。
簡易	手軽なこと。カン単でたヤスいさま。
簡易書留	カンイカキトメ。
簡易検査	カンイケンサ。
簡潔	シンプル。
簡略	複雑なことは省いて、カン単なさま。
簿記	日々の経営活動を記録・計算・整理すること。
米俵	コメダワラ。
米国	アメリカ。
米国産	ベイコクサン。
米国産牛肉	ベイコクサンギュウニク。
米国経済	ベイコクケイザイ。
米寿	八十八歳。
米所	コメドコロ。
米軍基地	ベイグンキチ。
粉末	フンマツ。
粉薬	コナグスリ。
粉雪	コナユキ。
粘土	こねて形を作るもの。ネンド。
粘度	物質のネバり気のド合い。
精力	スタミナ。
精密	セイミツ。
精密検査	セイミツケンサ。
精密機械	セイミツキカイ。
精密機械部品	セイミツキカイブヒン。
精神	心、意識、気力など。
精神力	セイシンリョク。
精神安定剤	セイシンアンテイザイ。
精神年齢	セイシンネンレイ。
精神状態	セイシンジョウタイ。
精神病	セイシンビョウ。
精神科	セイシンカ。
精神科医	セイシンカイ。
精神論	セイシンロン。
精算	金額を細かく計サンして結果を出すこと。
精米	セイマイ。
精米所	セイマイジョ。
精米機	セイマイキ。
精肉店	セイニクテン。
精製	混合物を純物質にする工程。
精通	あることについて詳しく知っていること。
精進	雑念を去り、仏道修行に専心すること。
糖分	ある食べ物の中に含まれているトウの量。
糸口	イトグチ。
糸電話	イトデンワ。
系列	ケイレツ。
紀元	キリスト生誕の年。
紀元前	キリスト降誕の年以前。B.C.
約分	ブン子とブン母を同じ数で割ってより簡単なブン数にすること。
約数	そのカズを割ることのできるカズ。
約束	ヤクソク。
約束事	ヤクソクゴト。
紅一点	コウイッテン。
紅白	ベニ色とシロ色。
紅白歌合戦	コウハクウタガッセン。
紅色	ベニイロ。
紅茶	コウチャ。
紅葉	モミジ。
納入	品物や金をオサめること。
納入期限	ノウニュウキゲン。
納品	シナ物をノウ入すること。
納品書	ノウヒンショ。
納得	ナットク。
納税	ゼイ金をオサめること。
納税者	ノウゼイシャ。
納豆	大豆が発酵して糸を引く食べ物。
純利益	ジュンリエキ。
純情	ジュン粋で邪心のない心。
純白	まじりけのないシロ色。
純真	邪念がなくて心が清らかなこと。
純金	まじり物のないゴールド。
純金積立	ジュンキンツミタテ。
紙一重	カミヒトエ。
級友	クラスメイト。
紛争	もめ事やアラソいごと。フンソウ。
素人	シロウト。
素手	スデ。
素材	ソザイ。
素直	スナオ。
素行調査	ソコウチョウサ。
素質	ソシツ。
素足	スアシ。
素顔	スガオ。
紫外線	シガイセン。ＵＶ。
紫式部	ムラサキシキブ。
紫色	青と赤の中間のイロ。
累積赤字	ルイセキアカジ。
細工	サイク。
細心	コマかな点にまで気を配ること。「○○の注意を払う」
細胞	サイボウ。
細菌	ブドウ球キン、大腸キン、ボツリヌスキンなど。
細道	ホソミチ。
紹介	イントロダクション。
紹介状	ショウカイジョウ。
終始一貫	ハジめからオわりまで、ずっと同じ調子であること。
終息	物事がオわって、やむこと。シュウソク。
終戦	セン争がオわること。
終戦記念日	シュウセンキネンビ。
終日	一ニチじゅう。「○○禁煙」
終末期医療	シュウマツキイリョウ。
終業式	シュウギョウシキ。
終止符	ピリオド。
終点	ある路線のオわる地テン。
終着駅	シュウチャクエキ。
終身刑	シュウシンケイ。
組体操	クミタイソウ。
組織	ソシキ。
組織体質	ソシキタイシツ。
組織力	ソシキリョク。
組織図	ソシキズ。
組織的犯行	ソシキテキハンコウ。
経営	会社事業をイトナむこと。
経営不振	ケイエイフシン。
経営再建	ケイエイサイケン。
経営学	ケイエイガク。
経営統合	ケイエイトウゴウ。
経営者	ケイエイシャ。
経営術	ケイエイジュツ。
経営計画	ケイエイケイカク。
経営資源	ケイエイシゲン。
経歴	ケイレキ。
経済	エコノミクス。
経済不安	ケイザイフアン。
経済再生	ケイザイサイセイ。
経済制裁	ケイザイセイサイ。
経済効果	ケイザイコウカ。
経済協力	ケイザイキョウリョク。
経済協力開発機構	ケイザイキョウリョクカイハツキコウ（ＯＥＣＤ）。
経済危機	ケイザイキキ。
経済同友会	ケイザイドウユウカイ。
経済団体	ケイザイダンタイ。
経済大国	ケイザイタイコク。
経済学	エコノミクス。
経済学者	ケイザイガクシャ。
経済対策	ケイザイタイサク。
経済悪化	ケイザイアッカ。
経済成長	ケイザイセイチョウ。
経済成長率	ケイザイセイチョウリツ。
経済指標	ケイザイシヒョウ。
経済援助	ケイザイエンジョ。
経済政策	ケイザイセイサク。
経済新聞	ケイザイシンブン。
経済最優先	ケイザイサイユウセン。
経済格差	ケイザイカクサ。
経済活動	ケイザイカツドウ。
経済活性化	ケイザイカッセイカ。
経済活性化対策	ケイザイカッセイカタイサク。
経済特区	ケイザイトック。
経済状況	ケイザイジョウキョウ。
経済産業省	ケイザイサンギョウショウ。
経済界	ケイザイカイ。
経済白書	ケイザイハクショ。
経済的	ケイザイテキ。
経由	…を通って。via.
経費	かかったヒ用。
経費削減	ケイヒサクゲン。
経路	通る道順。道すじ。
経路検索	ケイロケンサク。
経過	時間がスぎること。「一年が○○した」
経験	実際に見たり、聞いたり、やってみること。
経験則	ケイケンソク。
経験者	ケイケンシャ。
経験豊富	ケイケンホウフ。
結合	二つ以上のものがムスびついて一つになること。
結婚	夫婦になること。
結婚式	ケッコンシキ。
結婚指輪	ケッコンユビワ。
結婚相手	ケッコンアイテ。
結婚記念日	ケッコンキネンビ。
結実	ミをムスぶこと。
結局	囲碁で、一局を打ち終えること。ケツ末。
結成	グループやバンドを作ること。
結末	最後の締めくくり。
結束	志を同じくする者が団ケツすること。
結果	ある原因や行為から生じた、ケツ末や状態。
結果発表	ケッカハッピョウ。
結構	「○○面白い」「頂かなくても○○」「もう○○です」
結論	考えたりロンじたりして得られる最終的な判断。
給仕	食事の席にいて世話をすること。
給料	サラリー。
給料日	キュウリョウビ。
給料明細	キュウリョウメイサイ。
給料袋	キュウリョウブクロ。
給料計算	キュウリョウケイサン。
給水	スイ道施設によってミズを供キュウすること。
給油	アブラを補キュウすること。
給食	ショク事の供キュウ、または供キュウされたショク事。
給食当番	キュウショクトウバン。
給食費	キュウショクヒ。
統一	ヒトつにまとめること。
統一地方選挙	トウイツチホウセンキョ。
統一教会	トウイツキョウカイ。
統治	その国土・人民を支配し、オサめること。
統率	多くの人をまとめてヒキいること。
統計	社会集団の状況を数字によって表現したもの。
統計学	トウケイガク。
絵具	エのグ。
絵巻物	エマキモノ。
絵文字	エモジ。
絵日記	エニッキ。
絵本	エホン。
絵画	カイガ。
絵筆	エフデ。
絵馬	エマ。
絶交	ゼッコウ。
絶体絶命	どうしようもできないむずかしい状態。
絶品	ゼッピン。
絶大	この上もなくオオきいさま。「効果は○○だった」
絶好調	ゼッコウチョウ。
絶対	ゼッタイ。
絶対値	ゼッタイチ。
絶対安静	ゼッタイアンセイ。
絶対服従	ゼッタイフクジュウ。
絶対音感	ゼッタイオンカン。
絶景	すばらしいケ色。ゼッケイ。
絶望	ノゾみがタたれたこと。
絶滅	生物種がすべて死に、その種がタえること。
絶滅動物	ゼツメツドウブツ。
絶賛	この上なくほめること。ゼッサン。
絶賛発売中	ゼッサンハツバイチュウウ。
絶頂	 山のチョウ上。物事の最高の状態。「人気の○○」
絶頂期	ゼッチョウキ。
絹糸	キヌイト。
絹織物	キヌオリモノ。
継続	途切れずにツヅくこと。ツヅけること。
継続勤務	ケイゾクキンム。
続出	同じようなことがツヅけざまに次々と起こること。
続行	中止しないでツヅけてオコナうこと。
維持	同じ状態を保ち続けること。「現状○○」
維持管理	イジカンリ。
維持費	イジヒ。
綿密	細かく注意が行き届いていること。「○○な計画」
綿毛	ワタゲ。
綿織物	メンオリモノ。
綿花	ワタのハナ。メンカ。
綿雲	ワタグモ。
緊張	心やからだが引き締まること。
緊張感	キンチョウカン。
緊張状態	キンチョウジョウタイ。
緊急	対応・処置にキュウを要する重大な事態。
緊急地震速報	キンキュウジシンソクホウ。
緊急指令	キンキュウシレイ。
総事業費	ソウジギョウヒ。
総会	特定の組織・団体に所属する者が集まるカイ合。
総出	ソウデ。
総力	すべてのチカラ。
総務省	ソウムショウ。
総合	様々な要素を含むこと。「○○バラエティ」
総合戦略	ソウゴウセンリャク。
総合病院	ソウゴウビョウイン。
総合職	ソウゴウショク。
総工費	ソウコウヒ。
総意	組織・団体全体のイ思。
総書記	ソウショキ。
総理	首相のこと。
総理大臣	首相のこと。
総称	いくつかのものを一つにまとめたナ前。
総選挙	ソウセンキョ。
総重量	ソウジュウリョウ。
総額	全部の金ガク。
緑化	植物を増やすこと。
緑化運動	植物を増やそうというウンドウ。
緑地	リョクチ。
緑色	ミドリイロ。
緑茶	ミドリ色のおチャ。
線対称	センタイショウ。
線路	電車が通る道。
線香	昔は「蚊取り○○」なるものが使われていた。
線香花火	センコウハナビ。
編集	文章・映画などの素材を組み立ててまとめ上げること。
編集者	ヘンシュウする人。
編集部	ヘンシュウブ。
練乳	レンニュウ。
練炭	レンタン。
練炭自殺	レンタンジサツ。
練習	上達するように繰り返してナラうこと。
練習問題	レンシュウモンダイ。
練習試合	レンシュウジアイ。
縁側	エンガワ。
縁談	結婚に関するめでたい話。
縁談話	エンダンバナシ。
縁起物	エンギモノ。
縄文式土器	ジョウモンシキドキ。
縦列駐車	ジュウレツチュウシャ。
縦横比	タテとヨコのヒ率。
縦横無尽	ジュウオウムジン。
縦糸	タテのイト。
縮図	シュクズ。
縮小	チヂめてチイさくすること。
縮尺	シュクシャク。
織物	オリモノ。
織田信長	戦国時代から安土桃山時代にかけての戦国大名。桶狭間の戦いで今川を破る。
罪作	ツミツクり。
罪悪感	ツミを犯してワルかったという思い。
置換	オきカえ。
置物	オキモノ。
罰則	バッソク。
罰金	バッキン。
署名	サインをすること。
署長	警察ショ・消防ショなどのオサ。
羊毛	ヒツジのケ。
羊飼	ヒツジカい。
美人	ウツクしいヒト。
美人局	ツツモタセ。
美化運動	ウツクしくしようというウンドウ。
美味	おいしい。
美声	きれいなコエ。
美女	ウツクしいオンナ。
美容	顔や肌などをウツクしくトトノえること。
美容室	ビヨウシツ。
美容家電	ビヨウカデン。
美容師	ビヨウシ。
美容成分	ビヨウセイブン。
美容法	ビヨウホウ。
美容院	ビヨウイン。
美少女	ビショウジョ。
美徳	ビトク。
美点	優れているところ。ビテン。
美術	ビジュツ。
美術品	ビジュツヒン。
美術展	ビジュツテン。
美術館	ビジュツカン。
美観	ウツクしい眺め。「○○を損なう」
美談	ウツクしい話。感心するような話。
群集心理	グンシュウシンリ。
群馬県	草津温泉のあるケン。
義務	ギム。
義務化	ギムカ。
義務教育	ギムキョウイク。
義手	テの不自由な人が付ける、テの代わりのもの。
義援金	ギエンキン。
義母	ギ理のハハ。
義父	ギ理のチチ。
義理	本命でない人にあげるのは「○○チョコ」
義理人情	ギリニンジョウ。
義足	アシの不自由な人が付ける、アシの代わりのもの。
羽化	成虫になってハネがつくこと。
羽子板	ハゴイタ。
羽毛	ウモウ。
羽田空港	ハネダクウコウ。
羽織	ハオリ。
羽衣	ハゴロモ。
羽音	ハオト。
翌年	ヨクネン。
翌日	ヨクジツ。
翌月	ヨクゲツ。
翌朝	ヨクアサ。
翌週	ヨクシュウ。
習字	文ジの書き方をナラうこと。
習字教室	シュウジキョウシツ。
習得	経験を通してナラい覚えること。
習性	同種の動物に一般的にみられる行動の特性。
習慣	日常的に繰り返される行い。くせ。
老人	年をとったヒト。
老化	年をとっていくこと。
老化現象	ロウカゲンショウ。
老化防止	ロウカボウシ。
老夫婦	ロウフウフ。
老女	年をとったオンナ。
老後	年オいたアトのこと。
老後資金	ロウゴシキン。
老木	年オいたキのこと。
老母	ロウボ。
老眼	年オいたメのこと。
考古学	史料を元に過去を研究するガク問。
考察	物事を明らかにするため、よくカンガえをめぐらせること。
考案	カンガえ出すこと。
考案者	カンガえ出した人。
耐久力	タイキュウリョク。
耐久性	タイキュウセイ。
耐震化	タイシンカ。
耐震性	タイシンセイ。
耐震補強	タイシンホキョウ。
耕作	田畑をタガヤし，サク物をツクること。
耕作地	コウサクチ。
耕作放棄地	コウサクホウキチ。
耕地	田畑として利用している土チ。
耕地面積	コウチメンセキ。
耳寄	ミミヨり。
耳障	ミミザワり。
耳鼻科	ミミとハナのことならジビカに行きましょう。
聖人	セイなるヒト。
聖夜	クリスマスイブ。
聖書	バイブル。
聖母	セイなるマリア。
聖火	セイなるヒ。
聴覚	音波をカンじてキき取る能力。
聴覚障害者	チョウカクショウガイシャ。
職人	その仕事をする技能を持った者。
職務	ショクム。
職務経歴書	ショクムケイレキショ。
職務質問	ショクムシツモン。
職員	学校・官庁・会社などでショク務を担当する人。
職員室	学校の先生が集まってデスクワークをする部屋。
職場	仕事バ。
職場体験	ショクバタイケン。
職場復帰	ショクバフッキ。
職場恋愛	ショクバレンアイ。
職業	お仕事。ジョブ。
職業安定所	ハローワーク。ショクアン。
職業病	ショクギョウビョウ。
職業能力	ショクギョウノウリョク。
職業訓練	上手に働くためのクンレン。
職種	ショク務のシュ類。
肉体	ニクタイ。
肉体労働	ニクタイロウドウ。
肉体改造	ニクタイカイゾウ。
肉体美	ニクタイビ。
肉屋	ニクヤ。
肉眼	ニクガン。
肉筆	ニクヒツ。
肉親	ニクシン。
肉食	ニクをタべること。
肉食動物	ニクショクドウブツ。
肉食系男子	ニクショクケイダンシ。
肝心	キモとココロ。もっとも重要なこと。
肝臓	人体で一番大きいゾウ器。カンゾウ。
肥大	ヒダイ。
肥料	植物の栄養分として人間が施すもの。
肥満	メタボ。
肥満体	ヒマンタイ。
肥満度	ヒマンド。
育児	子どもをソダてること。
育児休業	イクジキュウギョウ。
育児休業制度	イクジキュウギョウセイド。
育児教室	イクジキョウシツ。
肺呼吸	ハイコキュウ。
肺活量	ハイカツリョウ。
肺炎	ハイにエン症が起きる病気。
胃液	イで分泌される消化エキ。
胃腸	イとチョウ。
胃腸薬	イチョウヤク。
胃薬	イグスリ。
胃酸	イで分泌されるサン。
胆石	肝臓がつくるタン汁の固まり。
背中	セナカ。
背信行為	ハイシンコウイ。
背広	セビロ。
背後	ウシろ側から。
背景	写真や絵画などで、主題となる対象以外のもの。
背比	セイクラべ。
背番号	セバンゴウ。
背筋力	ハイキンリョク。
背骨	セボネ。
胞子	コケやカビの増えるもと。ホウシ。
胸中	ムネのうち。
胸像	人間のムネより上の部分をかたどったゾウ。
胸元	ムナモト。
胸囲	ムネ回りの長さ。
胸板	ムナイタ。
胸焼	ムネヤけ。
胸部	体のムネのブ分。
能力	何かを行うチカラ。
能力主義	ノウリョクシュギ。
能天気	ノウテンキ。
能率	仕事のはかどり具合。ノウリツ。
脅威	オビヤかすこと。
脅迫	オドしてある行動をセマること。
脅迫罪	キョウハクザイ。
脚本	シナリオ。キャクホン。
脚本家	シナリオライター。
脱会	属しているカイを抜けること。
脱出	その場所から抜けダすこと。
脱原発	ダツゲンパツ。
脱原発派	ダツゲンパツハ。
脱水	体内のスイ分量が不足した状態。「○○症状」
脱皮	カワをヌぐこと。
脱税	不正に納ゼイを逃れること。
脱線	車輪が軌道からはずれること。「電車が○○する」
脱落	抜けオちること。ダツラク。
脱衣室	ダツイシツ。
脱衣所	服をヌぐ場ショ。
脱走	ハシってニげること。
脱退	属している団体・組織から抜けること。ダッタイ。
脳出血	ノウシュッケツ。
脳卒中	ノウソッチュウ。
脳天気	ノウテンキ。
脳死判定	ノウシハンテイ。
脳科学	ノウカガク。
脳裏	頭の中。心の中。ノウリ。
腕前	ウデマエ。
腕力	ワンリョク。
腕時計	ウデドケイ。
腹八分	ハラハチブ。
腹巻	ハラマき。
腹痛	フクツウ。
腹黒	ハラグロ。
臓器	体内にあるキ官。
臓器売買	ゾウキバイバイ。
臓器提供	ゾウキテイキョウ。
臓器移植	ゾウキイショク。
臨時	定めれたトキではなく、そのトキの事情に応じて行うこと。
臨時国会	リンジコッカイ。
臨機応変	その時その時に応じて、かしこく対処すること。
臨海学校	リンカイガッコウ。
臨終	リンジュウ。
自主再建	ジシュサイケン。
自主回収	ジシュカイシュウ。
自伝	その人ジ身によるデン記。
自供	ジ分の犯した事柄を自ら述べること。
自信	ジ分ジ身をシンじる心。
自信過剰	ジシンカジョウ。
自分	ジブン。その人ジ身。
自分勝手	ジブンカッテ。
自分自身	ジブンジシン。
自力	ジ分のチカラで。
自動	オート。
自動制御	ジドウセイギョ。
自動的	ジドウテキ。
自動販売機	ジドウハンバイキ。
自動車	カー。
自動車会社	ジドウシャガイシャ。
自動車保険	ジドウシャホケン。
自動車修理工場	ジドウシャシュウリコウジョウ。
自動車取得税	ジドウシャシュトクゼイ。
自動車整備士	ジドウシャセイビシ。
自動車株	ジドウシャカブ。
自動車業界	ジドウシャギョウカイ。
自動車産業	ジドウシャサンギョウ。
自動車部品	ジドウシャブヒン。
自動車重量税	ジドウシャジュウリョウゼイ。
自動運転	ジドウウンテン。
自営業者	ジエイギョウシャ。
自国	ジ分のクニ。
自宅	ジ分の家。
自家発電機	ジカハツデンキ。
自尊心	ジソンシン。
自己	「○○流」「○○中心的」「○○満足」
自己中心的	ジコチュウシンテキ。
自己主張	ジコシュチョウ。
自己流	ジコリュウ。
自己満足	ジコマンゾク。
自己破産	ジコハサン。
自己紹介	ジコショウカイ。
自己負担	ジコフタン。
自己負担額	ジコフタンガク。
自己資本	ジコシホン。
自己資本利益率	ジコシホンリエキリツ（ＲＯＥ）。
自意識過剰	ジイシキカジョウ。
自慢	ジマン。
自業自得	ジ分がした行動の結果が、ジ分にはね返ってくること。
自殺	その人ジ身をコロすこと。
自殺者	ジサツシャ。
自民党総裁	ジミントウソウサイ。
自治	ジ分やジ分たちに関することをミズカらの責任において処理すること。
自治体	ジチタイ。
自治政府	ジチセイフ。
自治権	ジチケン。
自然	人工では無い物。あるがままの状態。
自然体	シゼンタイ。
自然保護	シゼンホゴ。
自然公園	シゼンコウエン。
自然数	シゼンスウ。
自然災害	シゼンサイガイ。
自然現象	シゼンゲンショウ。
自然環境	シゼンカンキョウ。
自然界	シゼンカイ。
自然発火	シゼンハッカ。
自然科学	シゼンカガク。
自由	フリーダム。リバティ。
自由化	ジユウカ。
自由席	ジユウセキ。
自由民主党	ジユウミンシュトウ。
自由研究	ジユウケンキュウ。
自由自在	何でも自分の思い通りでできること。
自由貿易	ジユウボウエキ。
自画像	ジガゾウ。
自画自賛	自分の行動を自分でほめること。
自発的	ジハツテキ。
自白	ジ分の犯した罪などを包み隠さずに言うこと。
自立	ジ分一人の力だけで物事を行うこと。ひとりだち。独リツ。
自筆	ジヒツ。
自給自足	必要なものを、自分で作り出して間に合わせること。
自習	独力で学シュウすること。「○○時間」
自習室	ジシュウシツ。
自習時間	ジシュウジカン。
自衛	ジ分の力でミズカらをまもること。
自衛官	ジエイカン。
自衛隊	ジエイタイ。
自覚	ジ分ジ身と、ジ分の置かれている状態を知ること。
自覚症状	ジカクショウジョウ。
自負	ジ分の才能や仕事にジ信をもち、誇らしく思うこと。
自販機	ジハンキ。
自責	ジ分でジ分のあやまちをセめること。「○○の念」
自費	ジ分で支払うヒ用。私ヒ。
自費出版	ジヒシュッパン。
自身	ジ分。ミズカら。ジシン。
自転	物体がその内部の点または軸のまわりを回テンすること。
自転車	ジテンシャ。
自転車操業	ジテンシャソウギョウ。
自重	ミズカらをオモんじること。言動を慎むこと。
自閉症	ジヘイショウ。
自首	捜査機関に対し犯人ジ身の犯罪事実を申告し、訴追を求めること。
至急	非常にイソぐこと。大イソぎ。シキュウ。
至近距離	シキンキョリ。
至難	きわめてムズカしいさま。「○○の業」
致命傷	チメイショウ。
興味	キョウミ。
舌打	シタウち。
舞台	ステージ
舞台装置	ブタイソウチ。
舞台設定	ブタイセッテイ。
航海	船舶でウミを渡コウすること。
航海士	コウカイシ。
航海日誌	コウカイニッキ。
航海訓練所	コウカイクンレンジョ。
航空	航クウ機でソラをコウ行すること。
航空便	コウクウビン。
航空券	コウクウケン。
航空業界	コウクウギョウカイ。
航空機	コウクウキ。
航空自衛隊	コウクウジエイタイ。
航路	船舶やコウ空機が通行する一定の経ロ。
船便	フナビン。
船出	フナデ。
船底	フナゾコ。
船旅	フナタビ。
船長	セン舶の最高責任者・管理者。
良好	状態・調子などがヨいこと。「視界○○」
良心	正しく行動しようとするココロの働き。
良薬	効き目がヨいクスリ。
良識	物事の健全な考え方。リョウシキ。
色彩	シキサイ。
色白	イロジロ。
色眼鏡	サングラス。
色紙	イロガミ。シキシ。
色素	イロのモト。
花吹雪	ハナフブキ。
花園	ハナゾノ。
花形	ハナガタ。
花束	ハナタバ。
花火	ハナビ。
花火大会	ハナビタイカイ。
花畑	ハナバタケ。
花粉	カフン。
花見	ハナミ。
花言葉	ハナコトバ。
花輪	ハナワ。
芸人	ゲイニン。
芸名	ゲイ能活動をする上で本ミョウのほかに持つナ前。
芸能事務所	ゲイノウジムショ。
芸能人	ゲイノウジン。
芸能界	ゲイノウカイ。
芸術	アート。
芸術作品	ゲイジュツサクヒン。
芸術品	ゲイジュツヒン。
芸術家	アーティスト。
芽生	メバえ。
若人	ワコウド。
若干	はっきりしないが、それほど多くはない数量。
若年層	ジャクネンソウ。
若手	ワカテ。
若手俳優	ワカテハイユウ。
若者	ワカモノ。
若芽	ワカメ。
若菜	ワカナ。
若葉	ワカバ。
苦労	クロウ。
苦味	ニガミ。
苦境	クルしい立場やキョウ遇。
苦心	何かをなしとげるためにココロをくだきク労すること。
苦情	クレーム。
苦情処理	クジョウショリ。
苦戦	クルしいタタカい。
苦手	ニガテ。
苦痛	クルしさとイタみ。
苦笑	ニガワラい。クショウ。
苦虫	ニガムシ。
苦言	本人のためにあえてイうコト葉。「○○を呈する」
英会話	エイカイワ。
英単語	エイタンゴ。
英和辞書	エイワジテン。
英国	イギリス。
英才教育	エイサイキョウイク。
英文	エイ語のブン。
英断	すぐれた決ダン。「○○を下す」
英訳	エイ語に翻ヤクすること。
英語	イングリッシュ。
英語教育	エイゴキョウイク。
英語検定	エイゴケンテイ。
茨城県	納豆の発祥地のケン。
茶会	ティーパーティ。
茶化	相手を困らせるようなことを言って面白がること。
茶柱	チャバシラ。
茶畑	チャバタケ。
茶色	チャイロ。
茶道	おチャの礼儀作法。サドウ。
茶間	チャのマ。
草原	ノハラ。
草木	クサキ。
草案	規約、法律などの下書き、原アン。
草笛	クサブエ。
草花	クサバナ。
草野球	クサヤキュウ。
草食	動物が植物をタべ物とすること。
草食動物	ソウショクドウブツ。
草食系	ソウショクケイ。
草食系男子	ソウショクケイダンシ。
荷札	ニフダ。
荷物	ニモツ。
荷車	ニグルマ。
荷造	ニヅクり。
菌類	キノコ・カビ・酵母などの仲間。
菜園	野サイを植える畑。野サイ畑。「家庭○○」
菜種	ナタネ。
菜種油	ナタネアブラ。
落下	シタにオちること。
落下物	ラッカブツ。
落城	シロが攻めオとされること。
落書	ラクガき。
落札額	ラクサツガク。
落目	オちメ。
落第	ラクダイ。
落第点	ラクダイテン。
落葉	ハっぱがオちること。
落葉樹	ラクヨウジュ。
落語	必ず最後にオチがつく話芸。
落選	セン挙にオちること。
落雷	カミナリがオちること。
落馬	ウマからオちること。
葉巻	ハマキ。
葉桜	ハザクラ。
葉緑素	植物の光合成に欠かせないミドリ色の色ソ。
葉脈	ハにみられる、細かいすじ。
著作	チョサク。
著作権	チョサクケン。
著作権侵害	チョサクケンシンガイ。
著作権法	チョサクケンホウ。
著名	世間にナ前がよく知られていること。チョメイ。
著書	カきあらわしたショ物。チョショ。
著者	その書物を書きあらわした人。筆シャ。
蒸器	ムしキ。
蒸気	スチーム。
蒸気機関	ジョウキキカン。
蒸気機関車	ジョウキキカンシャ。
蒸気船	ジョウキセン。
蒸留	液体をジョウ発させ、再び液化することで、成分を分離・濃縮させること。
蒸留水	ジョウリュウスイ。
蒸留酒	ジョウリュウシュ。
蒸発	液体の表面から気化が起こる現象。
蔵書	ショ物を所ゾウしていること。
薬剤師	ヤクザイシ。
薬効	クスリのキき目。
薬味	ヤクミ。
薬品	ヤクヒン。
薬局	ヤッキョク。
薬指	クスリユビ。
薬物汚染	ヤクブツオセン。
薬草	ヤクソウ。
虫息	ムシのイキ。
虫歯	ムシバ。
虫眼鏡	ムシメガネ。
蚕糸	カイコのまゆから取ったイト。生イト。
血圧	ケツアツ。
血圧計	ケツアツケイ。
血気	チのケ。
血液	ケツエキ。
血液型	ケツエキガタ。
血液検査	ケツエキケンサ。
血潮	チシオ。
血相	ケッソウ。
血眼	チマナコ。
血祭	チマツり。
血筋	チスジ。
血管	ケツ液が通るクダ。
血糖値	ケットウチ。
血統書	ケットウショ。
血縁関係	ケツエンカンケイ。
血肉	チとニク。ケツニク。
血行	チの流れ。
血行促進	ケッコウソクシン。
衆参両院	シュウサンリョウイン。
衆知	ほとんどの人がシっていること。「○○の事実」
衆議院	シュウギイン。
衆議院解散	シュウギインカイサン。
衆院議員	シュウインギイン。
衆院選	シュウインセン。
行事	一定の日を決めてオコナう儀式や催し。
行使	武力・権利などを実際に用いること。 「武力○○」
行列	ギョウレツ。
行動	実際に体をウゴかして、何かをオコナうこと。
行動計画	コウドウケイカク。
行司	相撲で、力士を立ち合わせ、勝負を判定する役。
行商	客のいそうな地域を商品を運搬しながら販売すること。
行政	国の機関や地方公共団体がオコナうセイ務。
行政処分	ギョウセイショブン。
行政指導	ギョウセイシドウ。
行政改革	ギョウセイカイカク。
行政書士	ギョウセイショシ。
行政書士試験	ギョウセイショシシケン。
行政機関	ギョウセイキカン。
行方	ユクエ。
行方不明	ユクエフメイ。
行方不明者	ユクエフメイシャ。
行来	ユきキ。
行楽地	コウラクチ。
行為	ある意思をもってするオコナい。コウイ。
行進	マーチング。
行進曲	コウシンキョク。
行間	ギョウとギョウのアイダ。
街灯	マチのトモシ火。
街角	マチカド。
街頭	市ガイ地の道路や広場。「○○演説」
街頭演説	ガイトウエンゼツ。
衛星	大きな天体のまわりを軌道運動している天体。
衛星放送	エイセイホウソウ。
衛星電話	エイセイデンワ。
衛生	清潔にして健康を保ち、病気にかからないようにすること。 
衛生管理	エイセイカンリ。
衣料品販売	イリョウヒンハンバイ。
衣服	身体にまとうもの。イフク。
衣装	着物。イ服。イショウ。
衣類	イルイ。
衣食住	イショクジュウ。
表向	オモテムき。
表彰台	ヒョウショウダイ。
表彰式	ヒョウショウシキ。
表彰状	ヒョウショウジョウ。
表情	顔や身振りにアラワれた感ジョウ。
表敬訪問	ヒョウケイホウモン。
表札	居住者の名を記して入り口などに掲げるフダ。
表現	ヒョウ情・身振り・記号・言語など。
表現力	ヒョウゲンリョク。
表示	アラワしシメすこと。
表示価格	ヒョウジカカク。
表紙	オモテのカミ。
表裏	オモテとウラ。「○○一体」
表記	アラワしシルすこと。
表門	オモテモン。
表面	物の外側をなす面。
表面化	ヒョウメンカ。
表面張力	ヒョウメンチョウリョク。
衰弱	体などがオトロえてヨワくなること。
衰弱死	スイジャクシ。
衰退	オトロえて勢いを失うこと。
被告	訴えを起こされた側の当事者。
被告人	ヒコクニン。
被害	損ガイ・危ガイを受けること。
被害届	ヒガイトドケ。
被害総額	ヒガイソウガク。
被害者	ヒガイシャ。
被害額	ヒガイガク。
被災地	ヒサイチ。
被災状況	ヒサイジョウキョウ。
被災者支援	ヒサイシャシエン。
被爆体験	ヒバクタイケン。
裁判	事件・争訟について第三者機関が法に基づいて判断し、解決する作用。
裁判員制度	サイバンインセイド。
裁判官	サイバンカン。
裁判所	サイバンショ。
裁判長	サイバンチョウ。
装備	武器や機器、用具などを身につけること。
装置	ある一定の機能を持った設備や機械。デバイス。
裏側	ウラガワ。
裏切	ウラギり。
裏千家	ウラセンケ。
裏口	ウラグチ。
裏口入学	ウラグチニュウガク。
裏声	ウラゴエ。
裏打	ウラウち。
裏目	ウラメ。
裏腹	ウラハラ。
裏表	ウラオモテ。
裏話	ウラバナシ。
裏面	ウラメン。
補佐	人を助けて、その務めを果たさせること。
補充	足りないものを補うこと。ホジュウ。
補助	足りないものをオギナいタスけること。
補助輪	ホジョリン。
補助金	ホジョキン。
補導	非行を防ぐために、青少年を正しい方向へミチビくこと。
補強	オギナってツヨくすること。
補強材	ホキョウザイ。
補欠	ホ充のために待機させておく人。
補正予算	ホセイヨサン。
補正予算案	ホセイヨサンアン。
補給	足りなくなった分をオギナうこと。「栄養○○」
補習	学力をオギナうために授業をすること。
補聴器	ホチョウキ。
補足	不十分な点をオギナうこと。「説明を○○する」
製作	道具や機械などを使って品物をツクること。
製品	工業において原材料を加工した後の完成ヒン。プロダクト。
製品開発	セイヒンカイハツ。
製図	器具を用いてズ面をセイ作すること。
製本	印刷物に表紙などをつけてホンの形につくり上げること。
製氷	コオリを作ること。
製氷機	セイヒョウキ。
製法	物をつくる方ホウ。セイ造の方ホウ。
製紙	カミをセイ造すること。
製綱	ハガネをセイ造すること
製薬業界	セイヤクギョウカイ。
製造	原材料に手を加えてセイ品にすること。
製造元	セイゾウモト。
製造年月日	セイゾウネンガッピ。
製造所固有記号	セイゾウショコユウキゴウ。
製造技術	セイゾウギジュツ。
製造業	セイゾウギョウ。
製造物責任法	セイゾウブツセキニンホウ。
製造番号	セイゾウバンゴウ。
製造者	セイゾウシャ。
製造販売	セイゾウハンバイ。
製造販売元	セイゾウハンバイモト。
製造過程	セイゾウカテイ。
製鉄	テツを作ること。
製鉄所	セイテツジョ。
複写	紙媒体を別の紙にウツし取ること。コピー。
複合映画施設	フクゴウエイガシセツ。
複合機	フクゴウキ。
複数	二つ以上のカズ。
複数形	フクスウケイ。
複眼	多数の小さな個ガンが束状に集まった目。
複製	もとの物と同じ物を別に作ること。
複雑	フクザツ。
西日	ニシビ。
西日本	ニシニホン。
西洋	ヨーロッパ及びアメリカ。セイヨウ。
西洋人	セイヨウジン。
西洋料理	セイヨウリョウリ。
西遊記	サイユウキ。
西部	ある地域のニシの方のブ分。
西郷隆盛	サイゴウタカモリ。
要人	重ヨウな地位にあるヒト。
要介護者	ヨウカイゴシャ。
要因	物事が生じた、主ヨウな原イン。ファクター。
要望	物事の実現を強くノゾむこと。
要望書	ヨウボウショ。
要求	必要または当然なこととして相手に強くモトめること。
要注意	ヨウチュウイ。
要点	重ヨウなポイント。
要約	文章や話のヨウ点を短くまとめること。
要素	物事を成り立たせているもの。ヨウソ。
要領	物事をうまく処理する方法・手段。「○○が悪い」
見事	すばらしいさま。ミるべきところがあるさま。
見学	実際にミてガク習すること。
見学会	ケンガクカイ。
見学料	ケンガクリョウ。
見張	ミハり。
見所	ミドコロ。
見方	物をミるホウ法。
見本	サンプル。
見栄	ミエ。「○○を張る」
見物	ミモノ。
見物人	ケンブツニン。
見納	ミオサめ。
見習	ミナラい。
見聞	実際にミたりキいたりすること。「東方○○録」
見覚	ミオボえ。
見解	物事に対するミ方・考え方。「○○の相違」
見識	物事の本質を深くミ通し、判断する力。
見返	ミカエり。「○○り美人」
見送	出かける人をオクること。オクる人。
見通	ミトオし。
規制	規則によって物事をセイ限すること。「○○緩和」
規制強化	キセイキョウカ。
規制改革	キセイカイカク。
規制緩和	キセイカンワ。
規則	物事の秩序。ルール。
規則性	キソクセイ。
規定	法令の条文としてサダめること。キテイ。
規律	集団の秩序を維持する決まり。
規模	構え・仕組みの大きさ。スケール。
規約	人々の協議によって決めたキ則。
視力	物を見るチカラ。
視力障害	シリョクショウガイ。
視察	実情を知るために実地を見ること。
視点	物事を見たり考えたりする立場。観テン。
視界	目に見える範囲。シカイ。
視界良好	シカイリョウコウ。
視神経	シシンケイ。
視線	目の中心と見ている対象とを結ぶセン。
視聴率	シチョウリツ。
視覚障害者	シカクショウガイシャ。
視野	目に見える範囲。シヤ。
親不孝	オヤフコウ。
親分	オヤブン。
親切	思いやりをもって人のためにつくすこと。
親友	シタしいトモ達。
親子	オヤとコ。
親子丼	オヤコドン。
親子関係	オヤコカンケイ。
親孝行	オヤコウコウ。
親密	シタしく交際していること。
親心	オヤゴコロ。
親愛	人にアイ情やシタしみの感情をいだいていること。
親指	オヤユビ。
親方	オヤカタ。
親日家	シンニチカ。
親潮	オヤシオ。
親父	オヤジ。
親身	肉シンのように心づかいをするさま。「○○になって」
親近感	シンキンカン。
親馬鹿	オヤバカ。
観光	他国・他郷を訪れ、景色などを見て歩くこと。 
観光協会	カンキョウキョウカイ。
観光地	カンコウチ。
観光客	カンコウキャク。
観光旅行	カンコウリョコウ。
観光業界	カンコウギョウカイ。
観光産業	カンキョウサンギョウ。
観光資源	カンコウシゲン。
観客	興行などを見る人、見物人のこと。
観客席	カンキャクセキ。
観察	物事の状態や変化を客観的に注意深く見ること。
観察力	カンサツリョク。
観戦	試合などを見物すること。
観測	カン察しソク定すること。
観測所	カンソクジョ。
観点	物事を考察・判断するときの立場。カンテン。
観衆	大勢のカン客・見物人。カンシュウ。
観賞	美しいものを見て味わい心を楽しませること。 
角度	カクの大きさ。
角材	カクザイ。
角柱	多カッ形を底面とするハシラ。カクチュウ。
角笛	ツノブエ。
解体	まとまっているものを、分カイすること。
解体作業	カイタイサギョウ。
解体工事	カイタイコウジ。
解体新書	カイタイシンショ。
解凍	凍結状態を戻すこと。
解放	束縛や制限を取り除いて自由にすること。
解放感	カイホウカン。
解散	会合・団体などが活動をやめて人々が別れチること。
解散総選挙	カイサンソウセンキョ。
解明	わからない事柄をアキらかにすること。
解決	物事や問題を片付けること。
解決済	カイケツズみ。
解決策	カイケツサク。
解消	それまであった関係・状態などをなくすること。
解消法	カイショウホウ。
解熱剤	ゲネツザイ。
解禁	法律などでキン止していたことをトくこと。
解答	問題をトいてコタえを出すこと。
解約	契ヤクを取り消すこと。
解説	物事をわかりやすいように説明すること。
解説者	カイセツシャ。
解釈	表現をトきほぐして意味を明らかにすること。
触感	物にフれた時のカンじ。
触角	頭部から突出し、感覚を司る器官。
言動	コト葉と行ドウ。
言葉	音声または文字による表現のまとまり。
言行一致	ゲンコウイッチ。
言行不一致	ゲンコウフイッチ。
言訳	イいワケ。
言語	コト葉の種類。日本ゴとか英ゴとか。
言語学者	ゲンゴガクシャ。
言語道断	コト葉ではイい表せないほど、まちがったこと。
言論	コト葉によって意見や思想を公表すること。ゲンロン。
言論統制	ゲンロントウセイ。
計器	ケイ量キ械。
計画	プラン。プロジェクト。
計算	数式に従って処理した結果の数値を引き出すこと。
計算機	コンピューター。
計量	重リョウ・分リョウなどをハカること。
討論	ある問題について、互いに意見を述べ合うこと。
討議	ある事について、互いに意見を交わし論じ合うこと。
訓練	トレーニング。
訓読	クンヨみ。
記事	新聞・雑誌などで伝えるコト柄と文章。
記入	書きイれること。
記号	キゴウ。
記念	思い出となるように残しておくこと。
記念写真	キネンシャシン。
記念切手	キネンキッテ。
記念品	キネンヒン。
記念日	キネンビ。
記念病院	キネンビョウイン。
記念硬貨	キネンコウカ。
記念行事	キネンギョウジ。
記憶	頭の中で覚えておくこと。メモリー。
記憶力	キオクリョク。
記者	取材したり、キ事を書いたり、編集したりする人。
記者会見	キシャカイケン。
記載	書類・書物などに書いてシルすこと。キサイ。
記述	文を書きシルすこと。
記述問題	キジュツモンダイ。
記述式	キジュツシキ。
記録	後世に残すために物事を書きシルすこと。レコード。
記録保持者	キロクホジシャ。
記録媒体	キロクバイタイ。
記録的	キロクテキ。
記録的大雨	キロクテキオオアメ。
訪問	他人の家などをオトズれること。
訪問介護	ホウモンカイゴ。
訪問看護	ホウモンカンゴ。
訪問者	ホウモンシャ。
設備	必要な建物・装置などをソナえ付けたもの。セツビ。
設備投資	セツビトウシ。
設定	ある物事や条件を作りサダめること。「舞台○○」
設立	学校・会社などの機関や組織を新しく作ること。
設置	新たな部署や部門や機械などをオくこと。
設置費用	セッチヒヨウ。
設計	デザイン。
設計図	セッケイズ。
許可	禁止されている行為を特定の場合または人に限ってユルすこと。
許可証	キョカショウ。
許容	ある程度までをユルして受け入れること。 
許容範囲	キョヨウハンイ。
訳者	翻ヤクした人。翻ヤクシャ。
診察室	シンサツシツ。
診断書	シンダンショ。
証人	ある事実をショウ明するヒト。
証券会社	ショウケンガイシャ。
証拠品	ショウコヒン。
証明	ある事柄が事実であることをアキらかにすること。
証明写真	ショウメイシャシン。
証言	事柄が事実であることをコト葉によってショウ明すること。
評価	物事の善悪などを考え、カ値を定めること。 
評判	世間でのうわさ。
評論	物事の善悪・価値などについて批ヒョウし、ロンじること。
評論家	ヒョウロンカ。
試作品	シサクヒン。
試作機	シサクキ。
試合	スポーツ・武術などの技を比べ合い勝敗を競うこと。
試合時間	シアイジカン。
試合終了	シアイシュウリョウ。
試合開始	シアイカイシ。
試練	信仰心や実力などを厳しくタメすこと、またはその苦難。
試運転	シウンテン。
試食	タメしにタべてみること。
試食会	シショクカイ。
試食販売	シショクハンバイ。
試験	テスト。
試験官	シケン場の監督をする人。
試験導入	シケンドウニュウ。
試験管	シケンカン。円筒形。
試験紙	シケンシ。
詩人	シを書き、それを発表するヒト。
詩歌	和カ・俳句・シなど韻文の総称。
詩集	シをアツめた書物。
話題	ワダイ。
認印	ミトメイン。
認可	ニンカ。
認定	資格・事実の有無などを調べて決めること。
認知度	ニンチド。
認知機能	ニンチキノウ。
認知症	ニンチショウ。
認識	ある物事を知り、その本質などを理解すること。
認識不足	ニンシキブソク。
誕生日	タンジョウビ。
語句	文章を組み立てているゴとク。
語学	ゴガク。
語学留学	ゴガクリュウガク。
語手	カタりテ。
語源	単語の一番初めの音形と意味。
誠実	偽りがなく、まじめなこと。
誠意	うそ偽りのない心。
誤報	間違えて知らせること。
誤字	間違ったジ。
誤字脱字	ゴジダツジ。
誤差	真の値と測定値または近似値とのサ。
誤算	計算間違い。見込み違い。
誤解	間違った理カイやカイ釈。
誤訳	間違った翻ヤク。
誤認	アヤマったニン識を持つこと。
説得	よく話して、相手に納トクさせること。
説得力	セットクリョク。
説教	オシえ導くために言い聞かせること。「親に○○される」
説明	トきアかして教えること。
説明不足	セツメイブソク。
説明会	セツメイカイ。
説明文	セツメイブン。
説明責任	セツメイセキニン。
読書	本をヨむこと。
読書感想文	ドクショカンソウブン。
読本	やさしく書かれた入門書や解説書。ドクホン。
読点	「、」
読物	ヨみモノ。
読破	ドクハ。
読者	本などをヨんでいる人。
読解力	ドッカイリョク。
課外授業	カガイジュギョウ。
課外活動	カガイカツドウ。
課程	教育や訓練で秩序立って学ぶ一連の流れ。
課税	ゼイ金をカすこと。
課税対象	カゼイタイショウ。
課長	部署あるいは一部門としての課の責任者。
課題	与えられたダイ。解決しなければならない問ダイ。
調合	薬品を混ぜ合わせること。
調味料	チョウミリョウ。
調和	物事の間に釣り合いがとれていること。
調子	音・気分・体チョウなどの状態。「○○に乗る」「○○が悪い」
調教	人間・動物に対して行われる訓練。
調教師	チョウキョウシ。
調整	調子の悪いものに手を加えてトトノえること。
調整中	チョウセイチュウ。
調査	事を明らかにするためにシラべること。
調査中	チョウサチュウ。
調査内容	チョウサナイヨウ。
調査委員会	チョウサイインカイ。
調査目的	チョウサモクテキ。
調査結果	チョウサケッカ。
調理	食べ物を食べやすくおいしく料リすること。
調理台	チョウリダイ。
調理器具	チョウリキグ。
調理場	チョウリバ。
調理家電	チョウリカデン。
調理師	チョウリシ。
調節	チョウセツ。
調達	求めに応じて金品を送り届けること。
談合	ダンゴウ。
談話	ダンワ。
請求書	セイキュウショ。
論争	怒ってロンじ合うこと。言葉のアラソい。
論外	議ロンの範囲ガイのこと。ロンずる価値のないこと。
論文	あるテーマについてロン理的に書き記したブン章。
論文発表	ロンブンハッピョウ。
論理	議ロンや思考を進める道筋。 ロジック。
諸君	ショクン。
諸国	多くのクニ。いろいろなクニ。
諸島	多くのシマ。いろいろなシマ。
諸説	いろいろなセツ。
講師	コウ演・コウ義をする人。
講座	コウ義の行われる場。
講演	聴衆の前で、あるテーマについて話をすること。
講演会	コウエンカイ。
講演料	コウエンリョウ。
講義	人々に学説・物事などの意味や内容を口頭で説明すること。
講習	人を集めて一定期間、学問・技芸などを教え指導すること。
講習会	コウシュウカイ。
謝礼	感謝・おレイの気持ちを表す金品。
謝礼金	シャレイキン。
謝罪	ツミや過ちをわびること。
謝罪文	シャザイブン。
識別	物事の相違を見分けること。
識字率	シキジリツ。
識者	物事に対して正しい判断をくだす力のある人。
警備	セキュリティ。
警備会社	ケイビガイシャ。
警備員	ケイビイン。
警備強化	ケイビキョウカ。
警告	起こりえる悪い状況について、前もって注意を与えておくこと。
警報	都合の悪いことが起きたことや起きそうなことを広く知らせること。
警報音	ケイホウオン。
警官	ケイ察カン。
警察	ポリス。
警察学校	ケイサツガッコウ。
警察官	ケイサツカン。
警察犬	ケイサツケン。
警察署	ケイサツショ。
警察署長	ケイサツショチョウ。
警察関係者	ケイサツカンケイシャ。
警戒区域	ケイカイクイキ。
警戒情報	ケイカイジョウホウ。
警視庁	ケイシチョウ。
警護	人・物などをケイ戒して守ること。
議事堂	ギジドウ。
議会	ギカイ。
議会政治	ギカイセイジ。
議員	ギ会の構成イン。
議員定数削減	ギインテイスウサクゲン。
議員年金	ギインネンキン。
議員立法	ギインリッポウ。
議案	会ギで審ギ・決定するための原アン。
議論	ギロン。
議長	会ギの最高責任者。
議院内閣制	ギインナイカクセイ。
議題	会ギで行うギ論のダイ材。
護岸工事	ゴガンコウジ。
護衛艦	ゴエイカン。
護身術	ゴシンジュツ。
豆知識	マメチシキ。
豆電球	マメデンキュウ。
豊作	サク物がたくさん収穫されること。
豊富	ユタかであること。ふんだんにあること。
豊年	ホウ作のトシ。
豊胸手術	ホウキョウシュジュツ。
豊臣秀吉	安土桃山時代の戦国大名。天下統一を成し遂げる。
象形文字	ショウケイモジ。
貝柱	カイバシラ。
負債総額	フサイソウガク。
負債額	フサイガク。
負傷	キズをオうこと。
負傷者	フショウシャ。
負担	背オったり、肩に担いだりすること。
負担割合	フタンワリアイ。
負担増	フタンゾウ。
負担軽減	フタンケイゲン。
負数	マイナスのカズ。
負荷	電力などを消費するもの。ニ物の重さ。
財力	ザイリョク。
財務体質	ザイムタイシツ。
財務省	ザイムショウ。
財宝	ザイホウ。
財布	おサイフ。
財政	国や公共団体の経済活動。
財政事情	ザイセイジジョウ。
財政健全化	ザイセイケンゼンカ。
財政健全化目標	ザイセイケンゼンカモクヒョウ。
財政再建	ザイセイサイケン。
財政収支	ザイセイシュウシ。
財政投融資	ザイセイトウユウシ。
財政支出	ザイセイシシュツ。
財政支援	ザイセイシエン。
財政赤字	ザイセイアカジ。
財政難	ザイセイナン。
財源	ザイゲン。
財産	ザイサン。
財界	ザイカイ。
貧困	ヒンコン。
貧困家庭	ヒンコンカテイ。
貧富	マズしいこととトんでいること。
貧弱	ヒンジャク。
貧血	ヒンケツ。
貨物	カモツ。
貨車	カ物列シャ。
販促	ハン売ソク進。
販売	商品をウりに出すこと。
販売価格	ハンバイカカク。
販売促進	ハンバイソクシン。
販売元	ハンバイモト。
販売好調	ハンバイコウチョウ。
販売実績	ハンバイジッセキ。
販売広告	ハンバイコウコク。
販売手法	ハンバイシュホウ。
販売計画	ハンバイケイカク。
販路拡大	ハンロカクダイ。
貫通	中をツラヌいて反対側に抜けること。
責任	セキニン。
責任感	セキニンカン。
責任者	セキニンシャ。
責務	セキ任と義ム。果たさなければならないツトめ。
貯水	ミズをタめること。
貯蔵	タクワえ、しまっておくこと。
貯金	おカネをタめること。
貯金箱	チョキンバコ。
貴族	社会の支配階級。キゾク。
貴重	非常に価値のあるさま。「○○な本」
貴重品	キチョウヒン。
貴金属	キキンゾク。
買値	カいネ。
買収	バイシュウ。
買収金額	バイシュウキンガク。
貸付	カしツけ。
貸付金	カシツケキン。
貸借	カすこととカりること。カしカり。
貸借対照表	タイシャクタイショウヒョウ。
貸出	カシダシ。
貸出図書	カシダシトショ。
貸出金利	カシダシキンリ。
貸切温泉	カシキリオンセン。
貸切風呂	カシキリブロ。
貸家	カしイエ。
貸本	カシホン。
費用	ヒヨウ。
費用対効果	ヒヨウタイコウカ。
貿易	二国間の商品の売買行為。
貿易収支	ボウエキシュウシ。
貿易立国	ボウエキリッコク。
貿易統計	ボウエキトウケイ。
貿易赤字	ボウエキアカジ。
貿易風	ボウエキフウ。
貿易黒字	ボウエキクロジ。
賀正	正月を祝うこと。
賃上	チンアげ。
賃貸	カしチンをとって物をカすこと。
賃金	チンギン。
賃金上昇	チンギンジョウショウ。
賃金体系	チンギンタイケイ。
賃金格差	チンギンカクサ。
資料	調査や研究の参考にするデータや文献。
資料作成	シリョウサクセイ。
資本	シホン。
資本主義	シホンシュギ。
資本家	シホンカ。
資本論	シホンロン。
資本金	シホンキン。
資材	ある物を作るもととなるザイ料。シザイ。
資格	あることをする場合の、人の立場や地位。
資格試験	シカクシケン。
資源	産業のもととなる有用物。リソース。
資源調査	シゲンチョウサ。
資源開発	シゲンカイハツ。
資産家	シサンカ。
資産運用	シサンウンヨウ。
資金	用意され使われるキン銭。
資金不足	シキンブソク。
資金洗浄	マネーロンダリング。
資金源	シキンゲン。
資金調達	シキンチョウタツ。
賛同	人の意見・提案などに、サン成・ドウ意すること。
賛否両論	サンピリョウロン。
賛成	提案や意見に同意すること。
賛成多数	サンセイタスウ。
賛成意見	サンセイイケン。
賛成派	サンセイハ。
賛成者	サンセイシャ。
賞味期限	ショウミキゲン。
賞品	成績の良かった者に与えられる品物。
賞状	表彰ジョウ・認定証・感謝ジョウなど。
賞賛	ほめたたえること。ショウサン。
賞金	ショウとして与えるキン銭。
質問	疑モン点やわからない点をトいタダすこと。 
質問状	シツモンジョウ。
質問箱	シツモンバコ。
質屋	シチヤ。
質疑応答	シツギオウトウ。
質素	シッソ。
質素倹約	シッソケンヤク。
質量	物体がもともと持っている重さのリョウ。
購入	買いイれること。
購入額	コウニュウガク。
購読	書籍や新聞・雑誌などを買ってヨむこと。
購読者	コウドクシャ。
購買力	コウバイリョク。
赤信号	アカいシンゴウ。
赤十字	白地にアカいジュウジを書いた記章。「○○○社」
赤外線	熱作用が強く、目に見えない光セン。
赤子	アカゴ。
赤字	支出が収入より多いこと。不足額。
赤字決算	アカジケッサン。
赤字解消	アカジカイショウ。
赤字路線	アカジロセン。
赤富士	フジ山がアカく見える現象。
赤提灯	アカチョウチン。
赤潮	海や湖などがアカく変色する現象。
赤組	アカのクミ。
赤色	アカいイロ。
赤血球	ヘモグロビンを含むケツ液中のたんぱく質。酸素を運ぶ。
赤道	日射量が最も多い場所をたどる線。地図ではアカ線で表される。
赤面	アカらガオ。
赤飯	セキハン。
走者	ランナー。
走行	自動車などがハシること。
走行距離	ソウコウキョリ。
起死回生	だめになりそうだったものが、よい状態にもどること。
起源	物事のオこり。始まり。ミナモト。
起立	「○○！　礼！　着席！」
超党派	各政党の政策・主張を超えて協力し合うこと。
超難問	チョウナンモン。
超高層	非常にタカい建築物。「○○○ビル」
足元	アシモト。
足場	アシバ。
足算	タしザン。
足跡	アシアト。
足音	アシオト。
足首	アシクビ。
距離	キョリ。
距離感	キョリカン。
路上	道ロのウエ。
路上駐車	ロジョウチュウシャ。
路線価	ロセンカ。
路面凍結	ロメントウケツ。
路頭	「妻子が○○に迷う」
身代金	ミノシロキン。
身体	カラダ。
身体検査	シンタイケンサ。
身体能力	シンタイノウリョク。
身体障害	シンタイショウガイ。
身元	ミモト。
身元不明	ミモトフメイ。
身元保証人	ミモトホショウニン。
身元保証書	ミモトホショウショ。
身元調査	ミモトチョウサ。
身内	ミウチ。
身分	ミブン。
身分証明書	ミブンショウメイショ。
身動	ミウゴき。
身支度	ミジタク。
身柄確保	ミガラカクホ。
身軽	ミガル。
身辺整理	シンペンセイリ。
身辺調査	シンペンチョウサ。
身近	ミジカ。
身長	シン体のナガさ。
車両	貨客を輸送するためのクルマ。シャリョウ。
車両保険	シャリョウホケン。
車両消毒	シャリョウショウドク。
車体	クルマのボディー。
車庫	自動シャをとめておく倉コ。
車社会	クルマで成り立つシャカイ。
車窓	クルマのマド。
車輪	シャリン。
車道	クルマの通るミチ。シャドウ。
軍事	グン隊・グン備・戦争に関するコト。
軍事作戦	グンジサクセン。
軍事力	グジリョク。
軍事境界線	グンジキョウカイセン。
軍事大国	グンジ力の強いタイコク。
軍事専門家	グンジセンモンカ。
軍事政権	グンジセイケン。
軍事演習	グンジエンシュウ。
軍事行動	グンジコウドウ。
軍事衛星	グンジに使う人工エイセイ。
軍事衝突	グンジショウトツ。
軍事訓練	グンジクンレン。
軍事費	グンジに使うヒ用。
軍人	戦争に従事するヒト。兵士。
軍国主義	グンコクシュギ。
軍手	白の太い木綿糸で編んだ手袋。作業用。
軍拡競争	グンカクキョウソウ。
軍施設	グンシセツ。
軍服	グン人用のフク。
軍縮	グン備シュク小の略。
軍艦	グンカン。
軍隊	グン人の集団。
転倒	すべってコロぶこと。
転勤	キン務先が変わること。
転居	住キョを変えること。
転居届	テンキョトドケ。
転換	気持ち、方針、方向などを異なるものに変えること。
転校	通学する学コウが変わること。
転校生	テンコウしたセイ徒。
転落	コロんでオちること。
転落死	テンラクシ。
転身	ミ分・職業などをすっかり変えること。
転送	情報やデータを他へオクり出すこと。
軽乗用車	ケイジョウヨウシャ。
軽傷	カルいキズ。
軽口	カルクチ。
軽工業	ケイコウギョウ。
軽快	カロやかで気分がいいこと。
軽業	カルワザ。
軽油	ディーゼル燃料。
軽減	カルくしてヘらすこと。
軽犯罪	ケイハンザイ。
軽率	よく考えずに物事を行うさま。カルはずみ。
軽症	カルいショウ状。
軽石	カルイシ。
軽自動車	ケイジドウシャ。
軽自動車税	ケイジドウシャゼイ。
軽視	重要ではないと考えること。
軽量	重リョウや程度のカルいこと。
軽量化	ケイリョウカ。
軽金属	ケイキンゾク。
軽音楽	ケイオンガク。
輪唱	同じ旋律・歌詞を追ショウする形で行われる声楽の一種。
輸入	外国から商品を購入すること。
輸入価格	ユニュウカカク。
輸入品	ユニュウヒン。
輸入小麦	ユニュウコムギ。
輸入業者	ユニュウギョウシャ。
輸出	自国の商品を他国へ売ること。
輸出産業	ユシュツサンギョウ。
輸血	他の人のケツ液を患者に注入すること。
輸送	乗り物で人や物を運ぶこと。
輸送能力	ユソウノウリョク。
辛口	カラクチ。
辛子明太子	カラシメンタイコ。
辞任	職務を自分からヤめること。
辞典	言葉を集め、その意味などを解説した書籍。ジテン。
辞書	言葉を集め、その意味などを解説した書籍。ジショ。
辞職	自分から会社をヤめること。
辞職願	ジショクネガイ。
辞表	役職のある人がヤめるときに提出する書類。
辞退	権利などを放棄すること。
農作物	ノウサクブツ。
農作物被害	ノウサクブツヒガイ。
農具	ノウグ。
農協	ノウ業キョウ同組合。ＪＡ。
農協改革	ノウキョウカイカク。
農園	野菜・草花・果樹などを栽培するノウ場。
農場	ノウジョウ。
農家	ノウカ。
農村	ノウソン。
農林水産省	ノウリンスイサンショウ。
農業	土地を利用した作物の栽培や、家畜の飼育。
農業体験	ノウギョウタイケン。
農業協同組合	ノウギョウキョウドウクミアイ。
農業団体	ノウギョウダンタイ。
農民	ノウミン。
農産物	ノウサクブツ。
農耕	田畑をタガヤしてノウ作物を作ること。
農耕民族	ノウコウミンゾク。
農薬	ノウヤク。
農薬混入	ノウヤクコンニュウ。
近代化	キンダイカ。
近似値	キンジチ。
近大	キ畿ダイ学。
近年	キンネン。
近所	キンジョ。
近所迷惑	キンジョメイワク。
近日	キンジツ。
近海	陸地にチカいウミ。
近眼	近くが見えて、遠くが見えない状態。キンガン。
近視	近くが見えて、遠くが見えない状態。キンシ。
近辺	キンペン。
近道	チカミチ。
返上	カエすこと。ヘンジョウ。
返事	呼びかけに対して答える言葉。ヘンジ。
返信	受け取った通シンについてヘン事を出すこと。
返品	シナ物をカエすこと。
返済	借りた金や物をカエすこと。
返答	問いや呼びかけなどに対してコタえる言葉。
返送	オクりカエすこと。
返金保証	ヘンキンホショウ。
迫力	ハクリョク。
迫害	ハクガイ。
述語	主ゴを除く、その動作や状態などを述べる部分。
迷信	社会に実害を及ぼし、道徳に反するような知識やシン仰。
迷子	マイゴ。
迷宮	メイキュウ。
迷惑	人のしたことで不快になったり困るさま。
迷惑行為	メイワクコウイ。
迷惑防止条例	メイワクボウシジョウレイ。
迷惑電話	メイワクデンワ。
迷路	複雑に入り組んだ道。
追加	付けクワえること。
追手	オっテ。
追放	ツイホウ。
追求	オいモトめること。
追突	後ろからぶつかること。
追突事故	ツイトツジコ。
追試	ツイシ験。
追試験	ツイシケン。
追跡	逃げる者のアトをオうこと。
追風	オいカゼ。
退化	進カの逆。
退去	ある場所から立ちのくこと。
退去届	タイキョトドケ。
退場	そのバ所・会ジョウなどからシリゾくこと。
退学	タイガク。
退学届	タイダクトドケ
退屈	タイクツ。
退治	悪いものをうち滅ぼすこと。「ネズミを○○する」
退社	勤務時間が終わって会シャから出ること。
退職	ショクをシリゾき、労働契約を解除すること。
退職届	タイショクトドケ。
退職金	タイショクキン。
退職願	タイショクネガイ。
退院	入イン患者の病状が回復して病インから出ること。
送付	オクり届けること。ソウフ。
送信	情報やデータなどを通シンでオクること。
送別	ワカれて行く人をオクること。
送別会	ソウベツカイ。
送料	品物をオクるのに必要なリョウ金。
送料無料	ソウリョウムリョウ。
送球	ボールをオクること。
送迎会	ソウゲイカイ。
送金	キン銭をオクること。
送風	カゼをオクること。
逃亡	ニげて身を隠すこと。
逃亡者	トウボウシャ。
逃走	ニげ去ること。
逃走経路	トウソウケイロ。
逆上	サカアがり。
逆効果	ギャクコウカ。
逆境	物事がうまくゆかず、苦労の多いキョウ遇。
逆手	サカテ。
逆立	サカダち。
逆行	進むべき方向と反対の方へ進むこと。
逆転	事のなりゆきや関係が今までとはギャクになること。
透明	スけて見えること。
透明度	トウメイド。
透明性	トウメイセイ。
透明性確保	トウメイセイカクホ。
途中	トチュウ。
途中出場	トチュウシュツジョウ。
通信	送り手が情報を送り、受け手が情報を受けること。
通信会社	ツウシンガイシャ。
通信制大学	ツウシンセイダイガク。
通信教育	ツウシンキョウイク。
通信業界	ツウシンギョウカイ。
通信販売	ツウシンハンバイ。
通信費	ツウシンヒ。
通信速度	ツウシンソクド。
通分	共通のブン母を持つブン数にすること。
通勤	家とキン務先を往復する行為。
通勤中	ツウキンチュウ。
通勤客	ツウキンキャク。
通勤手当	ツウキンテアテ。
通勤時間	ツウキンジカン。
通報	警察などに告げ知らせること。
通学	ガッ校にカヨうこと。
通帳	金額・数量などを記載するチョウ面。「預金○○」
通常	特別の事情がなく、いつもどおりであること。普ツウ。
通常国会	ツウジョウコッカイ。
通気性	ツウキセイ。
通用	広く世間に認められること。「世間に○○しない」
通称	世間一般にツウ用している名前。
通行	人や車が道をトオること。
通行人	ツウコウニン。
通訳	バイリンガルが言葉を別の言語に変換すること。
通話機能	ツウワキノウ。
通貨	国家などによって価値を保証された、決済のためのカ幣。
通貨危機	ツウカキキ。
通販	ツウハン。
通路	人や物の移動のために空けてある場所。ツウロ。
通過	トオりスぎること。
速報	事故の発生などを素早くホウ道すること。
速度	方向を持ったハヤさ。
速度制限	ソクドセイゲン。
速達	普通よりもハヤく届けること。
速達郵便	ソクタツユウビン。
造船	フネをツクること。
造花	人工的にツクられたハナ。
連中	仲間である者たち。レンチュウ。
連休	レン続したヤスみの日。
連勝	レン続したショウ利。
連合	日本労働組合総レンゴウ会の略。
連合国	レンゴウコク。
連合国軍総司令部	レンゴウコクグンソウシレイブ。ＧＨＱ。
連合軍	レンゴウグン。
連帯	二人以上の者が共同で責任を負うこと。
連帯保証	レンタイホショウ。
連帯保証人	レンタイホショウニン。
連帯感	レンタイカン。
連帯責任	レンタイセキニン。
連想	ある事柄からそれと関連のある事柄を思い浮かべること。
連携強化	レンケイキョウカ。
連敗	レン続したハイ北。
連日	何ニチもレン続で続くこと。
連発	何度も続けてハッ射すること。物事が続いて起きること。
連盟	共同の目的のためにメイ約を結ぶこと。「国際○○」
連立政権	レンリツセイケン。
連結	ひと続きになるようにつなぎ合わせること。
連結子会社	レンケツコガイシャ。
連結決算	レンケツケッサン。
連絡先	レンラクサキ。
連続	つながってツヅくこと。切れ目がないこと。
連続再生	レンゾクサイセイ。
連続放火事件	レンゾクホウカジケン。
連載小説	レンサイショウセツ。
週休	一シュウ間のうちのヤスみの日。
週刊	雑誌・新聞などを一シュウ間ごとに発行すること。
週刊誌	シュウカンシ。
週末	シュウの終わりごろ。
週間	日曜日から土曜日までの七日間。
進出	新しい方面や分野にススみデて、活動を広げること。
進化	生物の形質が世代を経る中で変カしていく現象。
進学	上級のガッ校へススむこと。
進学校	シンガクコウ。
進展	事態がシン行しテン開すること。
進歩	物事がより良い方や望ましい方へススんでいくこと。
進級	等キュウ・学年が上にススむこと。
進行	前へススむこと。物事がはかどること。
進行中	シンコウチュウ。
進路	ススんで行くミチ。
進路変更	シンロヘンコウ。
進退	このまま仕事を続けるかやめるか。
進退問題	シンタイモンダイ。
遊園地	ユウエンチ。
遊牧	移動しながらボク畜を行うこと。
遊牧民	ユウボクミン。
遊牧民族	ユウボクミンゾク。
遊覧船	ユウランセン。
運休	「ウン行キュウ止」の略。
運動	物がウゴくこと。体をウゴかすこと。
運動不足	ウンドウブソク。
運動会	ウンドウカイ。
運動場	ウンドウジョウ。
運動方針	ウンドウホウシン。
運動時間	ウンドウジカン。
運動神経	ウンドウシンケイ。
運動選手	ウンドウセンシュ。
運動部	ウンドウブ。
運勢	幸・不幸の巡ってくる具合。ウン命のイキオい。
運命	天によって決められた人間の定め。
運命共同体	ウンメイキョウドウタイ。
運営	組織などを動かし、うまく機能するようにすること。
運営会社	ウンエイガイシャ。
運河	船が通るために作られた人工的な水路。「スエズ○○」「パナマ○○」
運賃	交通機関に支払う金銭。
運転	ドライビング。
運転免許	ウンテンメンキョ。
運転免許証	ウンテンメンキョショウ。
運転手	ウンテンシュ。
運輸	ウンユ。
運送	品物をハコんでオクること。
運送会社	ウンソウガイシャ。
運送業	ウンソウギョウ。
過保護	カホゴ。
過信	価値・力量などを実際以上に高く評価して頼ること。
過剰	必要な程度や数量を越えて多いこと。
過剰防衛	カジョウボウエイ。
過労	体や頭脳を使いスぎて疲ロウすること。
過労死	カロウシ。
過半数	カハンスウ。
過去	すでに過ぎ去った時間の流れのこと。
過去最低	カコサイテイ。
過去最悪	カコサイアク。
過去最高	カコサイコウ。
過大評価	カダイヒョウカ。
過失	誤りやシッ敗のこと。カシツ。
過密	入れ込みすぎていて、ゆとりがないこと。「○○スケジュール」
過小評価	カショウヒョウカ。
過度	適切な程ドを超えていること。
過激	考え方ややり方が世間の常識からひどくかけ離れていること。
過激思想	カゲキシソウ。
過激派	カゲキハ。
過熱	必要以上にまた限界以上にアツくなること。
過程	物事が変化していく一連の流れ。プロセス。
道具	ドウグ。ツール。
道化師	ドウケシ。
道場	武芸の修練を行う場所。
道州制	ドウシュウセイ。
道徳	善悪・正邪を判断し、正しく行動するための規範。
道徳教育	ドウトクキョウイク。
道案内	ミチアンナイ。
道楽	趣味を楽しむこと。
道理	物事の正しいすじみち。「無リが通れば○○引っ込む」
道草	ミチクサ。
道路	人や車両の交通のために設けられた地上のミチ。
道路交通法	ドウロコウツウホウ。
道路整備	ドウロセイビ。
道路標識	ドウロヒョウシキ。
道順	ミチジュン。
達人	タツジン。
達成	成し遂げること。目的を果たすこと。
達成感	タッセイカン。
達筆	文字を上手に書くさま。勢いのあるフデづかい。
達者	タッシャ。
違反	法規・協定・約束などに従わないこと。
違反駐車	イハンチュウシャ。
違和感	イワカン。
違憲	ケン法に反すること。
違憲状態	イケンジョウタイ。
違法	ホウに反すること。
違法行為	イホウコウイ。
遠回	トオマワし。
遠征	試合・登山などでトオくへ出かけていくこと。
遠征先	エンセイサキ。
遠心力	エンシンリョク。
遠方	トオくのホウ。
遠洋漁業	エンヨウギョギョウ。
遠目	トオメ。
遠視	近い・トオいに関係なく、目の焦点があっていない状態。
遠赤外線	エンセキガイセン。
遠足	エンソク。
遠距離恋愛	エンキョリレンアイ。
遠近法	エンキンホウ。
遠隔操作	リモートコントロール。
遠隔操作事件	エンカクソウサジケン。
遣唐使	ケントウシ。
適任	その仕事やニン務に合っていること。
適切	ふさわしいこと。ぴったりと当てはまること。「○○に対処する」
適合	条件・状況などに当てはまること。「条件に○○する」
適度	程度がちょうどよいさま。
適当	テキ切かつ妥トウ。いい加減。
適応	生物が環境に合わせて変化すること。
適材適所	その人の能力にあった役目につけること。
適格	必要な資カクを満たしていること。
適正	テキ当でタダしいこと。
適正体重	テイセイタイジュウ。
適温	ほどよいオン度。ちょうどよいオン度。
適量	ほどよいリョウ。ちょうどよいリョウ。
選出	エラびダすこと。
選別	複数の物をより分けること。
選別機	センベツキ。
選手	競技者としてスポーツを行っている人。
選手会	センシュカイ。
選手団	センシュダン。
選手権	センシュケン。
選択	複数の中から良いもの、目的にかなうものなどをエラぶこと。
選択式	センタクシキ。
選択科目	センタクカモク
選挙	投票により代表者や役員などをセン出すること。
選挙制度	センキョセイド。
選挙制度改革	センキョセイドカイカク。
選挙区	センキョク。
選挙対策	センキョタイサク。
選挙対策委員会	センキョタイサクイインカイ。
選挙戦	センキョセン。
選挙期間	センキョキカン。
選挙権	センキョケン。
選挙無効	センキョムコウ。
選挙管理委員会	センキョカンリイインカイ。
選挙結果	センキョケッカ。
選挙違反	センキョイハン。
選考理由	センコウリユウ。
遺伝	生殖によって親から子へと形質がツタわる現象。
遺伝子	イデンシ。
遺伝子工学	イデンシコウガク。
遺伝子検査	イデンシケンサ。
遺伝子治療	イデンシチリョウ。
遺伝子解析	イデンシカイセキ。
遺体	死んだ人のカラダ。イタイ。
遺品	イヒン。
遺品整理	イヒンセイリ。
遺族	故人と死に別れ、残された家ゾクや親ゾク。
遺族年金	イゾクネンキン。
遺書	自殺する人が残す文章。イショ。
遺産	故人の残した財サン的な権利や義務。
遺産相続	イサンソウゾク。
遺産相続税	イサンソウゾクゼイ。
遺言	ユイゴン。
遺言書	ユイゴンショ。
遺言状	ユイゴンジョウ。
遺跡	過去の人間の活動のアトが確認できる場所。
遺骨	イコツ。
避難場所	ヒナンバショ。
避難指示	ヒナンシジ。
避難生活	ヒナンセイカツ。
避難経路	ヒナンケイロ。
避難訓練	ヒナンクンレン。
部下	手下。ブカ。
部分	パート。
部品	パーツ。
部品交換	ブヒンコウカン。
部品調達	ブヒンチョウタツ。
部員	ブに所属する構成イン。
部屋	ヘヤ。
部長	ブチョウ。
部隊	軍隊の一組織。ブタイ。
部首	「へん」や「つくり」といった、漢字を構成する要素。
郵便	〒
郵便切手	ユウビンキッテ。
郵便局	ユウビンキョク。
郵便局員	ユウビンキョクイン。
郵便振替	ユウビンフリカエ。
郵便料金	ユウビンリョウキン。
郵便物	ユウビンブツ。
郵便番号	ユウビンバンゴウ。
郵政民営化	ユウセイミンエイカ。
郵政選挙	ユウセイセンキョ。
郵送	ユウ便でオクること。
郷土料理	キョウドリョウリ。
都会	田舎の対義語。
都内	東京トの中。
都合	ツゴウ。
都営	東京トによる経エイ。
都市	人口が多く、商業・交通が発達している地区。
都市伝説	トシデンセツ。
都市計画法	トシケイカクホウ。
都庁	東京トの事務を行う役所。
都心	ト市の中シン部。
都民	東京トの人。
都知事	トチジ。
都立	東京トが設リツ・経営していること。
都道府県	トドウフケン。
配偶者	ハイグウシャ。
配分	割り当ててクバること。ワけ前。
配合飼料	ハイゴウシリョウ。
配布	ゆきわたるようにクバること。
配布資料	ハイフシリョウ。
配給	品物などを割り当ててクバること。
配線	回路や回線を構成するセンをつなぐこと。
配線工事	ハイセンコウジ。
配置	レイアウト。
配置図	ハイチズ。
配置転換	ハイチテンカン。
配色	イロのとり合わせ。
配達	相手に品物が届くこと。
配達先	ハイタツサキ。
配達記録	ハイタツキロク。
酒場	サケを飲む店。サカバ。
酒屋	サカヤ。
酒気	酒のにおい。「○○帯び運転はやめましょう」
酸味	スっぱいアジ。
酸味料	サンミリョウ。
酸性	アルカリセイの反対。
酸性雨	サンセイウ。
酸素	呼吸のために必要な気体。元素記号Ｏ。
酸素系漂白剤	サンソケイヒョウハクザイ。
釈放	シャクホウ。
釈明	誤解や非難に対して説メイし、理解を求めること。
里親	サトオヤ。
重体	命にかかわるほどのオモい病気、負傷のこと。
重傷	命には別状は無いが、後に障害が残りそうな怪我。
重力	ジュウリョク。
重力加速度	ジュウリョクカソクド。
重労働	ジュウロウドウ。
重圧	オモいアツ力。
重大	きわめてジュウ要な事態であるさま。大ゴトであるさま。
重大事件	ジュウダイジケン。
重大事故	ジュウダイジコ。
重宝	たいせつなタカラ物。便利に使うこと。
重工業	ジュウコウギョウ。
重役	責任のオモいヤク目・地位。
重心	オモさの中シン。
重油	ジュウユ。
重油流出事故	ジュウユリュウシュツジコ。
重病	オモいビョウ気。
重病人	ジュウビョウニン。
重症	ショウ状がオモいこと。
重税	負担のオモいゼイ金。
重箱	ジュウバコ。
重罪	オモいツミ。
重荷	オモニ。
重複	チョウフク。
重要	非常に大事で大切なこと。
重要事項	ジュウヨウジコウ。
重要人物	ジュウヨウジンブツ。
重要参考人	ジュウヨウサンコウニン。
重要市場	ジュウヨウシジョウ。
重要性	ジュウヨウセイ。
重要文化財	ジュウヨウブンカザイ。
重要視	ジュウヨウシ。
重要課題	ジュウヨウカダイ。
重視	オモく見ること。大切だと考えること。
重責	オモいセキ任。
重量	物体に働く地球のジュウ力の大きさ。
重量税	ジュウリョウゼイ。
重金属	ジュウキンゾク。
野党	与トウではないトウ。
野党再編	ヤトウサイヘン。
野原	ノハラ。
野営	キャンプ。
野外	ノ原。郊ガイ。ヤガイ。
野宿	ヤ外に寝て夜を明かすこと。
野心	ヤシン。
野放	ノバナし。
野望	ヤボウ。
野次馬	ヤジウマ。
野球	ベースボール。
野球場	ヤキュウジョウ。
野球用品	ヤキュウヨウヒン。
野球部	ヤキュウブ。
野生動物	ヤセイドウブツ。
野良犬	ノライヌ。
野菜	ベジタブル。
野菜工場	ヤサイコウジョウ。
野菜栽培	ヤサイサイバイ。
野鳥	ヤ生のトリ。
野鳥観察	ヤチョウカンサツ。
量産	「大リョウ生サン」の略。
量産化	リョウサンカ。
量的緩和	リョウテキカンワ。
金具	カナグ。
金利	資キンの使用料もしくは賃借料のおカネ。
金利計算	キンリケイサン。
金品	キンピン。
金属	メタル。
金属探知機	キンゾクタンチキ。
金属片	キンゾクヘン。
金属音	キンゾクオン。
金庫	金品を入れ、鍵をかけて保管しておくための箱。
金星	太陽系で太陽に近い方から二番目の惑セイ。
金曜	フライデー。
金曜日	フライデー。
金棒	キン属のボウ。「鬼に○○」
金正恩	キムジョンウン。
金正恩体制	キムジョンウンタイセイ。
金物	カナモノ。
金目	カネメ。
金管楽器	キンカンガッキ。
金粉	キンプン。
金網	カナアミ。
金色	キンイロ。コンジキ。
金融	おキンの流れ。おキンの貸借。
金融危機	キンユウキキ。
金融商品	キンユウショウヒン。
金融市場	キンユウシジョウ。
金融庁	キンユウチョウ。
金融政策	キニュウセイサク。
金融機関	キンユウキカン。
金融緩和	キンユウカンワ。
金融街	キンユウガイ。
金貨	ゴールドメダル。
金賞	展覧会・品評会などで、第一位の入ショウ。
金賞受賞	キンショウジュショウ。
金銭	おカネ。貨幣。ゼニ。
金銭感覚	キンセンカンカク。
金閣寺	キンカクジ。
金額	キンガク。
金髪	キンパツ。
金魚	キンギョ。
針小棒大	ささいなことをオオげさに言うこと。
針山	ハリヤマ。
針葉樹	シンヨウジュ。
針葉樹林	シンヨウジュリン。
針金	ハリガネ。
鉄分	テツブン。
鉄分不足	テツブンブソク。
鉄則	テッソク。
鉄板	テツのイタ。
鉄柱	テツのハシラ。
鉄棒	テツのボウ。
鉄橋	テツのハシ。
鉄筋	コンクリートを補強するため、中に入れる鋼材。
鉄道	テツドウ。
鉄道事業	テツドウジギョウ。
鉄鉱石	テッコウセキ。
鉛直方向	エンチョクホウコウ。
鉛筆	エンピツ。
鉱山	金・銀・銅などの自然資源を採掘するヤマ。
鉱石	イシのように固まった自然資源。
銀世界	ギンセカイ。
銀山	ギンを採掘するヤマ。
銀座	日本を代表する繁華街。東京都中央区南西部。
銀河	無数の星の大きな集まり。
銀河系	ギンガケイ。
銀紙	ギンガミ。
銀色	ギンイロ。シルバー。
銀行	預金を集め、融資をする金融機関。バンク。
銀行振込	ギンコウフリコミ。
銀行株	ギンコウカブ。
銀貨	シルバーコイン。
銅像	ドウゾウ。
銅山	ドウを採掘するヤマ。
銅板	ドウでできたイタ。
銅線	ドウでできたセン。
銭湯	料金をとって客を入浴させる浴場。公衆浴場。風呂屋。
鋭利	刃がスルドく、切れ味のよいさま。
鋭角	九十度よりとがったカク度。
録画	映像・動ガを記ロクすること。
録画機能	ロクガキノウ。
録音	オン声を記ロクすること。
録音機	ボイスレコーダー。
録音機能	ロクオンキノウ。
鎌倉幕府	源頼朝がカマクラに開いたバクフ。
鎌倉時代	1192年～1333年の約140年間。
鏡台	カガミとそれを支えるダイから成る家具。
鑑定	美術品・骨董品などの良し悪しの評価を行うこと。
鑑定人	カンテイニン。
鑑定書	カンテイショ。
鑑賞	芸術作品のよさを味わい楽しみ理解すること。
長女	最初のオンナの子。
長寿命	チョウジュミョウ。
長居	ナガい間、同じ所にイること。
長崎県	九州西端部に位置するケン。原爆が投下された。
長年	ナガいネン月。ナガネン。
長所	すぐれているトコロ。メリット。
長方形	内角がすべて直角の四角ケイ。
長時間	チョウジカン。
長時間使用	チョウジカンシヨウ。
長時間労働	チョウジカンロウドウ。
長期	ナガいキ間。
長期保存	チョウキホゾン。
長期化	チョウキカ。
長期国債	チョウキコクサイ。
長期政権	チョウキセイケン。
長期金利	チョウキキンリ。
長男	最初のオトコの子。
長続	ナガツヅき。
長老	年老いた人を敬っていう語。チョウロウ。
長者	金持ち。チョウジャ。
長者番付	チョウジャバンヅケ。
長調	陽気、活発さといった感情を受ける音楽のチョウ子。
長距離	チョウキョリ。
長身	シン長がナガいさま。
長野県	本州内陸部にあるケンで、冬季オリンピックの開催地。
長針	時計のナガいハリ。
長音	ナガいオト。
門出	旅立ち。カドデ。
閉会	ヘイカイ。
閉口	クチをトじること。
閉店	ミセをトじること。
閉経	月経がなくなること。
閉館	ヤカタをシめること。
開会	カイをヒラくこと。
開会式	カイカイシキ。
開化	「文明○○」
開口部	クチがヒラいているブ分。
開国	外コクとの交流を行うこと。
開始	スタート。
開始時間	カイシジカン。
開封	手紙などのフウをヒラくこと。
開幕	マクがヒラくこと。
開店	ミセをヒラくこと。
開放	アけたままにしておくこと。自由に出入りさせること。
開放感	カイホウカン。
開業	商売や事ギョウを始めること。
開港	ミナトをヒラくこと。
開発	人間の生活に役立つものを作り出すこと。
開発期間	カイハツキカン。
開発途上国	カイハツトジョウコク。
開票	投ヒョウの結果を調べること。 
開票時間	カイヒョウジカン。
開花	草木のハナがヒラくこと。
開通	道路・鉄道などがツウじること。
開閉	ヒラくこととトじること。
開館	ヤカタをヒラくこと。
開館時間	カイカンジカン。
間一髪	カンイッパツ。
間取	マドり。
間近	マヂカ。
間隔	物と物とのアイダ。時間のヘダたり。
間食	朝食・昼食・夕食以外の補助的なショク事。
関係	二つ以上の物事が互いにカカわり合うこと。
関係代名詞	カンケイダイメイシ。
関係修復	カンケイシュウフク。
関係悪化	カンケイアッカ。
関係改善	カンケイカイゼン。
関係機関	カンケイキカン。
関係者	カンケイシャ。
関心	ある物事に特に心を引かれ、注意を向けること。
関東	トウ京を中心に首都圏と呼ばれる地域。
関東地方	カントウチホウ。
関東大震災	カントウダイシンサイ。
関税	輸入貨物に対して課されるゼイ金。
関節	骨と骨が連結する部分。
関西	京阪神地方。カンサイ。
関西人	カンサイジン。
関西弁	カンサイベン。
関連会社	カンレンガイシャ。
関連商品	カンレンショウヒン。
閣下	「デーモン○○」
閣議	 内カクが意思決定するための会ギ。
閣議決定	カクギケッテイ。
阪神	野球のタイガーズといえば…
阪神大震災	ハンシンダイシンサイ。
防止	フセぎトめること。
防水	ミズをフセぐこと。
防火	ヒをフセぐこと。
防災	サイ害をフセぐこと。
防災情報	ボウサイジョウホウ。
防災教育	ボウサイキョウイク。
防災訓練	ボウサイクンレン。
防犯	ハン罪をフセぐこと。
防衛	外国による攻撃に対して国の安全を保持する作用。
防衛協力指針	ボウエイキョウリョクシシン。
防衛大臣	ボウエイダイジン。
防衛省	ボウエイショウ。
防護服	ボウゴフク。
防音	オトをフセぐこと。
降下	高い所からオりること。「ヘリから○○する」
降参	戦いや争いに負け、相手に従うこと。コウサン。
降水量	コウスイリョウ。
降雪	ユキがフること。
限定	物事の範囲や数量をカギること。
限定公開	ゲンテイコウカイ。
限定商品	ゲンテイショウヒン。
限定販売	ゲンテイハンバイ。
限度	ゲンド。
限界	それ以上の値を超えられないこと。
限界集落	ゲンカイシュウリャク。
陛下	皇帝・天皇・国王等の敬称。ヘイカ。
院長	インの最高責任者。
陣地	戦いのために軍隊・火器などを配備してある場所。
除去	ジョキョ。
除名	メイ簿などから、そのナ前を取りノゾくこと。
除外	ジョガイ。
除夜	大みそかの夜には「○○の鐘」を鳴らす。
除染	ある場所の放射能の影響を少なくすること。
除染作業	ジョセンサギョウ。
除草剤	ジョソウザイ。
除雪	ユキを取りノゾくこと。
除雪車	ジョセツシャ。
陰性	反応がなかったこと。「HIV検査の結果が○○だった」
陰性反応	インセイハンノウ。
陰極	マイナスの電キョク。
陸上	リクのウエ。
陸上競技	リクジョウキョウギ。
陸上競技場	リクジョウキョウギジョウ。
陸上自衛隊	リクジョウジエイタイ。
陸地	チ球の表面で、水におおわれていない部分。
陸橋	道路や鉄道線路などの上にかけたハシ。リッキョウ。
陸海空軍	リクカイクウグン。
陸路	リクロ。
陸軍	リクグン。
険悪	ケンアク。
陽性	反応があったこと。「HIV検査の結果が○○だった」
陽性反応	ヨウセイハンノウ。
陽極	プラスの電キョク。
陽気	にぎやかで明るいさま。
隊長	軍タイで、タイの指揮をとる人。
階層	上下にソウをなした重なり。
階段	高さの違う場所をつなぐ、ダンダンのある通路。
階級	身分・地位などの上下の段カイ。
障子	木枠に紙を張った扉や窓。
障子紙	ショウジガミ。
障害	体や心の機能が妨げられて低下すること。
障害年金	ショウガイネンキン。
障害物	ショウガイブツ。
障害物競走	ショウガイブツキョウソウ。
障害者	ショウガイシャ。
障害者年金	ショウガイシャネンキン。
障害者手帳	ショウガイシャテチョウ。
集中	一か所にアツめること。「精神を○○する」
集中力	シュウチュウリョク。
集会	ある目的のために多くの人が一定の場所に集まること。
集合	一ヶ所にアツまること。
集合場所	シュウゴウバショ。
集合時間	シュウゴウジカン。
集団	組織化された複数の人々の集合。
集団感染	シュウダンカンセン。
集団生活	シュウダンセイカツ。
集団的自衛権	シュウダンテキジエイケン。
集団面接	シュウダンメンセツ。
集大成	シュウタイセイ。
集積回路	シュウセキカイロ。ＩＣ。
集荷	各地の物をアツめること。シュウカ。
集計	データをアツめてケイ算すること。
集金	代キンなどをアツめること。
集金代行	シュウキンダイコウ。
集金日	シュウキンビ。
集金袋	シュウキンブクロ。
雇用促進	コヨウソクシン。
雇用創出	コヨウソウシュツ。
雇用問題	コヨウモンダイ。
雇用契約	コヨウケイヤク。
雇用拡大	コヨウカクダイ。
雇用状況	コヨウジョウキョウ。
雇用環境	コヨウカンキョウ。
雑学	ザツガク。
雑木林	ゾウキバヤシ。
雑煮	ゾウニ。
雑用	ザツヨウ。
雑種	ザッシュ。
雑草	ザッソウ。
雑誌	ザッシ。
雑誌広告	ザッシコウコク。
雑談	ザツダン。
雑貨	ザッカ。
雑貨屋	ザッカヤ。
雑音	ザツオン。
雑魚	ザコ。
離党届	リトウトドケ。
離婚届	リコントドケ。
離婚歴	リコンレキ。
離島防衛	リトウボウエイ。
離着陸	リリクとチャクリク。
離陸	航空機などがリク地をハナれて空中に飛び上がること。
難問	ムズカしいモン題。
難攻不落	ナンコウフラク。
難易度	ナンイド。
難民	ナンミン。
難民支援	ナンミンシエン。
難病	治療がムズカしいビョウ気。
難破船	ナンパセン。
難色	賛成できないというような態度。
難解	ムズカしくてカイ釈に苦しむこと。
難関	たやすくは通過できないセキ所。
難関大学	ナンカンダイガク。
難題	ムズカしい問ダイ。
雨具	アマグ。
雨垂	アマダれ。
雨天	ウテン。
雨天中止	ウテンチュウシ。
雨天決行	ウテンケッコウ。
雨季	アメがよく降るキ節。
雨宿	アマヤドり。
雨戸	アマド。
雨支度	アマジタク。
雨模様	アマモヨウ。
雨水	アマミズ。
雨足	アマアシ。
雨量	アメのリョウ。ウリョウ。
雨量計	ウリョウケイ。
雨降	アメフり。
雨雲	アマグモ。
雪合戦	ユキガッセン。
雪国	ユキグニ。
雪女	ユキオンナ。
雪崩	ナダレ。
雪景色	ユキゲシキ。
雪解	ユキドけ。
雪道	ユキミチ。
雲海	ウンカイ。
雲行	クモユき。
雷雨	ライウ。
雷鳴	ライメイ。
電光石火	ほんの短い時間やすばやい行動のたとえ。
電力	デン流が単位時間にする仕事量。
電力会社	デンリョクガイシャ。
電力供給	デンリョクキョウキュウ。
電力改革	デンリョクカイカク。
電力系統	デンリョクケイトウ。
電力自由化	デンリョクジユウカ。
電力輸出	デンリョクユシュツ。
電力量	デン気のエネルギー。
電力需要	デンリョクジュヨウ。
電化製品	デンカセイヒン。
電卓	デンタク。
電圧	デン気を流そうとするアツ力。
電圧計	デンアツケイ。
電子商取引	デンシショウトリヒキ。
電子政府	デンシセイフ。
電子計算機	デンシケイサンキ。
電子部品	デンシブヒン。
電柱	デンチュウ。古くはデン信バシラと言っていた。
電極	デン気的に接続する部分。
電気	デン化製品を作動させるのに必要なもの。
電気信号	デンキシンゴウ。
電気回路	デンキカイロ。
電気抵抗	デンキテイコウ。
電気料金	デンキリョウキン。
電気自動車	デンキジドウシャ。
電池	電気エネルギーを蓄えるもの。バッテリー。
電池交換	デンチコウカン。
電波	デン気のナミ。
電流	デン気のナガれ。
電源	デンゲン。
電灯	デン気を利用した照明装置。
電球	デン気で光る丸い物。
電磁波	デンジハ。
電磁石	デンジシャク。
電線	デン気が流れるセン。
電脳空間	デンノウクウカン。
電解液	デンカイエキ。
電話	デンワ。
電話世論調査	デンワヨロンチョウサ。
電話予約	デンワヨヤク。
電話会談	デンワカイダン。
電話取材	デンワシュザイ。
電話機	デンワキ。
電話番号	デンワバンゴウ。
電話線	デンワセン。
電話連絡	デンワレンラク。
電車	トレイン。
需要	「欲しい」「買いたい」という求め。
震度	地シンの強さ。
震源地	シンゲンチ。
震災	2011.3.11は「東日本大○○」。
震災関連死	シンサイカンレンシ。
露天風呂	ヨテンブロ。
青二才	アオニサイ。
青写真	アオジャシン。
青天井	アオテンジョウ。
青天白日	疑いが完全に晴れること。
青少年	セイショウネン。
青年期	セイネンキ。
青年海外協力隊	セイネンカイガイキョウリョクタイ。
青春	セイシュン。
青果物市況	セイカブツシキョウ。
青森県	日本の本州最北端に位置するケン。リンゴの産地。
青空	アオゾラ。
青空駐車場	アオゾラチュウシャジョウ。
青色	アオイロ。
青葉	アオバ。
青酸化合物	セイサンカゴウブツ。
青銅器	セイドウキ。
静岡県	富士山と伊豆半島を含むケン。
静止	動かず、じっとしていること。
静止画	セイシガ。
静止画像	セイシガゾウ。
静止衛星	セイシエイセイ。
静脈	心臓へ血液を送り込む血管。
静電気	下敷きと頭髪をこすると、ひっぱられます。
静養	仕事を離れて心身を休めること。
非公式	ヒコウシキ。
非売品	ヒバイヒン。
非常	ふだんと異なった状態。
非常時	ヒジョウジ。
非常用	ヒジョウヨウ。
非常識	ヒジョウシキ。
非常階段	ヒジョウカイダン。
非常食	ヒジョウショク。
非政府組織	ヒセイフソシキ（ＮＧＯ）。
非正規労働者	ヒセイキロウドウシャ。
非正規社員	ヒセイキシャイン。
非正規雇用	ヒセイキコヨウ。
非行	青少年の、社会にそむくコウ為。
非課税	ヒカゼイ。
非難	欠点や過失などを取り上げて責めること。
面会	病院などで人に会うこと。
面会時間	メンカイジカン。
面会謝絶	メンカイシャゼツ。
面影	オモカゲ。
面接	求人採用に際して実際に会って話をすること。
面接官	メンセツカン。
面目	メンボク。
面積	一定の面の広さ。
面談	メン会して直接話をすること。
面識	顔見知りであること。「○○がない」
革命	統治体制が急激かつ根底的に変カクされること。
革新	古くからの習慣・制度などをアタラしく変えようとすること。
韓国	朝鮮半島南部に位置するクニ。
韓国人	カンコクジン。
韓国政府	カンコクセイフ。
韓国語	カンコクゴ。
音信不通	ウンセイフツウ。
音域	オトの高さの範囲。
音声	オトとコエ。
音声案内	オンセイアンナイ。
音声認識	オンセイニンシキ。
音感	オトに対するカン覚。
音楽	ミュージック。
音楽会	オンガクカイ。
音楽家	ミュージシャン。
音楽教室	オンガクキョウイク。
音波	オトのナミ。
音程	二つ以上の音の高さの差。
音色	ネイロ。
音質	オトの品シツ。
音速	オトのハヤさ。
音量	オトのリョウ。
音量調節	オンリョウチョウセイ。
音階	音を高さにより並べたもの。
音頭	「よさこい○○」「東京○○」「河内○○」
頂上	山などの一番高い所。チョウジョウ。
頂点	角の端にあるテン。
順位	一定の基準によってジュンに並べたときの、それぞれのイ置。
順位表	ジュンイヒョウ。
順序	何が先で何が後に来るか。物事の相互の前後関係。
順番	ジュンバン。
順調	ジュンチョウ。
預言者	ヨゲンシャ。
預貯金	ヨチョキン。
預金	おカネをアズけること。
預金残高	ヨキンザンダカ。
預金通帳	ヨキンツウチョウ。
預金金利	ヨキンキンリ。
領収書	リョウシュウショ。
領収証	リョウシュウショウ。
領土	リョウ有しているト地。リョウ地。
領土問題	リョウドモンダイ。
領地	リョウ有している土チ。
領域	物事・人がかかわりをもつ範囲。リョウイキ。
領有権	リョウユウケン。
領海	国家の主権が及ぶウミの範囲。
領海侵犯	リョウカイシンパン。
頭上	アタマのウエ。
頭上注意	ズジョウチュウイ。
頭打	アタマウち。
頭数	アタマカズ。
頭文字	カシラモジ。
頭痛	アタマがイタいこと。
頭脳	考えるアタマ。
頭脳流出	ズノウリュウシュツ。
頭髪	アタマの毛。
題名	タイトル。
題材	芸術作品などのもととなるザイ料。 
額面	有価証券に記載された金ガクのこと。
顔写真	カオジャシン。
顔文字	カオモジ。
顔色	カオイロ。
顔面	ガンメン。
願事	ネガいゴト。
願書	ガンショ。
願望	ガンボウ。
類似	よく似ていること。
類似品	ルイジヒン。
類語	意味が似ている単ゴ。
顧客情報	コキャクジョウホウ。
風上	カザカミ。
風下	カザシモ。
風俗店	フウゾクテン。
風刺画	フウシガ。
風力	カゼのチカラ。
風力発電	フウリョクハツデン。
風向	カザムき。
風味	フウミ。
風情	フゼイ。
風景	フウケイ。
風景画	フウケイガ。
風格	フウカク。
風流	フウリュウ。
風潮	フウチョウ。
風物	フウブツ。
風物詩	フウブツシ。
風紀委員会	フウキイインカイ。
風習	フウ俗・シュウ慣。
風船	フウセン。バルーン。
風車	カゼで回るクルマ。
風速	カゼのソク度。
風邪	「寒い服装で外出すると○○を引くよ」
風邪薬	カゼを治すクスリ。
風雨	カゼとアメ。
飛石	トびイシ。
飛行	空をトぶこと。
飛行機	空をトぶキ械。
食中毒	ショクチュウドク。
食事	タべるコト。
食券	タべるために使うケン。ショク事ケン。
食前	タべるマエ。
食卓	ショク事のための台やテーブル。
食品	栄養分を含み、ショク用に供されるシナ。
食品工場	ショクヒンコウジョウ。
食品添加物	ショクヒンテンカブツ。
食品衛生法	ショクヒンエイセイホウ。
食品表示法	ショクヒンヒョウジホウ。
食器	ショク事のために使うウツワ。
食堂	ショク事をするための部屋。
食塩	ショク用のシオ。
食塩水	ショクエンスイ。
食後	タべたアト。
食感	タべたカンじ。
食文化	ショクブンカ。
食料	タべ物。タべ物になる材リョウ。
食料不足	ショクリョウブソク。
食料事情	ショクリョウジジョウ。
食料品店	ショクリョウヒンテン。
食料問題	ショクリョウモンダイ。
食料生産	ショクリョウセイサン。
食料自給率	ショクリョウジキュウリツ。
食材	料理のザイ料となるショク品。
食欲	何かタべたいというヨク求。
食生活	ショクセイカツ。
食用	ショクヨウ。
食費	ショク事にかかるヒ用。
食道	口から胃までをつなぐ管。
飲料	インリョウ。
飲料水	インリョウスイ。
飲物	ノむモノ。
飲薬	クスリをノむこと。
飲酒	サケをノむこと。「○○運転はやめよう」
飲酒運転	サケをノんでウンテンすること。
飲食	ノんだりタべたりすること。
飲食店	ノんだりタべたりするミセ。
飲食禁止	インショクキンシ。
飼主	動物をカっている人。
飼犬	カっているイヌ。「○○に手をかまれる」
飼育	動物をカってソダてる。
飼育法	シイクホウ。
養分	栄ヨウとなる成ブン。
養子	実際の親コではなく、法律上のみの親コ関係。
養成	教育や訓練をして一人前に育てること。
養成所	ヨウセイジョ。
養生	生活に留意して健康の増進を図ること。
養育費	子どもをヤシナいソダてるヒ用。
養蚕	カイコを育てて副産物を利用する産業。
養蚕業	カイコを育てて副産物を利用する仕事。
館長	図書カンで一番偉い人。
首位打者	シュイダシャ。
首相	内閣総理大臣。総理。
首筋	首の後ろの部分。うなじ。
首脳	組織や団体の中心にいて指導的な役割を果たす人。
首脳会談	シュノウカイダン。
首都	東京都。ワシントン。パリ。
首都東京	シュトトウキョウ。
香川県	四国の北東に位置するケン。うどんが有名。
香料	カオりの元となる材リョウ。
香水	カオり付けのためのミズ。
香港政府	ホンコンセイフ。
香辛料	コウシンリョウ。
馬力	ウマの一頭分のチカラ。
馬耳東風	人の意見を気にしないこと。
馬車	ウマで引いて動かすクルマ。
馬鹿	バカ。ウマシカ。
駅伝	エキデン。
駅前	エキのマエ。
駅員	鉄道のエキの従業イン。
駅弁	鉄道のエキで売るベン当。
駅長	エキで一番偉い人。
駆使	思いどおりに使いこなすこと。クシ。
駆除	虫などを退治すること。
駐車	クルマを長時間とめておくこと。
駐車場	クルマを長時間とめておく場所。
骨折	ホネがオれること。
骨格	コッカク。
骨組	ホネグみ。
骨肉	ホネとニク。
高低	タカいこととヒクいこと。
高価	カ格がタカいこと。
高価買取	コウカカイトリ。
高値	ネ段がタカいこと。
高卒	コウ等学校をソツ業したこと。
高台	タカダイ。
高品質	ヒンシツがタカいこと。
高圧	電アツや水アツなどがタカいこと。
高圧線	電アツがタカい電セン。
高密度	ミツドがタカいこと。
高層	タカい建築物。「○○ビル」
高度	タカさのド合い。海水面からのタカさ。
高度成長期	コウドセイチョウキ。
高度経済成長	コウドケイザイセイチョウ。
高度経済成長期	コウドケイザイセイチョウキ。
高度計	コウドケイ。
高性能	セイノウがタカいこと。
高望	タカノゾみ。
高校	コウ等学コウ。
高校受験	コウコウジュケン。
高校生	コウ等学コウの学セイ。
高校進学	コウコウシンガク。
高機能	コウキノウ。
高気圧	キアツがタカいこと。
高温	オン度がタカいこと。
高温多湿	オン度とシツ度がタカいこと。
高潮	タカシオ。
高潮注意報	タカシオチュウイホウ。
高潮警報	タカシオケイホウ。
高濃度	ノウドがタカいこと。
高熱	体温が非常にタカかった。
高画質	コウガシツ。
高知県	四国の太平洋側に位置するケン。坂本竜馬の出身地。
高等学校	中ガッコウの次。
高級	等キュウや品質・程度などがタカいこと。
高級品	コウキュウヒン。
高級時計	コウキュウドケイ。
高級車	コウキュウシャ。
高血圧	ケツアツがタカいこと。
高裁	「コウ等サイ判所」の略。
高速	非常にハヤいソク度。
高速料金	コウソクリョウキン。
高速道路	コウソクドウロ。
高野連	「日本コウ等学校ヤ球レン盟」の略。
高音	タカいオト。
高音質	コウオンシツ。
高額	値段がタカいこと。
高飛車	タカビシャ。
高齢化社会	コウレイカシャカイ。
高齢者	コウレイシャ。
魚介類	ギョカイルイ。
魚屋	サカナを売る店。
魚市場	サカナのイチバ。
魚群探知機	ギョグンタンチキ。
魚肉	サカナのニク。
魚雷	ギョライ。
魚類	サカナの仲間。
鮮度	食材などの新しさ。フレッシュネス。
鮮明	色や形がアザやかではっきりしているさま。
鳥取県	中国地方の日本海側に位置し、砂丘で有名なケン。
鳥居	トリイ。
鶏卵	ニワトリのタマゴ。
鶏肉	ニワトリのニク。
鹿児島県	九州南部に位置するケン。種子島宇宙センターがある。
麦芽	バクガ。
麦茶	ムギチャ。
麻薬	依存性があり、幻覚や妄想などで頭をおかしくする危険なクスリ。
麻薬中毒	マヤクチュウドク。
麻薬取締官	マヤクトリシマリカン。
麻薬取締法違反	マヤクトリシマリホウイハン。
黄色	イエロー。
黄色人種	キイロのジンシュ。
黄身	卵のキ色のミ。
黄金	ゴールド。
黄金色	ゴールドのイロ。
黄金虫	コガネムシ。
黒人	クロいヒト。
黒字	会社で利益が出た。
黒幕	クロマク。
黒星	相撲で負けのこと。
黒板	チョークで字を書くイタ。教室で使う。
黒毛和牛	クロゲワギュウ。
黒潮	クロシオ。
黒点	太陽の比較的温度の低い場所。クロく見える。
黒煙	クロいケムリ。
黒白	クロとシロ。
黒色	クロいイロ。
黒色人種	クロいイロのジンシュ。
黒豚	クロブタ。
鼻息	ハナから出るイキ。
鼻歌	ハナから出るウタ。ふーふふん。
鼻水	ハナから出るミズ。
鼻血	ハナから出るチ。
摩訶不思議	マカフシギ。
貨物車	カモツシャ。
一等星	イットウセイ。
入道雲	ニュウドウグモ。
絵葉書	エハガキ。
不愛想	ブアイソウ
未解決事件	ミカイケツジケン。
一方的	イッポウテキ。
直接的	チョクセツテキ。
間接的	カンセツテキ。
友好的	ユウコウテキ。
感情的	カンジョウテキ。
基本的	キホンテキ。
松竹梅	ショウチクバイ。
上中下	ジョウチュウゲ。
大中小	ダイチュウショウ。
心技体	シンギタイ。
天地人	テンチジン。
朝昼晩	アサヒルバン。
和洋中	ワヨウチュウ。
近代的	キンダイテキ。
合理的	ゴウリテキ。
合理性	ゴウリセイ。
危険性	キケンセイ。
具体性	グタイセイ。
具体化	グタイカ。
社会性	シャカイセイ。
社会的	シャカイテキ。
機械的	キカイテキ。
自主性	ジシュセイ。
自主的	ジシュテキ。
対照的	タイショウテキ。
抽象的	チュウショウテキ。
抽象化	チュウショウカ。
非合法	ヒゴウホウ。
不案内	フアンナイ。
不分別	フフンベツ。
未発達	ミハッタツ。
無理解	ムリカイ。
未開拓	ミカイタク。
未開拓地	ミカイタクチ。
不売品	フバイヒン。
不心得	フココロエ。
無関心	ムカンシン。
未確認	ミカクニン。
未発表	ミハッピョウ。
未成熟	ミセイジュク。
微生物	ビセイブツ。
眼科医	ガンカイ。
飛行機雲	ヒコウキグモ。
立候補者	リッコウホシャ。
雪月花	セツゲツカ。
紳士的	シンシテキ。
善後策	ゼンゴサク。
門外漢	モンガイカン。
老婆心	ロウバシン。
太公望	タイコウボウ。
登竜門	トウリュウモン。
下剋上	ゲコクジョウ。
好敵手	コウテキシュ。
皮算用	カワザンヨウ。
無造作	ムゾウサ。
花鳥風月	カチョウフウゲツ。
付和雷同	フワライドウ。
自慢話	ジマンバナシ。
因果応報	インガオウホウ。
五里霧中	ゴリムチュウ。
一覧表	イチランヒョウ。
悪趣味	アクシュミ。
悪循環	アクジュンカン。
悪条件	アクジョウケン。
浅知恵	アサヂエ。
天邪鬼	アマノジャク
荒療治	アラリョウジ。
一見識	イチケンシキ。
一辺倒	イッペントウ。
絵空事	エソラゴト。
大海原	オオウナバラ。
大御所	オオゴショ。
大雑把	オオザッパ。
幼馴染	オサナナジミ。
音沙汰	オトサタ。
表沙汰	オモテザタ。
怪文書	カイブンショ。
案山子	カカシ。
風見鶏	カザミドリ。
過不足	カフソク。
感無量	カンムリョウ。
几帳面	キチョウメン。
既得権	キトクケン。
急先鋒	キュウセンポウ
金字塔	キンジトウ。
小細工	コザイク。
御破算	ゴハサン。
最高潮	サイコウチョウ。
猿芝居	サルシバイ。
猿真似	サルマネ。
自堕落	ジダラク。
守銭奴	シュセンド。
修羅場	シュラバ。
正攻法	セイコウホウ。
千秋楽	センシュウラク。
俗世間	ゾクセケン。
千鳥足	チドリアシ。
追体験	ツイタイケン。
出来心	デキゴコロ。
桃源郷	トウゲンキョウ。
逃避行	トウヒコウ。
土地勘	トチカン。
丼勘定	ドンブリカンジョウ。
並大抵	ナミタイテイ。
裸一貫	ハダカイッカン。
破天荒	ハテンコウ。
一筋縄	ヒトスジナワ。
百人力	ヒャクニンリキ。
日和見	ヒヨリミ。
貧乏神	ビンボウガミ。
不謹慎	フキンシン。
袋小路	フクロコウジ。
不合理	フゴウリ。
不見識	フケンシキ。
不作為	フサクイ。
不退転	フタイテン。
不養生	フヨウジョウ。
雰囲気	フンイキ。
分相応	ブンソウオウ。
屁理屈	ヘリクツ。
愛弟子	マナデシ。
真人間	マニンゲン。
未亡人	ミボウジン。
昔気質	ムカシカタギ。
無作為	ムサクイ。
無尽蔵	ムジンゾウ。
無神論	ムシンロン。
無駄足	ムダアシ。
無駄骨	ムダボネ。
胸算用	ムナザンヨウ。
目一杯	メイッパイ。
目論見	モクロミ。
疫病神	ヤクビョウガミ。
八千代	ヤチヨ。
夢心地	ユメゴコチ。
楽天地	ラクテンチ。
両極端	リョウキョクタン。
類人猿	ルイジンエン。
冷血漢	レイケツカン。
一体化	イッタイカ。
簡体字	カンタイジ。
旧体制	キュウタイセイ。
具体案	グタイアン。
口語体	コウゴタイ。
弱腰外交	ヨワゴシガイコウ。
情報弱者	ジョウホウジャクシャ。
基礎化粧品	キソケショウヒン。
高齢化	コウレイカ
化学結合	カガクケツゴウ。
化学物質	カガクブッシツ。
化学的去勢	カガクテキキョセイ。
感染症	カンセンショウ。
化学兵器	カガクヘイキ。
繁華街	ハンカガイ。
時間設定	ジカンセッテイ。
改正法	カイセイホウ。
不要不急	フヨウフキュウ。
安定的	アンテイテキ。
感染力	カンセンリョク。
多神教	タシンキョウ。
細胞核	サイボウカク。
顕微鏡	ケンビキョウ。
標準的	ヒョウジュンテキ。
細胞膜	サイボウマク。
高分子	コウブンシ。
水素結合	スイソケツゴウ。
大正時代	タイショウジダイ。
電気事業	デンキジギョウ。
昭和時代	ショウワジダイ。
常務	ジョウム。
火力発電所	カリョクハツデンショ。
交渉成立	コウショウセイリツ。
活発化	カッパツカ。
短期間	タンキカン。
長期間	チョウキカン。
有効票	ユウコウヒョウ。
無効票	ムコウヒョウ。
十字型	ジュウジガタ。
円柱状	エンチュウジョウ。
名産品	メイサンヒン。
食物繊維	ショクモツセンイ。
満洲事変	マンシュウジヘン。
国家予算	コッカヨサン。
最盛期	サイセイキ。
植民地支配	ショクミンチシハイ。
敗戦国	ハイセンコク。
航空会社	コウクウガイシャ。
鉄道経営	テツドウケイエイ。
政情不安	セイジョウフアン。
治外法権	チガイホウケン。
都市計画	トシケイカク。
住宅街	ジュウタクガイ。
宿泊施設	シュクハクシセツ。
娯楽施設	ゴラクシセツ。
旧日本軍	キュウニホングン。
発言権	ハツゲンケン。
軍事利用	グンジリヨウ。
好意的	コウイテキ。
議定書	ギテイショ。
給水管	キュウスイカン。
水槽	スイソウ。
施設	シセツ。
決定事項	ケッテイジコウ。
勧告	カンコク。すすめつげること。
譲渡	ジョウト。
改良工事	カイリョウコウジ。
経営権	ケイエイケン。
売却	バイキャク。
建設費	ケンセツヒ。
門戸開放	モンコカイホウ。
機会均等	キカイキントウ。
国際政治	コクサイセイジ。
石油権益	セキユケンエキ。
戦勝国	センショウコク。
人類社会	ジンルイシャカイ。
最高水準	サイコウスイジュン。
工業化	コウギョウカ。
相互作用	ソウゴサヨウ。
日米関係	ニチベイカンケイ。
帝国主義	テイコクシュギ。
社会不安	シャカイフアン。
公共性	コウキョウセイ。
重要局面	ジュウヨウキョクメン。
通院	ツウイン。
定例記者会見	テイレイキシャカイケン。
冒頭	ボウトウ。
官房長官	カンボウチョウカン。
外出自粛	ガイシュツジシュク。
逆風	ギャクフウ。
連載	レンサイ。
自由貿易協定	ジユウボウエキキョウテイ。
経営難	ケイエイナン。
統廃合	トウハイゴウ。
大人数	オオニンズウ。
転換点	テンカンテン。
市場動向	シジョウドウコウ。
失点	シッテン。
性差別	セイサベツ。
人権感覚	ジンケンカンカク。
墜落事故	ツイラクジコ。
運航停止	ウンコウテイシ。
運航再開	ウンコウサイカイ。
概算要求	ガイサンヨウキュウ。
少人数学級	ショウニンズウガッキュウ。
現地時間	ゲンチジカン。
皆様方	ミナサマガタ。
御協力	ゴキョウリョク。
上場廃止	ジョウジョウハイシ。
財務情報	ザイムジョウホウ。
政官財	セイカンザイ。
感染者	カンセンシャ。
条例案	ジョウレイアン。
市議会	シギカイ。
住民投票	ジュウミントウヒョウ。
公聴会	コウチョウカイ。
識別子	シキベツシ。
徹底	テッテイ。
徹底的	テッテイテキ。
徹夜	テツヤ。
防御率	ボウギョリツ。
守護神	シュゴシン。
冷徹	レイテツ。
筆順	ヒツジュン。
常用漢字表	ジョウヨウカンジヒョウ。
七不思議	ナナフシギ。
錬金術士	レンキンジュツシ。
錬金術	レンキンジュツ。
決定版	ケッテイバン。
最新作	サイシンサク。
曲者	クセモノ。
御案内	ゴアンナイ。
一般社団法人	イッパンシャダンホウジン。
社団法人	シャダンホウジン。
構成員	コウセイイン。
非営利	ヒエイリ。
剰余金	ジョウヨキン。
許認可	キョニンカ。
公益性	コウエキセイ。
財団法人	ザイダンホウジン。
会社設立	カイシャセツリツ。
追加料金	ツイカリョウキン。
